matchId,blue_gold,red_gold,blue_cs,red_cs,blue_kills,red_kills,blue_deaths,red_deaths,blue_assists,red_assists,blue_dragons,red_dragons,blue_heralds,red_heralds,blue_wards_placed,red_wards_placed,blue_wards_killed,red_wards_killed,blue_towerplates,red_towerplates,first_blood_blue,first_blood_red,first_dragon_blue,first_dragon_red,first_tower_blue,first_tower_red,frames_used,duration_ms_covered,gold_diff,cs_diff,kill_diff,death_diff,assist_diff,dragon_diff,herald_diff,wards_placed_diff,wards_killed_diff,towerplates_diff
KR_7690523877,15546,16015,236,245,6,8,8,7,6,7,0,0,0,0,16,17,3,1,1,3,0,1,0,0,0,0,10,540228,-469,-9,-2,1,-1,0,0,-1,2,-2
KR_7690552485,13928,14282,260,267,2,2,2,2,4,2,0,0,0,0,36,18,3,4,0,2,1,0,0,0,0,0,10,540213,-354,-7,0,0,2,0,0,18,-1,-2
KR_7690568768,16468,13916,276,267,8,2,2,9,14,2,0,0,0,0,15,17,2,2,2,0,1,0,0,0,0,0,10,540247,2552,9,6,-7,12,0,0,-2,0,2
KR_7690755025,15741,16862,278,281,6,10,10,6,4,10,1,0,0,0,16,15,3,3,0,0,1,0,1,0,0,0,10,540112,-1121,-3,-4,4,-6,1,0,1,0,0
KR_7691203826,16730,15794,263,233,9,7,7,9,9,13,0,1,0,0,19,18,3,1,2,1,1,0,0,1,0,0,10,540247,936,30,2,-2,-4,-1,0,1,2,1
KR_7691595579,17682,14627,292,261,7,5,5,7,7,3,0,0,0,0,112,15,3,3,2,0,1,0,0,0,0,0,10,540260,3055,31,2,-2,4,0,0,97,0,2
KR_7691623414,16886,14375,278,278,7,2,2,7,8,1,0,0,0,0,21,21,4,5,0,4,1,0,0,0,0,0,10,540223,2511,0,5,-5,7,0,0,0,-1,-4
KR_7692979601,15075,14709,304,289,3,3,3,3,3,5,0,0,0,0,16,14,4,2,0,0,0,1,0,0,0,0,10,540138,366,15,0,0,-2,0,0,2,2,0
KR_7693033088,13632,15298,267,300,2,4,4,2,3,5,0,1,0,0,15,12,2,1,0,0,1,0,0,1,0,0,10,540196,-1666,-33,-2,2,-2,-1,0,3,1,0
KR_7693055261,15876,13621,251,252,7,2,2,7,14,3,1,0,0,0,13,39,6,2,1,0,1,0,1,0,0,0,10,540204,2255,-1,5,-5,11,1,0,-26,4,1
KR_7693810458,17475,14644,219,253,13,3,3,13,23,3,0,0,0,0,20,15,5,2,0,2,1,0,0,0,0,0,10,540267,2831,-34,10,-10,20,0,0,5,3,-2
KR_7693902530,15236,17316,289,278,4,10,10,4,5,14,0,1,0,0,14,14,1,6,1,1,0,1,0,1,0,0,10,540262,-2080,11,-6,6,-9,-1,0,0,-5,0
KR_7693909011,16179,13585,240,283,10,1,1,10,11,0,0,0,0,0,20,13,3,3,2,0,1,0,0,0,0,0,10,540273,2594,-43,9,-9,11,0,0,7,0,2
KR_7694070732,16152,16678,246,229,8,10,10,8,10,11,0,0,0,0,11,24,3,2,1,1,1,0,0,0,0,0,10,540217,-526,17,-2,2,-1,0,0,-13,1,0
KR_7694143604,18467,13530,272,224,13,3,3,13,12,2,0,0,0,0,28,11,2,3,3,0,1,0,0,0,0,0,10,540261,4937,48,10,-10,10,0,0,17,-1,3
KR_7694357468,13510,20449,234,261,3,18,18,3,7,31,1,0,0,0,17,20,2,2,0,2,1,0,1,0,0,0,10,540259,-6939,-27,-15,15,-24,1,0,-3,0,-2
KR_7694384288,19145,13977,265,216,15,4,4,15,23,9,0,0,0,0,26,19,5,3,1,0,1,0,0,0,0,0,10,540225,5168,49,11,-11,14,0,0,7,2,1
KR_7694409373,15886,15688,262,258,6,8,8,6,10,4,0,1,0,0,11,16,3,1,0,0,0,1,0,1,0,0,10,540200,198,4,-2,2,6,-1,0,-5,2,0
KR_7694433022,16764,15593,274,234,9,7,7,9,8,8,0,0,0,0,18,19,3,5,1,0,1,0,0,0,0,0,10,540237,1171,40,2,-2,0,0,0,-1,-2,1
KR_7694880061,15439,16696,268,224,4,10,10,4,3,17,0,0,0,0,16,47,4,4,3,0,0,1,0,0,0,0,10,540259,-1257,44,-6,6,-14,0,0,-31,0,3
KR_7694996205,13709,15016,300,303,1,3,3,1,0,3,1,0,0,0,18,18,7,7,0,0,0,1,1,0,0,0,10,540203,-1307,-3,-2,2,-3,1,0,0,0,0
KR_7695028359,17641,14286,292,248,9,4,4,9,9,2,0,0,0,0,20,15,3,3,6,0,1,0,0,0,0,0,10,540274,3355,44,5,-5,7,0,0,5,0,6
KR_7695354360,13664,14326,279,282,1,2,2,1,1,2,0,0,0,0,16,18,4,5,0,0,1,0,0,0,0,0,10,540201,-662,-3,-1,1,-1,0,0,-2,-1,0
KR_7695424107,15196,14472,289,309,5,1,1,5,5,1,1,0,0,0,17,19,6,2,0,1,1,0,1,0,0,0,10,540181,724,-20,4,-4,4,1,0,-2,4,-1
KR_7696406605,14858,15104,269,280,3,4,4,3,4,5,0,0,0,0,22,20,6,5,0,2,1,0,0,0,0,0,10,540202,-246,-11,-1,1,-1,0,0,2,1,-2
KR_7696472078,16329,17004,260,241,10,9,9,10,10,17,0,1,0,0,16,14,4,3,0,2,0,1,0,1,0,0,10,540169,-675,19,1,-1,-7,-1,0,2,1,-2
KR_7697742284,16036,16146,251,247,9,6,6,9,5,7,0,0,0,0,17,16,2,7,0,1,1,0,0,0,0,0,10,540235,-110,4,3,-3,-2,0,0,1,-5,-1
KR_7697802457,17161,15478,224,215,12,7,7,12,10,4,0,0,0,0,16,36,4,6,2,0,1,0,0,0,0,0,10,540202,1683,9,5,-5,6,0,0,-20,-2,2
KR_7697842039,14856,13810,234,254,7,2,2,7,8,1,0,0,0,0,17,24,5,2,0,0,1,0,0,0,0,0,10,540198,1046,-20,5,-5,7,0,0,-7,3,0
KR_7697892726,15102,13788,307,276,2,2,2,2,2,1,0,1,0,0,21,20,6,2,1,0,1,0,0,1,0,0,10,540210,1314,31,0,0,1,-1,0,1,4,1
KR_7697967231,17696,16193,271,249,10,9,9,10,11,8,0,0,0,0,16,12,1,2,1,0,1,0,0,0,0,0,10,540228,1503,22,1,-1,3,0,0,4,-1,1
KR_7697986368,17637,15747,305,288,8,4,4,8,12,5,1,0,0,0,27,15,5,4,1,1,0,1,1,0,0,0,10,540234,1890,17,4,-4,7,1,0,12,1,0
KR_7698006286,15403,15474,277,242,5,6,6,5,3,5,1,0,0,0,15,14,3,1,2,0,1,0,1,0,0,0,10,540245,-71,35,-1,1,-2,1,0,1,2,2
KR_7698043405,17240,13394,269,249,10,2,2,10,10,1,0,0,0,0,17,14,4,5,3,0,1,0,0,0,0,0,10,540217,3846,20,8,-8,9,0,0,3,-1,3
KR_7698242352,14930,17268,243,238,4,10,10,4,4,14,0,0,0,0,17,14,1,5,0,1,0,1,0,0,0,0,10,540263,-2338,5,-6,6,-10,0,0,3,-4,-1
KR_7698261827,13953,14962,283,286,1,3,3,1,1,4,0,1,0,0,16,46,2,5,1,1,0,1,0,1,0,0,10,540196,-1009,-3,-2,2,-3,-1,0,-30,-3,0
KR_7698293235,17157,15075,274,292,8,3,3,8,11,3,0,0,0,0,17,31,6,4,1,0,1,0,0,0,0,0,10,540246,2082,-18,5,-5,8,0,0,-14,2,1
KR_7698314713,15774,15190,254,266,6,4,4,6,9,5,0,1,0,0,15,18,1,0,1,0,1,0,0,1,0,0,10,540257,584,-12,2,-2,4,-1,0,-3,1,1
KR_7698504069,16142,16655,263,265,7,8,8,7,10,12,0,0,0,0,19,14,2,2,0,0,0,1,0,0,0,0,10,540212,-513,-2,-1,1,-2,0,0,5,0,0
KR_7698574097,15078,16114,265,268,5,8,8,5,7,9,0,1,0,0,40,14,1,2,2,0,1,0,0,1,0,0,10,540279,-1036,-3,-3,3,-2,-1,0,26,-1,2
KR_7698593973,11987,16688,192,268,1,9,9,1,0,11,0,1,0,0,30,22,0,4,0,2,0,1,0,1,0,0,10,540240,-4701,-76,-8,8,-11,-1,0,8,-4,-2
KR_7698606414,15571,16239,273,295,5,7,7,5,5,6,0,1,0,0,19,18,4,3,0,1,0,1,0,1,0,0,10,540259,-668,-22,-2,2,-1,-1,0,1,1,-1
KR_7698661667,15999,16044,252,227,7,8,8,7,11,13,0,0,0,0,38,20,4,2,0,0,0,1,0,0,0,0,10,540267,-45,25,-1,1,-2,0,0,18,2,0
KR_7698672814,15252,14576,294,273,4,3,3,4,6,4,0,0,0,0,15,15,4,3,0,0,0,1,0,0,0,0,10,540165,676,21,1,-1,2,0,0,0,1,0
KR_7698705242,14677,15648,287,307,2,4,4,2,1,2,0,0,0,0,22,13,3,5,2,1,0,1,0,0,0,0,10,540116,-971,-20,-2,2,-1,0,0,9,-2,1
KR_7698710726,14861,13196,284,253,3,1,1,3,2,1,1,0,0,0,16,14,3,3,1,0,1,0,1,0,0,0,10,540202,1665,31,2,-2,1,1,0,2,0,1
KR_7698761291,14636,15741,291,260,3,7,7,3,3,8,0,1,0,0,15,38,6,3,2,2,0,1,0,1,0,0,10,540232,-1105,31,-4,4,-5,-1,0,-23,3,0
KR_7698790708,16400,14539,287,231,9,4,4,9,6,2,0,0,0,0,21,18,4,2,0,0,1,0,0,0,0,0,10,540122,1861,56,5,-5,4,0,0,3,2,0
KR_7698811216,15880,15648,249,265,8,6,6,8,8,6,0,0,0,0,16,18,2,0,1,0,1,0,0,0,0,0,10,540219,232,-16,2,-2,2,0,0,-2,2,1
KR_7698838209,14663,15523,269,266,5,6,6,5,2,6,0,0,0,0,17,16,8,4,0,0,1,0,0,0,0,0,10,540308,-860,3,-1,1,-4,0,0,1,4,0
KR_7698876832,14616,14483,287,284,3,3,3,3,3,5,0,0,0,0,21,16,1,2,1,0,1,0,0,0,0,0,10,540170,133,3,0,0,-2,0,0,5,-1,1
KR_7698909849,15380,17707,257,271,5,9,9,6,5,10,0,1,0,0,19,31,2,4,1,2,0,1,0,1,0,0,10,540295,-2327,-14,-4,3,-5,-1,0,-12,-2,-1
KR_7698921812,14146,15149,267,257,3,6,6,3,2,7,0,1,0,0,22,17,3,1,0,0,0,1,0,1,0,0,10,540227,-1003,10,-3,3,-5,-1,0,5,2,0
KR_7698957107,15266,16274,250,247,6,9,9,6,6,17,0,0,0,0,14,18,2,5,1,1,1,0,0,0,0,0,10,540164,-1008,3,-3,3,-11,0,0,-4,-3,0
KR_7698960473,14004,16203,244,271,3,6,6,3,3,5,1,0,0,0,19,17,1,4,2,3,1,0,1,0,0,0,10,540209,-2199,-27,-3,3,-2,1,0,2,-3,-1
KR_7698966877,13940,15512,234,262,5,6,6,5,5,5,0,0,0,0,16,25,3,1,0,1,1,0,0,0,0,0,10,540231,-1572,-28,-1,1,0,0,0,-9,2,-1
KR_7698986563,14959,14843,262,267,5,4,4,5,4,4,0,1,0,0,16,16,2,4,0,2,0,1,0,1,0,0,10,540250,116,-5,1,-1,0,-1,0,0,-2,-2
KR_7698995738,14763,16886,245,268,4,8,9,4,4,15,0,0,0,0,19,20,3,1,1,2,1,0,0,0,0,0,10,540226,-2123,-23,-4,5,-11,0,0,-1,2,-1
KR_7699005621,15538,14919,286,293,5,3,3,5,5,3,0,0,0,0,19,32,8,3,0,2,1,0,0,0,0,0,10,540226,619,-7,2,-2,2,0,0,-13,5,-2
KR_7699022880,16684,14896,285,285,7,4,4,7,11,2,1,0,0,0,19,18,2,4,2,0,0,1,1,0,0,0,10,540276,1788,0,3,-3,9,1,0,1,-2,2
KR_7699028562,15341,17053,249,259,4,8,8,4,9,15,0,0,0,0,18,16,1,8,2,4,1,0,0,0,0,0,10,540198,-1712,-10,-4,4,-6,0,0,2,-7,-2
KR_7699048840,14631,15592,264,258,3,5,5,3,5,11,0,0,0,0,17,15,1,1,3,2,0,1,0,0,0,0,10,540264,-961,6,-2,2,-6,0,0,2,0,1
KR_7699066337,15851,15668,230,279,8,5,5,8,9,2,0,0,0,0,18,19,3,2,2,2,1,0,0,0,0,0,10,540271,183,-49,3,-3,7,0,0,-1,1,0
KR_7699082598,16119,15102,228,248,9,5,5,9,16,10,0,0,0,0,18,22,6,4,0,0,1,0,0,0,0,0,10,540271,1017,-20,4,-4,6,0,0,-4,2,0
KR_7699505354,16164,14692,282,261,7,4,4,7,5,5,1,0,0,0,17,18,4,3,1,0,1,0,1,0,0,0,10,540277,1472,21,3,-3,0,1,0,-1,1,1
KR_7699549406,17005,15038,294,274,5,4,4,5,7,9,0,1,0,0,113,23,4,2,4,0,1,0,0,1,1,0,10,540276,1967,20,1,-1,-2,-1,0,90,2,4
KR_7699586470,15053,14492,291,260,3,3,3,3,7,4,0,0,0,0,18,20,2,3,1,0,1,0,0,0,0,0,10,540214,561,31,0,0,3,0,0,-2,-1,1
KR_7699799868,16948,14422,268,249,8,3,3,8,10,5,0,1,0,0,14,17,3,3,0,2,1,0,0,1,0,0,10,540218,2526,19,5,-5,5,-1,0,-3,0,-2
KR_7699850721,13766,14486,290,269,1,3,3,1,2,3,1,0,0,0,33,13,2,2,0,1,0,1,1,0,0,0,10,540243,-720,21,-2,2,-1,1,0,20,0,-1
KR_7699898655,15166,14464,228,274,7,3,3,7,6,2,0,0,0,0,16,13,1,2,0,0,1,0,0,0,0,0,10,540242,702,-46,4,-4,4,0,0,3,-1,0
KR_7699936739,15164,15416,253,278,5,5,5,5,5,4,0,1,0,0,13,9,2,4,0,4,0,1,0,1,0,0,10,540187,-252,-25,0,0,1,-1,0,4,-2,-4
KR_7700251585,17189,15388,238,264,11,6,6,11,10,11,1,0,0,0,17,16,2,1,1,0,0,1,1,0,0,0,10,540251,1801,-26,5,-5,-1,1,0,1,1,1
KR_7700389696,16525,15098,276,260,8,5,5,8,6,8,1,0,0,0,17,12,1,2,2,0,1,0,1,0,0,0,10,540275,1427,16,3,-3,-2,1,0,5,-1,2
KR_7700460029,6683,5432,91,68,2,1,1,2,4,0,0,0,0,0,7,3,0,0,1,0,1,0,0,0,0,0,5,224103,1251,23,1,-1,4,0,0,4,0,1
KR_7700461648,17515,13688,247,235,12,3,3,12,13,2,0,0,0,0,15,14,3,1,3,0,1,0,0,0,0,0,10,540245,3827,12,9,-9,11,0,0,1,2,3
KR_7700477467,16164,15135,249,257,9,5,5,9,16,7,0,0,0,0,20,22,2,5,1,0,0,1,0,0,0,0,10,540184,1029,-8,4,-4,9,0,0,-2,-3,1
KR_7700489228,17148,15620,274,239,10,6,6,10,15,7,1,0,0,0,16,17,6,2,0,0,1,0,1,0,0,0,10,540230,1528,35,4,-4,8,1,0,-1,4,0
KR_7700495610,14624,17092,265,296,5,6,6,5,5,10,0,1,0,0,16,16,1,5,0,2,1,0,0,1,0,0,10,540241,-2468,-31,-1,1,-5,-1,0,0,-4,-2
KR_7700511738,16281,14259,259,227,8,4,4,8,14,6,0,0,0,0,16,13,2,2,3,2,1,0,0,0,0,0,10,540254,2022,32,4,-4,8,0,0,3,0,1
KR_7700648010,15922,14210,273,291,6,2,2,6,7,0,1,0,0,0,22,17,3,2,0,0,1,0,1,0,0,0,10,540245,1712,-18,4,-4,7,1,0,5,1,0
KR_7700925893,16259,15131,270,254,8,6,6,8,8,6,0,0,0,0,15,14,5,1,0,1,1,0,0,0,0,0,10,540245,1128,16,2,-2,2,0,0,1,4,-1
KR_7700976336,15356,14089,302,275,3,3,3,3,3,3,0,1,0,0,17,16,4,3,1,0,0,1,0,1,0,0,10,540174,1267,27,0,0,0,-1,0,1,1,1
KR_7701021627,15578,15085,254,232,8,5,5,8,7,3,0,0,0,0,17,13,2,1,1,2,1,0,0,0,0,0,10,540205,493,22,3,-3,4,0,0,4,1,-1
KR_7701064209,16431,15993,264,290,6,6,6,6,9,9,1,0,0,0,33,15,6,3,2,1,0,1,1,0,0,0,10,540242,438,-26,0,0,0,1,0,18,3,1
KR_7701095531,13965,15064,244,281,4,4,4,4,3,4,0,0,0,0,17,115,1,4,0,1,1,0,0,0,0,0,10,540152,-1099,-37,0,0,-1,0,0,-98,-3,-1
KR_7701105386,15529,14679,232,214,7,6,6,7,13,8,0,0,0,0,17,18,2,1,0,0,0,1,0,0,0,0,10,540210,850,18,1,-1,5,0,0,-1,1,0
KR_7701120037,15286,13768,290,271,5,2,3,5,3,2,0,1,0,0,15,16,1,1,0,0,1,0,0,1,0,0,10,540201,1518,19,3,-2,1,-1,0,-1,0,0
KR_7701128115,15985,15931,268,236,7,7,7,7,4,7,0,0,0,0,15,14,4,3,1,0,1,0,0,0,0,0,10,540299,54,32,0,0,-3,0,0,1,1,1
KR_7701138493,15675,15668,256,283,7,5,5,7,10,5,1,0,0,0,25,17,3,4,0,1,1,0,1,0,0,0,10,540232,7,-27,2,-2,5,1,0,8,-1,-1
KR_7701282661,14866,14008,253,258,5,3,3,5,5,5,0,1,0,0,13,23,5,3,1,1,1,0,0,1,0,0,10,540219,858,-5,2,-2,0,-1,0,-10,2,0
KR_7701309939,18446,16021,270,240,13,7,7,13,13,10,1,0,0,0,21,13,1,5,3,0,1,0,1,0,0,0,10,540217,2425,30,6,-6,3,1,0,8,-4,3
KR_7701339936,16906,16235,249,222,10,9,9,10,16,10,1,0,0,0,18,18,2,5,1,0,1,0,1,0,0,0,10,540277,671,27,1,-1,6,1,0,0,-3,1
KR_7701392460,17313,14733,243,259,11,4,4,11,11,3,0,0,0,0,21,16,4,2,0,0,1,0,0,0,0,0,10,540278,2580,-16,7,-7,8,0,0,5,2,0
KR_7701548961,15182,16169,291,257,4,7,7,4,4,11,1,0,0,0,18,33,5,4,0,1,1,0,1,0,0,0,10,540204,-987,34,-3,3,-7,1,0,-15,1,-1
KR_7701600177,14621,17844,273,299,4,8,8,4,4,6,0,1,0,0,18,42,4,4,0,2,0,1,0,1,0,0,10,540198,-3223,-26,-4,4,-2,-1,0,-24,0,-2
KR_7701629529,16400,15842,237,257,10,6,6,10,8,5,0,0,0,0,14,13,3,1,0,2,1,0,0,0,0,0,10,540194,558,-20,4,-4,3,0,0,1,2,-2
KR_7701675062,17421,14762,257,255,11,4,4,11,14,4,0,0,0,0,16,29,2,5,1,0,1,0,0,0,0,0,10,540230,2659,2,7,-7,10,0,0,-13,-3,1
KR_7701722647,16306,18316,284,272,6,11,11,6,9,21,0,1,0,0,15,36,5,1,1,1,0,1,0,1,0,0,10,540239,-2010,12,-5,5,-12,-1,0,-21,4,0
KR_7701737900,15595,16774,297,296,5,6,6,5,3,8,0,0,0,0,16,38,4,4,0,0,0,1,0,0,0,0,10,540264,-1179,1,-1,1,-5,0,0,-22,0,0
KR_7701793333,15707,15837,291,274,5,6,6,5,6,11,0,1,0,0,15,20,2,4,0,1,1,0,0,1,0,0,10,540207,-130,17,-1,1,-5,-1,0,-5,-2,-1
KR_7701813634,16387,18324,255,265,7,13,13,7,5,16,0,1,0,0,13,18,3,3,1,0,0,1,0,1,0,0,10,540262,-1937,-10,-6,6,-11,-1,0,-5,0,1
KR_7701845532,16243,13472,296,288,5,0,0,5,6,0,1,0,0,0,18,14,2,6,1,1,1,0,1,0,0,0,10,540256,2771,8,5,-5,6,1,0,4,-4,0
KR_7701845658,15877,15112,253,265,6,5,5,6,7,9,0,0,0,0,16,19,3,5,1,0,1,0,0,0,0,0,10,540241,765,-12,1,-1,-2,0,0,-3,-2,1
KR_7701882880,14815,16208,259,294,4,5,5,4,4,6,0,1,0,0,18,14,3,1,0,2,0,1,0,1,0,0,10,540210,-1393,-35,-1,1,-2,-1,0,4,2,-2
KR_7701906058,16252,14910,262,254,8,5,5,8,10,11,0,1,0,0,23,50,0,3,1,0,1,0,0,1,0,0,10,540217,1342,8,3,-3,-1,-1,0,-27,-3,1
KR_7701944219,15722,15764,274,289,6,5,5,6,5,7,1,0,0,0,14,19,5,3,2,1,1,0,1,0,0,0,10,540204,-42,-15,1,-1,-2,1,0,-5,2,1
KR_7701957688,15844,14354,298,308,4,1,1,4,10,3,0,1,0,0,17,92,4,5,0,3,1,0,0,1,0,0,10,540253,1490,-10,3,-3,7,-1,0,-75,-1,-3
KR_7701993085,15569,15444,232,276,8,7,7,8,9,2,0,0,0,0,14,188,3,2,0,0,0,1,0,0,0,0,10,540255,125,-44,1,-1,7,0,0,-174,1,0
KR_7702000330,16885,15973,256,252,8,6,6,8,11,6,0,0,0,0,16,22,7,4,0,2,0,1,0,0,0,0,10,540270,912,4,2,-2,5,0,0,-6,3,-2
KR_7702076315,15957,15603,283,266,7,6,7,8,6,7,0,1,0,0,19,109,0,3,0,0,1,0,0,1,0,0,10,540217,354,17,1,-1,-1,-1,0,-90,-3,0
KR_7702083416,14278,17352,230,265,5,12,12,5,4,10,1,0,0,0,12,164,3,3,0,3,0,1,1,0,0,0,10,540162,-3074,-35,-7,7,-6,1,0,-152,0,-3
KR_7702124408,14789,16178,240,241,5,8,8,5,10,10,0,0,0,0,23,19,2,0,1,0,0,1,0,0,0,0,10,540234,-1389,-1,-3,3,0,0,0,4,2,1
KR_7702204787,15314,15147,264,270,6,5,5,6,10,6,1,0,0,0,17,18,6,2,0,0,1,0,1,0,0,0,10,540249,167,-6,1,-1,4,1,0,-1,4,0
KR_7702251607,14457,15145,293,294,2,4,4,2,3,8,0,0,0,0,14,16,4,5,0,0,1,0,0,0,0,0,10,540205,-688,-1,-2,2,-5,0,0,-2,-1,0
KR_7702284434,17342,16757,291,282,8,8,8,8,9,7,0,0,0,0,15,101,2,5,2,0,1,0,0,0,0,0,10,540276,585,9,0,0,2,0,0,-86,-3,2
KR_7702319223,14749,16135,264,254,5,7,7,5,3,10,1,0,0,0,18,14,3,2,0,4,0,1,1,0,0,0,10,540233,-1386,10,-2,2,-7,1,0,4,1,-4
KR_7702339739,15620,16428,272,263,5,8,8,6,8,10,0,0,0,0,32,43,1,4,0,2,0,1,0,0,0,0,10,540168,-808,9,-3,2,-2,0,0,-11,-3,-2
KR_7702354987,14153,15054,252,253,3,6,7,3,3,15,0,1,0,0,15,16,2,3,1,1,0,1,0,1,0,0,10,540270,-901,-1,-3,4,-12,-1,0,-1,-1,0
KR_7702364871,15069,15680,251,226,5,7,7,6,4,13,0,0,0,0,18,16,4,3,1,0,0,1,0,0,0,0,10,540221,-611,25,-2,1,-9,0,0,2,1,1
KR_7702413739,14355,15422,225,255,5,6,6,5,7,6,0,0,0,0,18,20,2,1,0,3,0,1,0,0,0,0,10,540222,-1067,-30,-1,1,1,0,0,-2,1,-3
KR_7702429145,14588,15474,244,248,4,6,6,4,6,7,1,0,0,0,12,18,7,2,0,3,0,1,1,0,0,0,10,540276,-886,-4,-2,2,-1,1,0,-6,5,-3
KR_7702431873,16438,13772,267,252,8,2,2,8,8,1,0,0,0,0,20,13,3,3,1,0,1,0,0,0,0,0,10,540247,2666,15,6,-6,7,0,0,7,0,1
KR_7702452186,15083,14246,281,276,3,3,3,3,4,3,0,0,0,0,18,23,5,2,2,0,0,1,0,0,0,0,10,540228,837,5,0,0,1,0,0,-5,3,2
KR_7702460810,15384,14478,242,279,6,3,3,6,12,9,0,1,0,0,15,20,4,7,0,0,1,0,0,1,0,0,10,540217,906,-37,3,-3,3,-1,0,-5,-3,0
KR_7702624728,16039,14158,261,262,8,3,3,8,13,5,0,1,0,0,40,14,3,10,1,2,0,1,0,1,0,0,10,540215,1881,-1,5,-5,8,-1,0,26,-7,-1
KR_7702653627,17010,14808,276,259,9,4,4,9,13,2,0,0,0,0,35,18,4,5,0,0,1,0,0,0,0,0,10,540245,2202,17,5,-5,11,0,0,17,-1,0
KR_7702688994,16979,14825,247,281,11,3,3,11,11,3,0,0,0,0,18,15,3,4,0,0,1,0,0,0,0,0,10,540232,2154,-34,8,-8,8,0,0,3,-1,0
KR_7702711227,14646,15373,263,285,4,5,5,4,6,4,0,1,0,0,15,14,2,4,2,0,0,1,0,1,0,0,10,540239,-727,-22,-1,1,2,-1,0,1,-2,2
KR_7702759119,15885,13891,280,269,5,2,2,5,7,4,1,0,0,0,13,17,3,0,1,0,0,1,1,0,0,0,10,540216,1994,11,3,-3,3,1,0,-4,3,1
KR_7702812650,15422,15246,289,293,5,5,5,5,5,5,0,0,0,0,21,15,4,3,0,0,0,1,0,0,0,0,10,540246,176,-4,0,0,0,0,0,6,1,0
KR_7702839932,15093,14131,249,259,6,3,3,6,7,3,0,0,0,0,34,16,9,0,0,0,1,0,0,0,0,0,10,540207,962,-10,3,-3,4,0,0,18,9,0
KR_7702946357,14493,13635,297,286,2,1,1,2,1,1,1,0,0,0,20,18,4,1,1,0,0,1,1,0,0,0,10,540273,858,11,1,-1,0,1,0,2,3,1
KR_7703228900,15718,16160,290,274,6,6,6,6,8,6,0,0,0,0,17,19,9,3,1,0,1,0,0,0,0,0,10,540274,-442,16,0,0,2,0,0,-2,6,1
KR_7703295296,2525,2549,0,0,0,0,0,0,0,0,0,0,0,0,2,4,0,0,0,0,0,0,0,0,0,0,3,102050,-24,0,0,0,0,0,0,-2,0,0
KR_7703306797,14802,15425,263,283,4,4,4,4,9,7,0,0,0,0,15,16,5,4,1,3,1,0,0,0,0,0,10,540257,-623,-20,0,0,2,0,0,-1,1,-2
KR_7703385211,14504,13974,217,232,6,3,3,6,5,5,0,0,0,0,17,16,5,0,0,3,1,0,0,0,0,0,10,540231,530,-15,3,-3,0,0,0,1,5,-3
KR_7703390010,14528,13935,284,281,2,2,2,2,1,1,1,0,0,0,14,127,3,6,0,0,0,1,1,0,0,0,10,540289,593,3,0,0,0,1,0,-113,-3,0
KR_7703421061,16306,15402,268,248,8,5,5,8,6,7,0,0,0,0,30,15,2,3,0,2,1,0,0,0,0,0,10,540214,904,20,3,-3,-1,0,0,15,-1,-2
KR_7703469167,15500,14026,272,261,6,2,2,6,8,3,1,0,0,0,15,19,1,2,0,0,0,1,1,0,0,0,10,540214,1474,11,4,-4,5,1,0,-4,-1,0
KR_7703544779,14283,15620,263,292,3,4,4,3,3,5,0,0,0,0,15,14,3,3,0,0,0,1,0,0,0,0,10,540222,-1337,-29,-1,1,-2,0,0,1,0,0
KR_7703574087,15690,14778,301,272,4,3,3,4,6,5,0,0,0,0,13,21,2,2,2,0,1,0,0,0,0,0,10,540190,912,29,1,-1,1,0,0,-8,0,2
KR_7703594565,16328,14685,299,281,6,3,3,6,6,5,0,0,0,0,17,13,3,3,2,1,1,0,0,0,0,0,10,540246,1643,18,3,-3,1,0,0,4,0,1
KR_7703649361,15880,14491,289,252,7,4,5,7,8,3,0,0,0,0,15,28,4,4,0,0,1,0,0,0,0,0,10,540251,1389,37,3,-2,5,0,0,-13,0,0
KR_7703941158,16511,12925,267,240,8,2,2,8,9,0,1,0,0,0,17,10,2,1,2,0,1,0,1,0,0,0,10,540294,3586,27,6,-6,9,1,0,7,1,2
KR_7704237472,14534,15542,282,265,4,6,6,4,0,8,0,1,0,0,18,11,1,6,0,0,0,1,0,1,0,0,10,540236,-1008,17,-2,2,-8,-1,0,7,-5,0
KR_7704265700,14395,16398,259,255,2,8,8,2,2,7,0,0,0,0,290,17,2,2,0,1,0,1,0,0,0,0,10,540241,-2003,4,-6,6,-5,0,0,273,0,-1
KR_7704324213,16393,13961,270,256,9,2,2,9,13,3,0,1,0,0,15,17,4,2,2,3,1,0,0,1,0,0,10,540249,2432,14,7,-7,10,-1,0,-2,2,-1
KR_7704463758,16142,14331,253,279,8,2,2,8,16,3,0,0,0,0,20,13,4,5,1,1,1,0,0,0,0,0,10,540249,1811,-26,6,-6,13,0,0,7,-1,0
KR_7704513168,14456,15669,242,250,5,7,7,5,11,9,0,0,0,0,25,15,3,1,1,0,0,1,0,0,0,0,10,540244,-1213,-8,-2,2,2,0,0,10,2,1
KR_7704526944,15078,13927,258,291,5,1,1,5,7,1,0,1,0,0,47,113,3,4,0,1,1,0,0,1,0,0,10,540256,1151,-33,4,-4,6,-1,0,-66,-1,-1
KR_7704582800,15978,15032,248,259,8,5,5,8,13,3,0,0,0,0,17,16,2,3,0,0,0,1,0,0,0,0,10,540203,946,-11,3,-3,10,0,0,1,-1,0
KR_7704832350,15127,13374,251,227,7,3,3,7,10,5,0,1,0,0,35,41,9,4,0,1,1,0,0,1,0,0,10,540253,1753,24,4,-4,5,-1,0,-6,5,-1
KR_7704834471,14710,15949,274,308,3,4,4,5,5,3,1,0,0,0,14,14,1,4,1,3,1,0,1,0,0,0,10,540237,-1239,-34,-1,-1,2,1,0,0,-3,-2
KR_7704854560,16978,15447,239,227,11,8,8,11,10,12,1,0,0,0,203,14,0,3,2,0,0,1,1,0,0,0,10,540257,1531,12,3,-3,-2,1,0,189,-3,2
KR_7704893110,15392,15794,227,243,8,8,8,8,13,10,1,0,0,0,16,33,1,2,0,1,1,0,1,0,0,0,10,540230,-402,-16,0,0,3,1,0,-17,-1,-1
KR_7704915112,16655,14831,260,263,9,4,4,9,6,4,0,0,0,0,51,21,3,3,1,0,1,0,0,0,0,0,10,540231,1824,-3,5,-5,2,0,0,30,0,1
KR_7704944656,14724,12887,265,245,4,1,1,4,6,3,0,0,0,0,41,15,3,5,0,0,0,1,0,0,0,0,10,540265,1837,20,3,-3,3,0,0,26,-2,0
KR_7704947095,14294,14527,248,294,4,2,2,4,6,4,0,1,0,0,40,17,4,6,0,0,1,0,0,1,0,0,10,540275,-233,-46,2,-2,2,-1,0,23,-2,0
KR_7704950423,14586,14547,253,285,4,3,3,4,5,2,0,0,0,0,28,13,2,10,0,1,1,0,0,0,0,0,10,540211,39,-32,1,-1,3,0,0,15,-8,-1
KR_7704976999,14735,15449,247,274,5,5,5,5,9,5,0,0,0,0,16,40,5,6,0,0,0,1,0,0,0,0,10,540216,-714,-27,0,0,4,0,0,-24,-1,0
KR_7704983587,12957,15938,220,280,2,6,6,2,4,3,0,0,0,0,18,23,3,6,0,2,0,1,0,0,0,0,10,540191,-2981,-60,-4,4,1,0,0,-5,-3,-2
KR_7704996867,14613,16852,238,251,4,10,11,4,7,12,0,1,0,0,13,17,0,1,2,1,1,0,0,1,0,0,10,540242,-2239,-13,-6,7,-5,-1,0,-4,-1,1
KR_7705030971,16208,13634,254,242,9,3,3,9,12,1,0,0,0,0,19,14,3,1,0,0,1,0,0,0,0,0,10,540240,2574,12,6,-6,11,0,0,5,2,0
KR_7705076396,14674,15113,267,284,3,4,4,3,3,5,0,0,0,0,17,22,2,6,2,1,1,0,0,0,0,0,10,540240,-439,-17,-1,1,-2,0,0,-5,-4,1
KR_7705183673,17130,16424,258,235,9,10,10,9,7,9,0,0,0,0,17,15,2,0,0,1,0,1,0,0,0,0,10,540252,706,23,-1,1,-2,0,0,2,2,-1
KR_7705263710,15159,16508,257,240,5,9,9,6,4,12,0,1,0,0,12,12,3,1,0,1,0,1,0,1,0,0,10,540278,-1349,17,-4,3,-8,-1,0,0,2,-1
KR_7705327968,16262,16278,246,240,9,9,9,9,11,7,1,0,0,0,17,13,2,3,1,2,1,0,1,0,0,0,10,540276,-16,6,0,0,4,1,0,4,-1,-1
KR_7705328894,14874,14010,289,292,3,0,0,3,4,0,0,0,0,0,16,16,3,1,0,0,1,0,0,0,0,0,10,540205,864,-3,3,-3,4,0,0,0,2,0
KR_7705357797,14149,15918,278,260,2,6,6,2,2,6,0,0,0,0,13,17,5,5,0,0,1,0,0,0,0,0,10,540214,-1769,18,-4,4,-4,0,0,-4,0,0
KR_7705358746,14880,16465,261,277,4,9,10,4,6,12,0,0,0,0,12,24,2,3,0,0,0,1,0,0,0,0,10,540251,-1585,-16,-5,6,-6,0,0,-12,-1,0
KR_7705481335,13616,15608,240,269,2,7,7,2,4,2,0,1,0,0,34,17,5,4,0,1,0,1,0,1,0,0,10,540284,-1992,-29,-5,5,2,-1,0,17,1,-1
KR_7705512727,14480,17612,269,271,3,10,10,3,5,18,0,0,0,0,38,15,1,3,0,0,0,1,0,0,0,0,10,540217,-3132,-2,-7,7,-13,0,0,23,-2,0
KR_7705550225,16408,13967,279,251,7,3,3,7,8,4,0,0,0,0,21,17,2,2,1,0,1,0,0,0,0,0,10,540201,2441,28,4,-4,4,0,0,4,0,1
KR_7705557693,14717,14995,276,267,4,5,5,4,1,5,0,1,0,0,12,18,3,1,0,0,1,0,0,1,0,0,10,540219,-278,9,-1,1,-4,-1,0,-6,2,0
KR_7705573778,13329,15084,249,262,2,6,6,2,1,5,1,0,0,0,13,14,3,1,1,0,0,1,1,0,0,0,10,540199,-1755,-13,-4,4,-4,1,0,-1,2,1
KR_7705589311,15086,16892,236,224,7,10,10,7,7,15,0,0,0,0,12,19,1,5,0,0,1,0,0,0,0,0,10,540241,-1806,12,-3,3,-8,0,0,-7,-4,0
KR_7705612312,15490,16077,207,269,8,7,7,8,10,6,0,1,0,0,18,11,2,5,1,0,1,0,0,1,0,0,10,540231,-587,-62,1,-1,4,-1,0,7,-3,1
KR_7705628733,14952,15322,252,263,4,6,6,4,3,6,0,1,0,0,31,16,3,2,1,1,0,1,0,1,0,0,10,540216,-370,-11,-2,2,-3,-1,0,15,1,0
KR_7705666500,16764,13789,269,254,9,3,4,9,10,2,0,0,0,0,19,16,5,1,2,0,1,0,0,0,0,0,10,540215,2975,15,6,-5,8,0,0,3,4,2
KR_7705699346,14469,15269,276,294,2,4,4,2,2,2,0,0,0,0,68,19,6,2,1,1,0,1,0,0,0,0,10,540257,-800,-18,-2,2,0,0,0,49,4,0
KR_7705715929,15223,17241,258,279,7,9,9,7,3,5,0,0,0,0,36,14,1,1,0,1,0,1,0,0,0,0,10,540151,-2018,-21,-2,2,-2,0,0,22,0,-1
KR_7705762238,15996,13023,302,262,6,1,1,6,6,1,0,1,0,0,65,14,1,1,0,0,1,0,0,1,0,0,10,540268,2973,40,5,-5,5,-1,0,51,0,0
KR_7705787546,14377,15031,253,264,4,5,5,4,5,6,0,0,0,0,14,34,5,3,0,0,1,0,0,0,0,0,10,540216,-654,-11,-1,1,-1,0,0,-20,2,0
KR_7705807694,15367,14768,269,272,6,3,3,6,4,7,0,1,0,0,14,18,4,4,2,0,1,0,0,1,0,0,10,540213,599,-3,3,-3,-3,-1,0,-4,0,2
KR_7706121421,15505,16203,263,255,6,6,6,6,8,8,1,0,0,0,12,29,3,2,0,1,1,0,1,0,0,0,10,540206,-698,8,0,0,0,1,0,-17,1,-1
KR_7706144008,16600,17506,225,248,10,10,10,10,12,10,0,0,0,0,110,18,3,3,0,1,1,0,0,0,0,0,10,540224,-906,-23,0,0,2,0,0,92,0,-1
KR_7706155911,15819,16754,255,278,6,7,7,6,6,7,0,0,0,0,16,216,1,5,0,3,0,1,0,0,0,0,10,540234,-935,-23,-1,1,-1,0,0,-200,-4,-3
KR_7706170024,14513,15957,231,284,4,6,6,4,4,4,0,0,0,0,11,23,2,1,1,0,0,1,0,0,0,0,10,540274,-1444,-53,-2,2,0,0,0,-12,1,1
KR_7706191689,16639,14871,266,254,8,5,5,8,11,4,0,0,0,0,20,11,1,3,1,1,0,1,0,0,0,0,10,540265,1768,12,3,-3,7,0,0,9,-2,0
KR_7706261456,15476,14777,286,262,5,5,5,5,7,6,1,0,0,0,19,19,5,4,0,1,0,1,1,0,0,0,10,540214,699,24,0,0,1,1,0,0,1,-1
KR_7706274917,14044,14481,227,246,5,4,4,5,2,7,0,0,0,0,12,15,1,3,0,3,1,0,0,0,0,0,10,540211,-437,-19,1,-1,-5,0,0,-3,-2,-3
KR_7706518935,16303,17980,241,243,7,13,13,7,7,17,0,0,0,0,14,20,5,2,0,1,0,1,0,0,0,0,10,540217,-1677,-2,-6,6,-10,0,0,-6,3,-1
KR_7706596434,13536,15932,254,270,2,7,7,2,3,3,1,0,0,0,17,15,3,2,0,0,0,1,1,0,0,0,10,540189,-2396,-16,-5,5,0,1,0,2,1,0
KR_7706749880,17375,14593,264,256,9,4,4,9,12,6,0,0,0,0,19,13,4,4,4,0,0,1,0,0,0,0,10,540261,2782,8,5,-5,6,0,0,6,0,4
KR_7706803563,15770,14183,267,273,6,2,2,6,9,4,0,0,0,0,16,69,0,2,1,1,1,0,0,0,0,0,10,540190,1587,-6,4,-4,5,0,0,-53,-2,0
KR_7706831223,14372,15467,262,267,3,6,6,3,2,9,0,0,0,0,38,17,2,5,0,0,0,1,0,0,0,0,10,540140,-1095,-5,-3,3,-7,0,0,21,-3,0
KR_7706953749,15938,16856,204,251,10,9,9,10,11,12,0,0,0,0,18,14,2,5,0,0,1,0,0,0,0,0,10,540271,-918,-47,1,-1,-1,0,0,4,-3,0
KR_7707079678,15101,14700,236,278,6,3,3,6,11,2,0,0,0,0,21,12,1,4,0,0,1,0,0,0,0,0,10,540254,401,-42,3,-3,9,0,0,9,-3,0
KR_7707137866,15196,14472,267,278,5,2,2,5,6,4,0,1,0,0,14,22,1,5,0,2,1,0,0,1,0,0,10,540229,724,-11,3,-3,2,-1,0,-8,-4,-2
KR_7707140424,16277,14441,258,274,8,2,2,8,15,4,0,1,0,0,40,14,3,5,0,2,1,0,0,1,0,0,10,540213,1836,-16,6,-6,11,-1,0,26,-2,-2
KR_7707171154,13258,15815,241,256,2,7,7,2,1,7,0,0,0,0,16,48,2,4,1,0,0,1,0,0,0,0,10,540233,-2557,-15,-5,5,-6,0,0,-32,-2,1
KR_7707184271,14671,14859,247,262,5,5,5,5,7,3,0,0,0,0,39,19,2,4,0,0,0,1,0,0,0,0,10,540189,-188,-15,0,0,4,0,0,20,-2,0
KR_7707279908,15794,16238,238,261,7,7,7,7,9,11,0,1,0,0,17,55,4,5,1,3,1,0,0,1,0,0,10,540249,-444,-23,0,0,-2,-1,0,-38,-1,-2
KR_7707303529,13579,17429,224,296,3,9,9,3,5,5,1,0,0,0,40,16,4,2,0,2,0,1,1,0,0,0,10,540217,-3850,-72,-6,6,0,1,0,24,2,-2
KR_7707321077,15321,15979,236,257,6,7,7,6,10,10,0,0,0,0,21,14,4,5,1,0,0,1,0,0,0,0,10,540244,-658,-21,-1,1,0,0,0,7,-1,1
KR_7707329565,14767,15309,245,257,6,5,5,6,5,10,0,1,0,0,22,17,1,5,0,1,1,0,0,1,0,0,10,540209,-542,-12,1,-1,-5,-1,0,5,-4,-1
KR_7707400856,14380,18925,240,231,3,17,17,3,2,18,0,1,0,0,16,19,3,2,2,2,0,1,0,1,0,0,10,540193,-4545,9,-14,14,-16,-1,0,-3,1,0
KR_7707421080,16299,14728,254,251,9,4,5,9,9,3,0,0,0,0,14,16,4,4,0,1,1,0,0,0,0,0,10,540270,1571,3,5,-4,6,0,0,-2,0,-1
KR_7707439860,14319,13368,266,249,3,2,2,3,2,2,0,1,0,0,16,14,3,3,0,0,1,0,0,1,0,0,10,540276,951,17,1,-1,0,-1,0,2,0,0
KR_7707469598,16543,15605,233,264,10,6,6,10,13,7,0,1,0,0,17,12,2,2,0,0,0,1,0,1,0,0,10,540261,938,-31,4,-4,6,-1,0,5,0,0
KR_7707585601,14744,16691,256,244,5,10,10,5,3,6,0,1,0,0,17,19,4,4,0,1,0,1,0,1,0,0,10,540221,-1947,12,-5,5,-3,-1,0,-2,0,-1
KR_7707604129,14597,14752,253,270,4,4,4,4,6,6,0,1,0,0,41,20,0,4,1,1,0,1,0,1,0,0,10,540241,-155,-17,0,0,0,-1,0,21,-4,0
KR_7707760676,2536,2525,1,0,0,0,0,0,0,0,0,0,0,0,2,2,0,0,0,0,0,0,0,0,0,0,3,101302,11,1,0,0,0,0,0,0,0,0
KR_7707775951,15454,14077,264,276,4,2,2,4,5,3,0,0,0,0,39,18,2,4,0,0,0,1,0,0,0,0,10,540240,1377,-12,2,-2,2,0,0,21,-2,0
KR_7707805197,15454,16250,252,250,7,8,8,7,6,7,0,0,0,0,19,14,0,3,0,0,0,1,0,0,0,0,10,540233,-796,2,-1,1,-1,0,0,5,-3,0
KR_7707824251,17784,13665,263,266,12,2,2,12,8,1,0,0,0,0,31,22,2,1,3,0,1,0,0,0,0,0,10,540186,4119,-3,10,-10,7,0,0,9,1,3
KR_7707833672,15664,13433,266,276,6,1,1,6,7,1,0,1,0,0,15,13,3,2,0,0,0,1,0,1,0,0,10,540241,2231,-10,5,-5,6,-1,0,2,1,0
KR_7707878557,2572,2551,1,0,0,0,0,0,0,0,0,0,0,0,1,2,0,0,0,0,0,0,0,0,0,0,3,104258,21,1,0,0,0,0,0,-1,0,0
KR_7707911214,16300,18209,215,247,8,11,12,8,11,12,0,0,0,0,19,118,2,2,1,4,0,1,0,0,0,0,10,540258,-1909,-32,-3,4,-1,0,0,-99,0,-3
KR_7707942932,14690,15178,234,265,5,5,5,5,7,4,1,0,0,0,34,15,3,4,0,1,0,1,1,0,0,0,10,540223,-488,-31,0,0,3,1,0,19,-1,-1
KR_7707985329,15413,13998,286,251,5,3,3,5,6,3,0,0,0,0,62,18,3,6,0,0,0,1,0,0,0,0,10,540217,1415,35,2,-2,3,0,0,44,-3,0
KR_7708017452,15231,15210,238,270,6,5,5,6,6,4,0,0,0,0,14,32,3,1,0,0,0,1,0,0,0,0,10,540219,21,-32,1,-1,2,0,0,-18,2,0
KR_7708054102,16173,14353,271,267,6,3,3,6,7,2,0,0,0,0,19,14,6,7,0,0,0,1,0,0,0,0,10,540187,1820,4,3,-3,5,0,0,5,-1,0
KR_7708068009,14622,16578,252,256,4,7,7,4,4,12,0,0,0,0,15,15,2,2,0,2,0,1,0,0,0,0,10,540252,-1956,-4,-3,3,-8,0,0,0,0,-2
KR_7708096618,14210,14648,293,287,1,2,2,1,2,4,0,0,0,0,62,41,2,3,1,1,0,1,0,0,0,0,10,540231,-438,6,-1,1,-2,0,0,21,-1,0
KR_7708116897,14450,15585,283,242,2,7,7,2,2,8,0,1,0,0,14,21,6,1,0,1,0,1,0,1,0,0,10,540250,-1135,41,-5,5,-6,-1,0,-7,5,-1
KR_7708148659,16658,14659,248,251,9,4,4,9,11,3,1,0,0,0,74,13,4,2,1,0,1,0,1,0,0,0,10,540201,1999,-3,5,-5,8,1,0,61,2,1
KR_7708175007,14867,15125,248,275,5,4,4,5,7,3,0,1,0,0,17,18,2,4,1,1,0,1,0,1,0,0,10,540229,-258,-27,1,-1,4,-1,0,-1,-2,0
KR_7708176744,15929,16185,269,302,6,4,4,6,7,3,0,0,0,0,18,88,4,4,0,3,1,0,0,0,0,0,10,540272,-256,-33,2,-2,4,0,0,-70,0,-3
KR_7708260534,15191,14537,255,268,5,3,3,5,7,3,1,0,0,0,15,16,0,2,1,2,1,0,1,0,0,0,10,540225,654,-13,2,-2,4,1,0,-1,-2,-1
KR_7708271351,17695,16805,258,249,11,9,9,11,8,8,0,0,0,0,17,14,1,3,2,1,0,1,0,0,0,0,10,540252,890,9,2,-2,0,0,0,3,-2,1
KR_7708276422,14896,14496,285,237,3,5,5,3,2,6,0,1,0,0,15,15,0,2,1,0,0,1,0,1,0,0,10,540214,400,48,-2,2,-4,-1,0,0,-2,1
KR_7708286432,15800,18478,228,242,7,15,15,7,9,16,1,0,0,0,20,12,3,2,1,0,0,1,1,0,0,0,10,540215,-2678,-14,-8,8,-7,1,0,8,1,1
KR_7708289906,16390,14613,259,239,8,4,4,8,12,10,0,0,0,0,17,15,0,3,0,0,1,0,0,0,0,0,10,540181,1777,20,4,-4,2,0,0,2,-3,0
KR_7708471355,15515,15317,263,285,6,4,4,6,9,7,0,0,0,0,21,16,5,3,0,1,1,0,0,0,0,0,10,540247,198,-22,2,-2,2,0,0,5,2,-1
KR_7708502744,15816,14696,272,258,5,5,5,5,9,6,0,0,0,0,140,17,2,3,1,1,1,0,0,0,0,0,10,540185,1120,14,0,0,3,0,0,123,-1,0
KR_7708544212,16933,14751,264,235,9,5,5,9,9,5,0,1,0,0,16,123,4,2,1,1,1,0,0,1,0,0,10,540314,2182,29,4,-4,4,-1,0,-107,2,0
KR_7708564729,14617,16529,269,285,4,8,8,4,1,10,0,0,0,0,32,271,2,1,1,1,0,1,0,0,0,0,10,540271,-1912,-16,-4,4,-9,0,0,-239,1,0
KR_7708723390,15975,14254,291,262,5,3,3,5,7,3,0,1,0,0,17,44,8,2,0,0,1,0,0,1,0,0,10,540259,1721,29,2,-2,4,-1,0,-27,6,0
KR_7708753283,14155,16398,280,267,3,8,8,3,2,10,0,1,0,0,16,13,3,3,1,0,1,0,0,1,0,0,10,540106,-2243,13,-5,5,-8,-1,0,3,0,1
KR_7708756980,16549,14174,270,286,7,2,2,7,8,2,0,0,0,0,12,13,4,2,0,0,1,0,0,0,0,0,10,540185,2375,-16,5,-5,6,0,0,-1,2,0
KR_7708777593,15811,14071,245,276,7,2,2,7,9,3,0,0,0,0,18,15,2,1,0,0,1,0,0,0,0,0,10,540241,1740,-31,5,-5,6,0,0,3,1,0
KR_7708818413,15180,13959,284,269,4,2,2,4,6,1,0,1,0,0,40,14,1,1,1,1,1,0,0,1,0,0,10,540236,1221,15,2,-2,5,-1,0,26,0,0
KR_7708838140,15004,14440,269,258,3,3,3,3,4,5,1,0,0,0,18,24,5,2,2,1,0,1,1,0,0,0,10,540177,564,11,0,0,-1,1,0,-6,3,1
KR_7708852849,14505,15869,278,278,2,7,7,2,4,7,0,0,0,0,18,18,1,6,0,0,0,1,0,0,0,0,10,540235,-1364,0,-5,5,-3,0,0,0,-5,0
KR_7708877552,14173,13756,246,241,2,3,3,2,4,1,0,0,0,0,15,26,3,4,3,0,0,1,0,0,0,0,10,540193,417,5,-1,1,3,0,0,-11,-1,3
KR_7708878504,15422,16372,226,240,8,8,8,8,10,11,0,0,0,0,14,28,2,3,3,1,1,0,0,0,0,0,10,540246,-950,-14,0,0,-1,0,0,-14,-1,2
KR_7708883880,15361,14938,270,278,6,4,4,6,7,5,0,0,0,0,17,12,6,5,0,0,1,0,0,0,0,0,10,540212,423,-8,2,-2,2,0,0,5,1,0
KR_7708905329,14681,13859,264,265,4,2,2,4,4,2,0,0,0,0,19,18,4,3,0,0,1,0,0,0,0,0,10,540184,822,-1,2,-2,2,0,0,1,1,0
KR_7708955893,2638,2598,3,1,0,0,0,0,0,0,0,0,0,0,1,2,0,0,0,0,0,0,0,0,0,0,3,107354,40,2,0,0,0,0,0,-1,0,0
KR_7708968638,15096,14825,324,276,2,3,3,2,4,4,0,1,0,0,18,16,2,3,0,0,1,0,0,1,0,0,10,540204,271,48,-1,1,0,-1,0,2,-1,0
KR_7708985495,15822,16611,235,261,8,8,8,8,10,8,0,0,0,0,16,14,1,3,0,1,1,0,0,0,0,0,10,540222,-789,-26,0,0,2,0,0,2,-2,-1
KR_7709007911,16438,16300,277,276,8,7,7,8,13,9,0,0,0,0,18,18,2,2,0,1,1,0,0,0,0,0,10,540212,138,1,1,-1,4,0,0,0,0,-1
KR_7709026277,13508,15827,233,285,2,5,5,2,3,7,0,0,0,0,33,20,2,0,0,1,1,0,0,0,0,0,10,540224,-2319,-52,-3,3,-4,0,0,13,2,-1
KR_7709032454,13357,15689,247,264,2,6,6,2,3,8,0,0,0,0,29,18,5,3,0,1,1,0,0,0,0,0,10,540274,-2332,-17,-4,4,-5,0,0,11,2,-1
KR_7709033729,14738,14791,254,281,4,3,3,4,4,2,0,0,0,0,17,18,2,0,0,2,0,1,0,0,0,0,10,540237,-53,-27,1,-1,2,0,0,-1,2,-2
KR_7709048220,16122,16913,246,252,8,9,9,8,9,5,0,0,0,0,18,16,3,4,2,3,1,0,0,0,0,0,10,540246,-791,-6,-1,1,4,0,0,2,-1,-1
KR_7709078287,15226,15324,268,286,5,4,4,5,8,5,1,0,0,0,22,21,2,5,2,1,1,0,1,0,0,0,10,540232,-98,-18,1,-1,3,1,0,1,-3,1
KR_7709080368,16115,14940,259,251,10,5,6,10,7,5,0,1,0,0,18,14,3,4,0,0,0,1,0,1,0,0,10,540205,1175,8,5,-4,2,-1,0,4,-1,0
KR_7709082825,15813,16299,235,246,8,10,10,8,8,6,0,0,0,0,19,14,4,3,3,0,1,0,0,0,0,0,10,540152,-486,-11,-2,2,2,0,0,5,1,3
KR_7709098689,15753,16905,276,272,5,8,8,5,8,19,0,0,0,0,37,11,1,3,2,0,0,1,0,0,0,0,10,540221,-1152,4,-3,3,-11,0,0,26,-2,2
KR_7709117514,16144,15881,266,264,8,7,7,8,6,7,0,0,0,0,16,17,3,5,0,0,0,1,0,0,0,0,10,540210,263,2,1,-1,-1,0,0,-1,-2,0
KR_7709123769,14379,17104,266,294,4,9,9,4,3,10,0,0,0,0,16,27,5,3,0,1,0,1,0,0,0,0,10,540112,-2725,-28,-5,5,-7,0,0,-11,2,-1
KR_7709134287,17318,14682,263,231,10,5,5,11,8,5,0,0,0,0,17,51,0,3,1,0,0,1,0,0,0,0,10,540204,2636,32,5,-6,3,0,0,-34,-3,1
KR_7709149019,16190,14873,242,254,8,4,4,8,14,4,0,0,0,0,18,17,2,0,0,2,1,0,0,0,0,0,10,540204,1317,-12,4,-4,10,0,0,1,2,-2
KR_7709161715,13370,15292,261,291,1,4,4,1,1,5,0,1,0,0,13,16,4,2,0,0,0,1,0,1,0,0,10,540259,-1922,-30,-3,3,-4,-1,0,-3,2,0
KR_7709177653,13422,14974,278,262,0,4,4,0,0,4,0,1,0,0,16,41,3,3,1,1,0,1,0,1,0,0,10,540217,-1552,16,-4,4,-4,-1,0,-25,0,0
KR_7709188080,14779,13052,279,232,4,2,2,4,2,1,0,1,0,0,17,34,2,2,0,0,0,1,0,1,0,0,10,540206,1727,47,2,-2,1,-1,0,-17,0,0
KR_7709194766,15199,14817,292,295,4,3,3,4,5,3,0,1,0,0,16,14,0,2,1,0,1,0,0,1,0,0,10,540195,382,-3,1,-1,2,-1,0,2,-2,1
KR_7709234770,14610,13297,220,255,6,2,2,6,7,0,0,0,0,0,19,33,6,4,0,1,0,1,0,0,0,0,10,540265,1313,-35,4,-4,7,0,0,-14,2,-1
KR_7709244710,15546,15804,275,249,5,6,6,5,8,6,1,0,0,0,16,16,4,3,0,0,1,0,1,0,0,0,10,540200,-258,26,-1,1,2,1,0,0,1,0
KR_7709280065,15798,13830,267,280,6,2,2,7,5,4,0,1,0,0,32,15,2,3,1,0,0,1,0,1,0,0,10,540134,1968,-13,4,-5,1,-1,0,17,-1,1
KR_7709321309,16447,15116,280,283,7,4,4,7,10,6,0,1,0,0,15,13,2,3,0,1,1,0,0,1,0,0,10,540116,1331,-3,3,-3,4,-1,0,2,-1,-1
KR_7709333578,14849,15032,243,271,5,5,5,5,5,4,0,0,0,0,32,18,4,1,0,0,0,1,0,0,0,0,10,540228,-183,-28,0,0,1,0,0,14,3,0
KR_7709353272,15918,13553,274,263,7,2,2,7,6,2,0,1,0,0,23,18,4,3,0,1,1,0,0,1,0,0,10,540242,2365,11,5,-5,4,-1,0,5,1,-1
KR_7709373980,14428,18210,245,284,4,13,13,4,2,10,1,0,0,0,104,17,3,5,0,2,0,1,1,0,0,0,10,540226,-3782,-39,-9,9,-8,1,0,87,-2,-2
KR_7709374732,14340,14042,237,247,5,3,3,5,7,3,1,0,0,0,14,13,1,1,0,1,1,0,1,0,0,0,10,540204,298,-10,2,-2,4,1,0,1,0,-1
KR_7709398498,16376,16320,194,247,10,8,8,10,13,10,0,0,0,0,35,19,5,3,1,2,1,0,0,0,0,0,10,540238,56,-53,2,-2,3,0,0,16,2,-1
KR_7709407018,15405,17064,248,254,6,9,9,6,9,10,0,1,0,0,41,15,2,9,1,1,0,1,0,1,0,0,10,540183,-1659,-6,-3,3,-1,-1,0,26,-7,0
KR_7709463292,16728,15398,268,265,9,5,5,9,7,4,0,1,0,0,17,15,5,3,1,2,0,1,0,1,0,0,10,540260,1330,3,4,-4,3,-1,0,2,2,-1
KR_7709484463,13798,14363,277,296,2,2,2,2,2,4,0,1,0,0,15,22,5,4,0,0,1,0,0,1,0,0,10,540240,-565,-19,0,0,-2,-1,0,-7,1,0
KR_7709504486,15458,15144,267,230,6,6,6,6,9,9,1,0,0,0,116,18,4,1,1,0,1,0,1,0,0,0,10,540113,314,37,0,0,0,1,0,98,3,1
KR_7709537295,15553,13881,300,269,4,2,2,4,4,0,0,1,0,0,14,15,2,1,2,0,1,0,0,1,0,0,10,540226,1672,31,2,-2,4,-1,0,-1,1,2
KR_7709539289,17305,12833,285,238,9,1,1,9,13,2,0,0,0,0,16,17,3,4,2,0,1,0,0,0,0,0,10,540249,4472,47,8,-8,11,0,0,-1,-1,2
KR_7709569429,18188,14609,241,246,14,4,4,14,18,6,1,0,0,0,17,17,3,1,2,0,1,0,1,0,0,0,10,540239,3579,-5,10,-10,12,1,0,0,2,2
KR_7709767749,14042,17306,238,283,4,9,9,4,3,9,0,0,0,0,18,17,4,2,0,1,0,1,0,0,0,0,10,540142,-3264,-45,-5,5,-6,0,0,1,2,-1
KR_7709834779,16072,14426,242,244,8,4,4,8,14,6,0,0,0,0,21,18,1,2,0,0,1,0,0,0,0,0,10,540250,1646,-2,4,-4,8,0,0,3,-1,0
KR_7709975879,17563,14607,256,288,10,1,1,10,15,1,1,0,0,0,19,14,3,4,1,1,1,0,1,0,0,0,10,540272,2956,-32,9,-9,14,1,0,5,-1,0
KR_7710028147,15266,14647,298,297,4,1,1,4,8,1,0,0,0,0,14,36,2,6,1,3,0,1,0,0,0,0,10,540185,619,1,3,-3,7,0,0,-22,-4,-2
KR_7710071595,15492,16161,243,248,6,9,9,6,9,13,0,0,0,0,27,18,3,2,1,0,1,0,0,0,0,0,10,540180,-669,-5,-3,3,-4,0,0,9,1,1
KR_7710111919,13807,14888,260,280,2,4,4,2,3,4,0,0,0,0,16,95,4,1,0,1,0,1,0,0,0,0,10,540290,-1081,-20,-2,2,-1,0,0,-79,3,-1
KR_7710176246,15917,13814,283,274,7,2,2,7,5,2,0,0,0,0,16,14,3,5,0,0,1,0,0,0,0,0,10,540223,2103,9,5,-5,3,0,0,2,-2,0
KR_7710211819,15574,14056,273,273,5,2,2,5,9,3,0,1,0,0,17,16,2,1,1,0,0,1,0,1,0,0,10,540248,1518,0,3,-3,6,-1,0,1,1,1
KR_7710220288,16430,15157,281,278,7,4,4,7,9,5,0,0,0,0,21,16,2,4,0,0,1,0,0,0,0,0,10,540182,1273,3,3,-3,4,0,0,5,-2,0
KR_7710221084,17015,13625,277,221,10,3,3,10,7,3,0,0,0,0,23,11,5,1,2,2,1,0,0,0,0,0,10,540206,3390,56,7,-7,4,0,0,12,4,0
KR_7710262499,15470,14630,296,289,4,2,2,4,7,2,0,0,0,0,21,16,3,6,0,0,1,0,0,0,0,0,10,540247,840,7,2,-2,5,0,0,5,-3,0
KR_7710292139,14711,13765,298,272,3,1,1,3,2,1,0,1,0,0,14,13,2,2,0,0,0,1,0,1,0,0,10,540165,946,26,2,-2,1,-1,0,1,0,0
KR_7710293927,15364,14609,277,285,5,3,3,5,5,2,0,1,0,0,14,13,3,4,1,0,1,0,0,1,0,0,10,540278,755,-8,2,-2,3,-1,0,1,-1,1
KR_7710312480,15563,16696,270,284,6,6,6,6,11,5,0,0,0,0,15,32,8,5,0,1,0,1,0,0,0,0,10,540253,-1133,-14,0,0,6,0,0,-17,3,-1
KR_7710417966,15610,13578,284,279,5,1,1,5,7,3,0,1,0,0,15,16,2,1,0,0,0,1,0,1,0,0,10,540124,2032,5,4,-4,4,-1,0,-1,1,0
KR_7710545628,2525,2525,0,0,0,0,0,0,0,0,0,0,0,0,0,2,0,0,0,0,0,0,0,0,0,0,3,102621,0,0,0,0,0,0,0,-2,0,0
KR_7710571345,15978,15302,262,245,7,7,7,7,11,15,0,0,0,0,11,12,3,2,0,1,1,0,0,0,0,0,10,540238,676,17,0,0,-4,0,0,-1,1,-1
KR_7710585765,17385,14414,274,259,10,3,3,10,12,4,0,0,0,0,15,14,3,2,2,0,1,0,0,0,0,0,10,540225,2971,15,7,-7,8,0,0,1,1,2
KR_7710632041,16235,14731,298,277,6,4,4,6,6,1,0,0,0,0,15,15,4,4,0,0,0,1,0,0,0,0,10,540217,1504,21,2,-2,5,0,0,0,0,0
KR_7710656835,15631,15755,242,300,8,4,4,8,12,3,1,0,0,0,19,17,3,1,0,1,0,1,1,0,0,0,10,540081,-124,-58,4,-4,9,1,0,2,2,-1
KR_7710752499,16686,14096,300,256,7,3,3,7,11,4,0,0,0,0,17,16,4,5,1,0,1,0,0,0,0,0,10,540268,2590,44,4,-4,7,0,0,1,-1,1
KR_7710897772,16034,15292,258,229,7,7,7,7,9,9,0,1,0,0,35,15,2,3,0,0,1,0,0,1,0,0,10,540276,742,29,0,0,0,-1,0,20,-1,0
KR_7711131058,14732,14898,295,258,2,4,4,2,1,9,0,0,0,0,18,16,3,1,1,0,0,1,0,0,0,0,10,540213,-166,37,-2,2,-8,0,0,2,2,1
KR_7711212721,16006,13336,254,245,7,2,2,7,12,2,1,0,0,0,15,17,2,2,2,0,1,0,1,0,0,0,10,540249,2670,9,5,-5,10,1,0,-2,0,2
KR_7711364484,14073,16270,268,272,2,8,8,2,3,10,0,1,0,0,22,203,0,4,0,1,1,0,0,1,0,0,10,540232,-2197,-4,-6,6,-7,-1,0,-181,-4,-1
KR_7711430943,14237,13484,282,263,3,2,2,3,1,1,1,0,0,0,16,18,3,1,1,0,1,0,1,0,0,0,10,540118,753,19,1,-1,0,1,0,-2,2,1
KR_7711817285,15586,13895,228,261,9,2,2,9,6,1,0,0,0,0,32,16,1,4,1,3,1,0,0,0,0,0,10,540237,1691,-33,7,-7,5,0,0,16,-3,-2
KR_7711838247,15267,14683,247,241,6,5,5,6,10,6,0,0,0,0,41,19,3,3,1,0,0,1,0,0,0,0,10,540201,584,6,1,-1,4,0,0,22,0,1
KR_7711859326,13755,16650,241,265,3,9,9,3,2,5,0,0,0,0,15,16,2,3,0,1,1,0,0,0,0,0,10,540260,-2895,-24,-6,6,-3,0,0,-1,-1,-1
KR_7711866891,14197,14650,277,286,2,3,3,2,2,4,0,1,0,0,14,18,2,2,0,0,1,0,0,1,0,0,10,540292,-453,-9,-1,1,-2,-1,0,-4,0,0
KR_7711883752,15890,16725,216,249,10,9,9,10,24,16,1,0,0,0,23,13,1,7,0,0,1,0,1,0,0,0,10,540206,-835,-33,1,-1,8,1,0,10,-6,0
KR_7711940760,16664,14996,284,231,6,6,6,6,8,7,1,0,0,0,12,15,3,6,4,0,1,0,1,0,1,0,10,540241,1668,53,0,0,1,1,0,-3,-3,4
KR_7711979466,14319,13531,277,270,3,2,2,3,2,1,0,0,0,0,12,14,2,2,0,0,1,0,0,0,0,0,10,540098,788,7,1,-1,1,0,0,-2,0,0
KR_7712161011,15666,12491,291,250,4,0,0,4,6,0,0,0,0,0,14,12,2,3,2,0,1,0,0,0,0,0,10,540226,3175,41,4,-4,6,0,0,2,-1,2
KR_7712290720,15469,13765,277,243,6,3,3,6,5,2,1,0,0,0,18,22,4,2,0,0,0,1,1,0,0,0,10,540246,1704,34,3,-3,3,1,0,-4,2,0
KR_7712377084,15984,12582,231,258,11,0,0,11,7,0,0,1,0,0,24,13,3,6,2,0,1,0,0,1,0,0,10,540241,3402,-27,11,-11,7,-1,0,11,-3,2
KR_7712414366,15804,15456,247,227,6,8,8,6,5,7,0,1,0,0,14,17,6,0,2,0,0,1,0,1,0,0,10,540195,348,20,-2,2,-2,-1,0,-3,6,2
KR_7712464160,14880,16697,258,260,5,9,9,5,5,14,0,1,0,0,20,12,1,4,0,1,0,1,0,1,0,0,10,540220,-1817,-2,-4,4,-9,-1,0,8,-3,-1
KR_7712774085,16228,17441,216,241,9,11,11,9,8,11,0,0,0,0,17,17,3,8,1,1,0,1,0,0,0,0,10,540196,-1213,-25,-2,2,-3,0,0,0,-5,0
KR_7712848430,14063,16208,258,271,3,7,7,3,2,6,0,0,0,0,23,29,3,5,0,1,0,1,0,0,0,0,10,540192,-2145,-13,-4,4,-4,0,0,-6,-2,-1
KR_7712979811,16513,14101,276,254,9,3,3,9,5,1,1,0,0,0,17,18,3,2,2,1,1,0,1,0,0,0,10,540206,2412,22,6,-6,4,1,0,-1,1,1
KR_7713028550,15880,14007,278,265,6,3,3,6,7,2,0,0,0,0,20,16,4,5,1,0,1,0,0,0,0,0,10,540244,1873,13,3,-3,5,0,0,4,-1,1
KR_7713040196,16643,16205,257,259,8,8,8,8,9,9,0,1,0,0,36,114,3,5,0,2,1,0,0,1,0,0,10,540226,438,-2,0,0,0,-1,0,-78,-2,-2
KR_7713066114,16378,15799,262,254,7,6,6,7,8,7,0,0,0,0,17,17,2,8,1,0,1,0,0,0,0,0,10,540192,579,8,1,-1,1,0,0,0,-6,1
KR_7713075399,15268,14677,248,250,6,4,4,6,7,6,0,1,0,0,18,39,1,3,0,0,1,0,0,1,0,0,10,540279,591,-2,2,-2,1,-1,0,-21,-2,0
KR_7713086875,16209,15052,265,265,5,5,5,5,8,6,0,0,0,0,13,14,4,4,1,0,0,1,0,0,0,0,10,540271,1157,0,0,0,2,0,0,-1,0,1
KR_7713116100,14264,14354,271,257,3,4,4,3,1,1,0,1,0,0,16,18,2,5,0,1,0,1,0,1,0,0,10,540266,-90,14,-1,1,0,-1,0,-2,-3,-1
KR_7713117547,15661,13260,265,256,7,1,1,7,3,3,0,0,0,0,19,11,1,3,0,0,1,0,0,0,0,0,10,540239,2401,9,6,-6,0,0,0,8,-2,0
KR_7713135884,14309,15525,244,240,4,7,7,4,4,8,0,0,0,0,16,14,2,2,0,0,0,1,0,0,0,0,10,540214,-1216,4,-3,3,-4,0,0,2,0,0
KR_7713352101,14624,14856,276,280,3,4,4,3,5,3,0,1,0,0,19,14,2,3,1,1,0,1,0,1,0,0,10,540199,-232,-4,-1,1,2,-1,0,5,-1,0
KR_7713378867,14676,15909,277,284,4,6,6,4,2,7,0,0,0,0,18,13,4,3,0,0,1,0,0,0,0,0,10,540230,-1233,-7,-2,2,-5,0,0,5,1,0
KR_7713390239,15742,16826,261,256,6,7,7,6,8,12,0,0,0,0,14,21,3,3,1,1,1,0,0,0,0,0,10,540234,-1084,5,-1,1,-4,0,0,-7,0,0
KR_7713418016,15584,14134,300,267,5,2,2,5,5,1,0,0,0,0,16,15,2,2,0,0,1,0,0,0,0,0,10,540232,1450,33,3,-3,4,0,0,1,0,0
KR_7713458117,14811,16177,275,282,4,7,7,4,3,6,1,0,0,0,21,66,3,5,0,1,1,0,1,0,0,0,10,540247,-1366,-7,-3,3,-3,1,0,-45,-2,-1
KR_7713478071,13772,18772,240,290,3,12,12,3,3,17,0,1,0,0,16,22,3,5,0,2,0,1,0,1,0,0,10,540203,-5000,-50,-9,9,-14,-1,0,-6,-2,-2
KR_7713487202,15291,14826,245,254,6,4,4,6,9,3,0,0,0,0,36,19,5,1,0,0,1,0,0,0,0,0,10,540200,465,-9,2,-2,6,0,0,17,4,0
KR_7713546516,14340,14351,256,265,3,3,3,3,5,4,0,1,0,0,15,20,4,2,1,0,1,0,0,1,0,0,10,540240,-11,-9,0,0,1,-1,0,-5,2,1
KR_7713714366,15400,15878,266,282,6,6,6,6,5,5,0,1,0,0,28,18,1,2,0,0,0,1,0,1,0,0,10,540267,-478,-16,0,0,0,-1,0,10,-1,0
KR_7713738881,15310,15739,265,244,5,6,6,5,4,6,0,0,0,0,16,15,4,1,2,2,1,0,0,0,0,0,10,540251,-429,21,-1,1,-2,0,0,1,3,0
KR_7713787785,14438,17275,262,250,3,11,11,3,4,10,0,1,0,0,18,15,3,3,0,0,0,1,0,1,0,0,10,540280,-2837,12,-8,8,-6,-1,0,3,0,0
KR_7713848084,13923,14821,250,259,3,5,5,4,6,6,0,0,0,0,26,16,3,4,0,1,0,1,0,0,0,0,10,540262,-898,-9,-2,1,0,0,0,10,-1,-1
KR_7713897639,14428,15546,292,281,2,6,6,2,4,6,1,0,0,0,12,13,2,4,1,1,0,1,1,0,0,0,10,540235,-1118,11,-4,4,-2,1,0,-1,-2,0
KR_7713898811,15382,15279,264,270,5,4,4,5,9,4,0,0,0,0,14,18,3,2,2,1,1,0,0,0,0,0,10,540259,103,-6,1,-1,5,0,0,-4,1,1
KR_7713935464,15985,14503,275,276,6,3,3,6,4,2,0,0,0,0,17,17,3,4,0,0,0,1,0,0,0,0,10,540090,1482,-1,3,-3,2,0,0,0,-1,0
KR_7713994661,14488,13429,255,258,4,1,1,4,6,1,0,0,0,0,19,37,1,2,2,1,1,0,0,0,0,0,10,540213,1059,-3,3,-3,5,0,0,-18,-1,1
KR_7714008314,17684,15260,226,260,13,4,4,13,16,7,0,0,0,0,16,15,3,5,3,1,1,0,0,0,0,0,10,540223,2424,-34,9,-9,9,0,0,1,-2,2
KR_7714043737,15338,14897,262,239,5,6,6,5,6,5,0,0,0,0,23,19,6,1,3,0,0,1,0,0,0,0,10,540101,441,23,-1,1,1,0,0,4,5,3
KR_7714081011,14557,16209,289,290,3,6,6,3,3,9,0,1,0,0,21,15,4,5,1,1,1,0,0,1,0,0,10,540104,-1652,-1,-3,3,-6,-1,0,6,-1,0
KR_7714091140,14384,15462,237,280,5,4,4,6,8,4,0,0,0,0,27,15,2,3,0,1,0,1,0,0,0,0,10,540189,-1078,-43,1,-2,4,0,0,12,-1,-1
KR_7714117282,16956,15774,201,222,12,9,9,12,14,8,0,0,0,0,13,14,4,2,0,1,1,0,0,0,0,0,10,540232,1182,-21,3,-3,6,0,0,-1,2,-1
KR_7714137358,15009,15614,249,271,6,5,5,6,6,6,1,0,0,0,13,15,1,2,0,2,0,1,1,0,0,0,10,540254,-605,-22,1,-1,0,1,0,-2,-1,-2
KR_7714183988,15713,15383,289,262,6,5,5,6,4,7,1,0,0,0,15,33,4,6,0,1,1,0,1,0,0,0,10,540210,330,27,1,-1,-3,1,0,-18,-2,-1
KR_7714215037,15489,16003,242,234,7,9,9,7,5,15,0,0,0,0,19,36,1,4,2,0,0,1,0,0,0,0,10,540205,-514,8,-2,2,-10,0,0,-17,-3,2
KR_7714227721,15497,15236,269,243,5,7,7,5,6,5,1,0,0,0,16,18,2,2,0,0,1,0,1,0,0,0,10,540206,261,26,-2,2,1,1,0,-2,0,0
KR_7714423158,14803,14472,303,303,2,2,2,2,2,3,1,0,0,0,22,17,4,4,0,0,0,1,1,0,0,0,10,540218,331,0,0,0,-1,1,0,5,0,0
KR_7714503867,16709,16266,252,274,9,7,7,9,11,6,0,1,0,0,31,33,9,2,0,1,0,1,0,1,0,0,10,540269,443,-22,2,-2,5,-1,0,-2,7,-1
KR_7714548134,13886,15825,272,305,2,6,6,2,3,4,0,1,0,0,15,17,5,1,0,2,0,1,0,1,0,0,10,540301,-1939,-33,-4,4,-1,-1,0,-2,4,-2
KR_7714562817,16118,17152,239,279,7,9,9,7,9,9,1,0,0,0,26,16,2,3,0,2,0,1,1,0,0,0,10,540209,-1034,-40,-2,2,0,1,0,10,-1,-2
KR_7714583210,14667,14226,279,264,5,3,3,5,7,6,0,1,0,0,21,13,2,3,0,0,1,0,0,1,0,0,10,540238,441,15,2,-2,1,-1,0,8,-1,0
KR_7714584793,15494,14894,270,256,6,5,7,6,8,5,1,0,0,0,11,18,5,2,0,0,0,1,1,0,0,0,10,540229,600,14,1,1,3,1,0,-7,3,0
KR_7714616933,15794,14916,257,262,5,5,5,5,8,4,0,1,0,0,13,16,5,2,1,1,0,1,0,1,0,0,10,540273,878,-5,0,0,4,-1,0,-3,3,0
KR_7714624681,14957,14834,295,288,4,3,3,4,7,5,0,0,0,0,19,26,4,10,0,0,1,0,0,0,0,0,10,540242,123,7,1,-1,2,0,0,-7,-6,0
KR_7714660161,14569,15531,265,270,3,5,5,3,3,4,0,0,0,0,122,17,5,1,1,2,0,1,0,0,0,0,10,540233,-962,-5,-2,2,-1,0,0,105,4,-1
KR_7714691700,15268,14426,306,302,4,1,1,4,3,2,1,0,0,0,13,12,2,1,1,0,1,0,1,0,0,0,10,540190,842,4,3,-3,1,1,0,1,1,1
KR_7714736405,14414,13574,280,303,3,0,0,3,2,0,1,0,0,0,15,10,3,3,1,0,1,0,1,0,0,0,10,540214,840,-23,3,-3,2,1,0,5,0,1
KR_7714797192,17114,13743,289,233,8,2,2,8,5,3,0,0,0,0,16,18,1,1,2,3,1,0,0,0,0,0,10,540208,3371,56,6,-6,2,0,0,-2,0,-1
KR_7714839021,18833,15002,285,258,11,5,5,11,23,11,0,1,0,0,24,18,5,4,1,0,0,1,0,1,0,0,10,540210,3831,27,6,-6,12,-1,0,6,1,1
KR_7714857947,15333,13366,274,228,5,2,2,5,5,4,1,0,0,0,18,14,4,2,0,0,1,0,1,0,0,0,10,540216,1967,46,3,-3,1,1,0,4,2,0
KR_7714898155,15815,14738,278,226,6,7,7,6,4,5,0,0,0,0,39,14,3,1,0,0,1,0,0,0,0,0,10,540127,1077,52,-1,1,-1,0,0,25,2,0
KR_7714899393,15141,16151,268,274,5,6,6,5,6,10,0,1,0,0,71,19,4,5,0,1,0,1,0,1,0,0,10,540238,-1010,-6,-1,1,-4,-1,0,52,-1,-1
KR_7714982340,15344,15289,265,256,6,5,5,6,3,7,0,0,0,0,19,17,2,3,0,1,1,0,0,0,0,0,10,540208,55,9,1,-1,-4,0,0,2,-1,-1
KR_7714991199,17283,15631,281,255,9,6,6,9,10,4,1,0,0,0,35,13,3,5,1,0,0,1,1,0,0,0,10,540261,1652,26,3,-3,6,1,0,22,-2,1
KR_7715047817,15306,15664,264,276,5,5,5,5,7,7,0,0,0,0,13,13,4,1,1,1,1,0,0,0,0,0,10,540212,-358,-12,0,0,0,0,0,0,3,0
KR_7715061621,13872,15845,220,271,4,6,7,4,5,3,1,0,0,0,164,35,4,3,0,2,0,1,1,0,0,0,10,540216,-1973,-51,-2,3,2,1,0,129,1,-2
KR_7715098297,15553,13669,279,266,6,2,2,6,6,2,0,1,0,0,25,16,7,3,0,1,1,0,0,1,0,0,10,540207,1884,13,4,-4,4,-1,0,9,4,-1
KR_7715149839,15023,15544,262,267,5,5,5,5,5,6,1,0,0,0,16,16,4,3,0,0,1,0,1,0,0,0,10,540271,-521,-5,0,0,-1,1,0,0,1,0
KR_7715157190,13900,14197,295,278,1,2,2,1,1,3,0,0,0,0,18,14,2,5,0,0,1,0,0,0,0,0,10,540245,-297,17,-1,1,-2,0,0,4,-3,0
KR_7715180330,14873,15765,287,278,3,6,6,3,1,8,0,1,0,0,14,17,2,4,1,2,0,1,0,1,0,0,10,540238,-892,9,-3,3,-7,-1,0,-3,-2,-1
KR_7715185849,16174,16785,247,219,8,9,9,8,9,12,0,0,0,0,18,15,3,3,0,1,1,0,0,0,0,0,10,540209,-611,28,-1,1,-3,0,0,3,0,-1
KR_7715197998,15797,15416,295,289,5,5,5,5,2,3,0,0,0,0,19,14,2,4,2,0,1,0,0,0,0,0,10,540249,381,6,0,0,-1,0,0,5,-2,2
KR_7715206588,14274,15324,237,247,5,7,7,5,1,5,0,0,0,0,16,13,4,3,0,1,0,1,0,0,0,0,10,540266,-1050,-10,-2,2,-4,0,0,3,1,-1
KR_7715230121,17004,15296,273,268,9,5,5,9,10,7,1,0,0,0,17,13,2,2,1,0,0,1,1,0,0,0,10,540216,1708,5,4,-4,3,1,0,4,0,1
KR_7715236277,14208,15758,278,248,1,8,8,1,0,9,0,0,0,0,35,18,3,2,1,0,0,1,0,0,0,0,10,540225,-1550,30,-7,7,-9,0,0,17,1,1
KR_7715246006,19137,16333,253,231,16,7,7,16,15,11,0,0,0,0,16,42,3,3,1,1,1,0,0,0,0,0,10,540222,2804,22,9,-9,4,0,0,-26,0,0
KR_7715258086,15640,14282,252,198,7,6,6,7,12,8,0,0,0,0,17,19,5,6,1,0,0,1,0,0,0,0,10,540252,1358,54,1,-1,4,0,0,-2,-1,1
KR_7715270601,13936,14953,269,258,2,5,5,2,2,7,0,0,0,0,17,24,1,2,1,0,1,0,0,0,0,0,10,540250,-1017,11,-3,3,-5,0,0,-7,-1,1
KR_7715277023,14623,14843,249,240,4,6,6,4,5,7,0,0,0,0,13,18,2,3,1,0,1,0,0,0,0,0,10,540250,-220,9,-2,2,-2,0,0,-5,-1,1
KR_7715279849,14616,15373,194,257,7,5,5,7,11,8,0,0,0,0,17,13,0,5,0,0,1,0,0,0,0,0,10,540222,-757,-63,2,-2,3,0,0,4,-5,0
KR_7715304227,15202,17145,256,258,4,11,12,4,6,11,0,1,0,0,14,22,1,4,2,1,0,1,0,1,0,0,10,540238,-1943,-2,-7,8,-5,-1,0,-8,-3,1
KR_7715451509,15647,17990,261,268,7,11,11,7,4,12,0,1,0,0,14,14,3,5,0,0,1,0,0,1,0,0,10,540222,-2343,-7,-4,4,-8,-1,0,0,-2,0
KR_7715470531,15210,14007,305,286,3,1,1,3,5,1,1,0,0,0,21,12,3,5,0,0,0,1,1,0,0,0,10,540225,1203,19,2,-2,4,1,0,9,-2,0
KR_7715501071,18024,15348,233,214,12,8,8,12,17,8,0,0,0,0,37,16,5,1,2,2,1,0,0,0,0,0,10,540231,2676,19,4,-4,9,0,0,21,4,0
KR_7715512817,14131,14086,275,259,3,3,3,3,1,4,0,1,0,0,21,30,0,7,0,0,0,1,0,1,0,0,10,540213,45,16,0,0,-3,-1,0,-9,-7,0
KR_7715522443,16260,15258,242,275,9,6,6,9,11,3,0,1,0,0,34,17,4,2,0,0,0,1,0,1,0,0,10,540228,1002,-33,3,-3,8,-1,0,17,2,0
KR_7715527505,16206,16416,240,226,8,9,9,8,10,10,0,1,0,0,139,18,3,5,2,0,1,0,0,1,0,0,10,540257,-210,14,-1,1,0,-1,0,121,-2,2
KR_7715546520,13711,15692,262,264,2,7,7,2,0,8,0,0,0,0,15,16,2,3,0,0,0,1,0,0,0,0,10,540262,-1981,-2,-5,5,-8,0,0,-1,-1,0
KR_7715556457,14236,16357,267,298,3,6,6,3,2,7,1,0,0,0,13,17,3,0,0,1,0,1,1,0,0,0,10,540206,-2121,-31,-3,3,-5,1,0,-4,3,-1
KR_7715586125,16202,15189,246,260,9,5,5,9,9,4,0,0,0,0,16,14,3,3,0,0,0,1,0,0,0,0,10,540244,1013,-14,4,-4,5,0,0,2,0,0
KR_7715590510,15361,14750,259,259,6,4,4,7,7,6,1,0,0,0,13,15,2,2,1,0,0,1,1,0,0,0,10,540210,611,0,2,-3,1,1,0,-2,0,1
KR_7715599907,14319,15593,269,261,4,7,7,4,2,9,0,0,0,0,18,19,4,3,0,1,1,0,0,0,0,0,10,540246,-1274,8,-3,3,-7,0,0,-1,1,-1
KR_7715606016,14562,15562,276,258,3,7,7,3,5,6,1,0,0,0,12,16,3,6,2,0,1,0,1,0,0,0,10,540265,-1000,18,-4,4,-1,1,0,-4,-3,2
KR_7715613488,15160,14947,279,300,4,3,3,4,5,3,1,0,0,0,21,30,5,3,1,0,0,1,1,0,0,0,10,540230,213,-21,1,-1,2,1,0,-9,2,1
KR_7715632851,15135,15398,237,276,5,4,4,5,7,5,0,0,0,0,12,17,7,4,1,1,0,1,0,0,0,0,10,540252,-263,-39,1,-1,2,0,0,-5,3,0
KR_7715639518,17374,15188,278,236,9,5,5,9,15,10,0,0,0,0,17,13,0,1,0,0,1,0,0,0,0,0,10,540231,2186,42,4,-4,5,0,0,4,-1,0
KR_7715651833,16834,17130,234,260,10,10,10,11,11,13,0,1,0,0,15,15,2,1,0,1,1,0,0,1,0,0,10,540210,-296,-26,0,-1,-2,-1,0,0,1,-1
KR_7715657042,14731,13913,253,266,5,3,3,5,4,6,0,1,0,0,17,35,1,5,0,0,0,1,0,1,0,0,10,540242,818,-13,2,-2,-2,-1,0,-18,-4,0
KR_7715677566,14221,14998,246,261,4,5,5,4,3,3,0,0,0,0,19,14,2,5,2,0,1,0,0,0,0,0,10,540220,-777,-15,-1,1,0,0,0,5,-3,2
KR_7715679807,14619,15073,269,241,3,6,6,3,3,9,0,1,0,0,14,144,4,3,1,0,0,1,0,1,0,0,10,540249,-454,28,-3,3,-6,-1,0,-130,1,1
KR_7715691193,14675,16523,235,227,5,9,9,5,6,12,0,0,0,0,20,15,3,3,1,2,0,1,0,0,0,0,10,540226,-1848,8,-4,4,-6,0,0,5,0,-1
KR_7715706537,15241,15864,244,249,6,8,8,6,8,11,0,0,0,0,17,15,1,2,0,0,0,1,0,0,0,0,10,540204,-623,-5,-2,2,-3,0,0,2,-1,0
KR_7715741500,14565,14025,286,261,3,2,2,3,6,1,1,0,0,0,15,16,7,5,0,2,0,1,1,0,0,0,10,540226,540,25,1,-1,5,1,0,-1,2,-2
KR_7715753151,17772,14017,279,267,10,2,3,10,8,2,1,0,0,0,12,19,6,1,2,0,0,1,1,0,0,0,10,540246,3755,12,8,-7,6,1,0,-7,5,2
KR_7715784975,15819,14549,266,264,6,4,4,6,9,2,0,0,0,0,14,15,4,3,0,1,0,1,0,0,0,0,10,540188,1270,2,2,-2,7,0,0,-1,1,-1
KR_7715807232,18061,14775,271,211,13,5,5,13,17,6,0,0,0,0,15,18,8,1,0,1,1,0,0,0,0,0,10,540179,3286,60,8,-8,11,0,0,-3,7,-1
KR_7715837450,14775,15858,295,244,2,7,7,2,4,9,0,0,0,0,17,23,9,2,0,0,0,1,0,0,0,0,10,540228,-1083,51,-5,5,-5,0,0,-6,7,0
KR_7715851231,15976,14449,258,233,6,6,6,6,9,4,0,0,0,0,18,28,3,4,0,1,0,1,0,0,0,0,10,540267,1527,25,0,0,5,0,0,-10,-1,-1
KR_7715855333,14761,14476,262,264,4,3,3,4,6,5,0,0,0,0,16,17,3,2,0,1,1,0,0,0,0,0,10,540224,285,-2,1,-1,1,0,0,-1,1,-1
KR_7715879542,15373,13561,280,259,6,1,1,6,10,2,0,0,0,0,38,15,3,4,0,0,1,0,0,0,0,0,10,540239,1812,21,5,-5,8,0,0,23,-1,0
KR_7715904178,15023,14407,273,264,5,2,2,6,7,2,1,0,0,0,27,18,4,7,0,2,1,0,1,0,0,0,10,540269,616,9,3,-4,5,1,0,9,-3,-2
KR_7715906878,15232,14380,273,264,5,4,4,5,4,3,0,1,0,0,19,17,5,3,2,1,0,1,0,1,0,0,10,540118,852,9,1,-1,1,-1,0,2,2,1
KR_7715961116,13827,15212,253,278,3,6,6,3,2,3,0,0,0,0,15,22,2,3,0,0,0,1,0,0,0,0,10,540273,-1385,-25,-3,3,-1,0,0,-7,-1,0
KR_7715973832,14602,15969,251,274,3,8,8,3,2,5,0,0,0,0,15,18,3,3,0,0,0,1,0,0,0,0,10,540120,-1367,-23,-5,5,-3,0,0,-3,0,0
KR_7715974498,14094,17098,235,308,4,9,9,4,2,11,0,1,0,0,38,38,1,2,0,1,1,0,0,1,0,0,10,540216,-3004,-73,-5,5,-9,-1,0,0,-1,-1
KR_7715992165,16867,13768,292,261,9,2,2,9,6,1,0,0,0,0,34,15,2,2,1,0,1,0,0,0,0,0,10,540160,3099,31,7,-7,5,0,0,19,0,1
KR_7716014551,13957,15087,285,298,2,5,5,2,1,1,1,0,0,0,16,19,6,4,1,0,1,0,1,0,0,0,10,540230,-1130,-13,-3,3,0,1,0,-3,2,1
KR_7716024322,16212,15071,258,230,8,7,7,8,6,7,0,1,0,0,35,48,7,2,1,0,0,1,0,1,0,0,10,540212,1141,28,1,-1,-1,-1,0,-13,5,1
KR_7716038375,13924,18434,241,308,3,12,12,3,5,11,0,1,0,0,20,21,3,5,0,5,1,0,0,1,0,0,10,540295,-4510,-67,-9,9,-6,-1,0,-1,-2,-5
KR_7716042870,13429,16083,228,288,3,3,3,3,1,2,0,0,0,0,32,18,2,4,0,4,1,0,0,0,0,1,11,547670,-2654,-60,0,0,-1,0,0,14,-2,-4
KR_7716085002,12799,16620,261,271,0,8,8,0,0,7,0,1,0,0,19,23,4,2,0,2,0,1,0,1,0,0,10,540258,-3821,-10,-8,8,-7,-1,0,-4,2,-2
KR_7716087954,15912,14583,270,260,7,3,3,7,9,6,0,0,0,0,18,13,2,6,1,1,0,1,0,0,0,0,10,540248,1329,10,4,-4,3,0,0,5,-4,0
KR_7716100412,18304,14349,277,250,12,4,4,12,14,2,0,0,0,0,13,13,1,0,2,0,1,0,0,0,0,0,10,540213,3955,27,8,-8,12,0,0,0,1,2
KR_7716128286,14606,13432,285,243,3,2,2,3,3,2,0,1,0,0,18,14,2,2,0,0,0,1,0,1,0,0,10,540235,1174,42,1,-1,1,-1,0,4,0,0
KR_7716153506,16312,15839,246,227,9,8,8,9,10,10,0,0,0,0,34,37,6,2,2,2,1,0,0,0,0,0,10,540259,473,19,1,-1,0,0,0,-3,4,0
KR_7716160234,17221,14387,288,267,8,3,3,8,12,1,0,1,0,0,19,15,4,5,2,0,1,0,0,1,0,0,10,540258,2834,21,5,-5,11,-1,0,4,-1,2
KR_7716192609,16241,15857,245,252,9,8,8,9,11,2,0,0,0,0,15,16,3,2,0,1,1,0,0,0,0,0,10,540210,384,-7,1,-1,9,0,0,-1,1,-1
KR_7716224740,14739,15206,234,281,6,3,3,6,4,4,1,0,0,0,160,15,4,4,0,3,0,1,1,0,0,0,10,540224,-467,-47,3,-3,0,1,0,145,0,-3
KR_7716250961,14858,13250,308,295,2,0,0,2,3,0,0,0,0,0,17,11,3,1,0,0,1,0,0,0,0,0,10,540104,1608,13,2,-2,3,0,0,6,2,0
KR_7716300958,15440,14360,246,285,7,3,3,7,5,2,0,1,0,0,14,18,4,3,1,1,1,0,0,1,0,0,10,540171,1080,-39,4,-4,3,-1,0,-4,1,0
KR_7716302809,14770,14778,272,279,4,4,4,4,5,6,0,1,0,0,13,15,3,1,0,2,1,0,0,1,0,0,10,540236,-8,-7,0,0,-1,-1,0,-2,2,-2
KR_7716329745,17952,16396,251,252,12,8,8,12,15,10,0,0,0,0,17,18,5,1,4,0,1,0,0,0,0,0,10,540242,1556,-1,4,-4,5,0,0,-1,4,4
KR_7716390984,15949,14632,300,290,4,3,3,4,3,3,0,1,0,0,14,20,8,2,3,0,0,1,0,1,0,0,10,540228,1317,10,1,-1,0,-1,0,-6,6,3
KR_7716423273,15202,15920,252,275,5,7,7,6,5,8,0,0,0,0,11,13,2,2,0,1,0,1,0,0,0,0,10,540184,-718,-23,-2,1,-3,0,0,-2,0,-1
KR_7716434234,16283,15868,240,226,10,8,8,10,7,10,1,0,0,0,14,17,2,1,0,0,0,1,1,0,0,0,10,540220,415,14,2,-2,-3,1,0,-3,1,0
KR_7716463205,15030,14709,254,268,5,4,4,5,9,1,1,0,0,0,24,10,1,6,0,3,0,1,1,0,0,0,10,540250,321,-14,1,-1,8,1,0,14,-5,-3
KR_7716474736,17922,13622,275,266,9,2,3,9,16,2,0,1,0,0,17,13,0,3,4,1,1,0,0,1,0,0,10,540242,4300,9,7,-6,14,-1,0,4,-3,3
KR_7716502321,15510,14034,249,255,7,4,4,7,7,1,0,1,0,0,120,14,0,0,0,0,1,0,0,1,0,0,10,540249,1476,-6,3,-3,6,-1,0,106,0,0
KR_7716515451,16762,14920,285,272,7,4,4,7,8,3,1,0,0,0,21,16,3,2,0,0,1,0,1,0,0,0,10,540231,1842,13,3,-3,5,1,0,5,1,0
KR_7716545425,17195,14025,292,252,9,3,3,9,6,4,0,0,0,0,14,22,6,1,1,0,1,0,0,0,0,0,10,540265,3170,40,6,-6,2,0,0,-8,5,1
KR_7716565908,14947,14916,274,293,5,3,3,5,5,4,0,0,0,0,19,15,3,2,0,0,1,0,0,0,0,0,10,540218,31,-19,2,-2,1,0,0,4,1,0
KR_7716586045,14500,14926,225,232,6,6,6,6,2,5,1,0,0,0,22,121,1,3,1,0,1,0,1,0,0,0,10,540252,-426,-7,0,0,-3,1,0,-99,-2,1
KR_7716618079,15006,14387,248,258,7,3,3,7,7,5,0,0,0,0,110,16,3,6,0,0,1,0,0,0,0,0,10,540247,619,-10,4,-4,2,0,0,94,-3,0
KR_7716677785,14314,14689,262,278,3,4,4,3,5,4,0,1,0,0,16,12,3,4,0,0,0,1,0,1,0,0,10,540235,-375,-16,-1,1,1,-1,0,4,-1,0
KR_7716680862,16745,14065,284,252,7,3,3,7,9,7,0,0,0,0,21,16,1,5,0,1,1,0,0,0,0,0,10,540269,2680,32,4,-4,2,0,0,5,-4,-1
KR_7716773553,16405,14501,251,268,9,3,4,9,14,4,1,0,0,0,16,19,2,0,0,0,1,0,1,0,0,0,10,540234,1904,-17,6,-5,10,1,0,-3,2,0
KR_7716774914,15814,15761,257,273,7,6,6,7,8,6,0,0,0,0,39,15,3,3,1,1,0,1,0,0,0,0,10,540212,53,-16,1,-1,2,0,0,24,0,0
KR_7716775768,15165,15505,272,257,4,6,6,4,5,8,0,0,0,0,13,33,4,2,0,1,0,1,0,0,0,0,10,540270,-340,15,-2,2,-3,0,0,-20,2,-1
KR_7716812625,14148,15782,229,246,4,8,8,4,3,8,0,1,0,0,14,16,1,1,0,1,0,1,0,1,0,0,10,540094,-1634,-17,-4,4,-5,-1,0,-2,0,-1
KR_7716826952,15252,15083,268,258,5,5,5,5,5,5,0,0,0,0,18,28,3,2,0,0,0,1,0,0,0,0,10,540271,169,10,0,0,0,0,0,-10,1,0
KR_7716852692,15099,14220,282,265,4,3,3,4,5,2,0,1,0,0,13,11,2,2,1,1,1,0,0,1,0,0,10,540249,879,17,1,-1,3,-1,0,2,0,0
KR_7716889102,15012,15472,271,293,5,5,5,5,5,6,1,0,0,0,20,17,7,4,0,0,0,1,1,0,0,0,10,540214,-460,-22,0,0,-1,1,0,3,3,0
KR_7716923960,14553,15500,238,278,5,5,5,5,4,7,0,1,0,0,19,13,3,4,0,2,0,1,0,1,0,0,10,540206,-947,-40,0,0,-3,-1,0,6,-1,-2
KR_7716979388,13963,14059,250,267,3,3,3,3,4,0,0,0,0,0,10,24,6,1,0,3,0,1,0,0,0,0,10,540233,-96,-17,0,0,4,0,0,-14,5,-3
KR_7717041303,14100,12583,232,208,6,2,2,6,7,2,1,0,0,0,23,12,3,1,3,0,1,0,1,0,0,0,10,482074,1517,24,4,-4,5,1,0,11,2,3
KR_7717154802,15479,13660,281,266,7,2,2,7,3,3,1,0,0,0,12,18,2,0,0,0,1,0,1,0,0,0,10,540206,1819,15,5,-5,0,1,0,-6,2,0
KR_7717323072,14334,14219,296,276,2,2,2,2,1,2,0,1,0,0,27,16,1,1,0,0,1,0,0,1,0,0,10,540213,115,20,0,0,-1,-1,0,11,0,0
KR_7717405824,16229,14217,305,259,7,3,3,7,4,6,0,0,0,0,18,30,3,4,0,1,1,0,0,0,0,0,10,540202,2012,46,4,-4,-2,0,0,-12,-1,-1
KR_7717423038,14314,14683,252,287,4,3,3,4,4,1,0,0,0,0,21,20,6,1,0,1,1,0,0,0,0,0,10,540186,-369,-35,1,-1,3,0,0,1,5,-1
KR_7717476446,18935,15811,222,233,15,7,7,15,19,10,1,0,0,0,17,13,4,3,2,0,1,0,1,0,0,0,10,540251,3124,-11,8,-8,9,1,0,4,1,2
KR_7717493485,16224,15093,258,246,7,5,5,7,10,8,0,0,0,0,18,146,3,6,2,1,1,0,0,0,0,0,10,540215,1131,12,2,-2,2,0,0,-128,-3,1
KR_7717521810,14664,14791,250,281,5,4,4,5,4,8,0,0,0,0,28,16,2,3,2,0,1,0,0,0,0,0,10,540190,-127,-31,1,-1,-4,0,0,12,-1,2
KR_7717561891,13709,16671,256,258,2,9,9,2,1,14,0,0,0,0,22,17,1,1,1,2,0,1,0,0,0,0,10,540297,-2962,-2,-7,7,-13,0,0,5,0,-1
KR_7717566189,14832,14467,278,263,3,4,4,3,6,6,0,0,0,0,16,15,3,3,1,0,0,1,0,0,0,0,10,540256,365,15,-1,1,0,0,0,1,0,1
KR_7717566726,14380,14515,274,299,2,2,2,2,2,3,0,0,0,0,16,42,3,3,0,0,1,0,0,0,0,0,10,540257,-135,-25,0,0,-1,0,0,-26,0,0
KR_7717591386,16605,15724,239,262,10,5,5,10,15,8,0,0,0,0,37,15,2,4,2,2,1,0,0,0,0,0,10,540217,881,-23,5,-5,7,0,0,22,-2,0
KR_7717592161,15054,15428,239,275,5,5,5,5,11,9,0,0,0,0,16,18,5,2,0,0,1,0,0,0,0,0,10,540230,-374,-36,0,0,2,0,0,-2,3,0
KR_7717607987,16924,13251,280,245,8,2,2,8,9,1,0,0,0,0,15,14,5,2,1,0,1,0,0,0,0,0,10,540235,3673,35,6,-6,8,0,0,1,3,1
KR_7717608308,15872,16982,228,248,8,10,10,8,8,7,0,1,0,0,40,20,5,2,0,4,0,1,0,1,0,0,10,540216,-1110,-20,-2,2,1,-1,0,20,3,-4
KR_7717622451,14707,15260,264,271,4,6,6,4,4,6,0,1,0,0,17,18,5,3,0,0,1,0,0,1,0,0,10,540231,-553,-7,-2,2,-2,-1,0,-1,2,0
KR_7717628362,15045,14732,276,270,4,4,5,4,4,5,0,1,0,0,26,29,3,3,1,1,1,0,0,1,0,0,10,540254,313,6,0,1,-1,-1,0,-3,0,0
KR_7717651078,12745,16765,234,257,2,9,9,2,1,7,0,0,0,0,11,15,1,2,0,1,1,0,0,0,0,0,10,540110,-4020,-23,-7,7,-6,0,0,-4,-1,-1
KR_7717657560,14044,15063,249,262,3,4,4,3,4,7,0,0,0,0,14,23,2,3,0,0,0,1,0,0,0,0,10,540237,-1019,-13,-1,1,-3,0,0,-9,-1,0
KR_7717679077,14741,13265,303,258,2,1,1,2,2,2,0,0,0,0,36,18,4,3,1,0,1,0,0,0,0,0,10,540231,1476,45,1,-1,0,0,0,18,1,1
KR_7717682602,15843,15542,267,245,7,6,6,7,5,7,0,1,0,0,24,15,1,3,2,0,1,0,0,1,0,0,10,540251,301,22,1,-1,-2,-1,0,9,-2,2
KR_7717684402,13897,15659,232,254,3,6,6,3,3,7,0,1,0,0,16,18,3,5,1,2,0,1,0,1,0,0,10,540259,-1762,-22,-3,3,-4,-1,0,-2,-2,-1
KR_7717684909,15755,13357,263,221,7,3,3,7,7,2,0,0,0,0,22,34,2,2,1,0,1,0,0,0,0,0,10,540236,2398,42,4,-4,5,0,0,-12,0,1
KR_7717703352,15209,17711,268,280,5,9,9,5,5,13,0,0,0,0,87,15,3,5,0,1,0,1,0,0,0,0,10,540238,-2502,-12,-4,4,-8,0,0,72,-2,-1
KR_7717715649,14557,16749,255,287,5,7,7,5,9,11,0,0,0,0,117,37,14,2,0,0,0,1,0,0,0,0,10,540259,-2192,-32,-2,2,-2,0,0,80,12,0
KR_7717749398,15065,16642,243,271,5,7,7,5,5,7,0,0,0,0,11,33,5,2,1,1,1,0,0,0,0,0,10,540189,-1577,-28,-2,2,-2,0,0,-22,3,0
KR_7717809042,14577,14234,220,266,5,3,3,5,6,6,0,0,0,0,12,207,0,2,2,1,1,0,0,0,0,0,10,540226,343,-46,2,-2,0,0,0,-195,-2,1
KR_7717833268,15503,15358,268,239,6,7,7,6,5,7,0,1,0,0,18,14,3,3,0,1,0,1,0,1,0,0,10,540225,145,29,-1,1,-2,-1,0,4,0,-1
KR_7717865920,15066,15627,284,259,5,5,5,5,2,5,0,0,0,0,155,13,4,3,1,1,1,0,0,0,0,0,10,540243,-561,25,0,0,-3,0,0,142,1,0
KR_7717905476,14501,16056,272,281,2,7,7,2,2,5,0,0,0,0,16,55,4,2,2,1,0,1,0,0,0,0,10,540215,-1555,-9,-5,5,-3,0,0,-39,2,1
KR_7717926884,15174,15088,287,282,4,4,4,4,6,6,0,1,0,0,14,63,3,4,0,0,1,0,0,1,0,0,10,540187,86,5,0,0,0,-1,0,-49,-1,0
KR_7718179410,15964,15604,253,253,8,6,6,8,5,8,0,0,0,0,40,19,6,1,1,1,1,0,0,0,0,0,10,540217,360,0,2,-2,-3,0,0,21,5,0
KR_7718190957,16135,15783,229,262,7,6,6,7,9,6,1,0,0,0,14,30,2,2,0,1,0,1,1,0,0,0,10,540226,352,-33,1,-1,3,1,0,-16,0,-1
KR_7718260311,14506,14412,272,276,4,3,3,4,2,3,0,0,0,0,16,19,3,6,1,1,1,0,0,0,0,0,10,540219,94,-4,1,-1,-1,0,0,-3,-3,0
KR_7718304878,15916,14239,284,295,7,1,1,7,8,1,1,0,0,0,25,13,1,5,1,0,1,0,1,0,0,0,10,540201,1677,-11,6,-6,7,1,0,12,-4,1
KR_7718309012,16336,15231,249,259,8,6,7,8,13,5,0,0,0,0,15,31,5,4,0,2,0,1,0,0,0,0,10,540204,1105,-10,2,-1,8,0,0,-16,1,-2
KR_7718360850,17516,13831,269,250,10,2,2,10,14,1,0,0,0,0,24,14,5,4,1,1,1,0,0,0,0,0,10,540264,3685,19,8,-8,13,0,0,10,1,0
KR_7718376012,14712,15829,246,279,4,6,6,4,6,6,0,0,0,0,19,17,0,4,0,1,0,1,0,0,0,0,10,540232,-1117,-33,-2,2,0,0,0,2,-4,-1
KR_7718564855,14858,16499,249,281,5,7,7,5,5,6,0,0,0,0,15,41,1,5,1,3,1,0,0,0,0,0,10,540192,-1641,-32,-2,2,-1,0,0,-26,-4,-2
KR_7718566311,17433,14324,230,205,12,6,6,12,22,7,0,1,0,0,23,18,2,1,1,0,0,1,0,1,0,0,10,540241,3109,25,6,-6,15,-1,0,5,1,1
KR_7718616977,16862,15676,251,277,9,5,5,9,14,4,0,0,0,0,16,37,2,2,0,2,0,1,0,0,0,0,10,540226,1186,-26,4,-4,10,0,0,-21,0,-2
KR_7718665570,13730,15119,257,229,2,7,7,2,1,10,0,0,0,0,17,21,5,3,0,0,0,1,0,0,0,0,10,540256,-1389,28,-5,5,-9,0,0,-4,2,0
KR_7718684931,12823,16464,245,270,1,7,7,1,0,10,0,1,0,0,38,17,1,7,1,2,0,1,0,1,0,0,10,540199,-3641,-25,-6,6,-10,-1,0,21,-6,-1
KR_7718713051,15107,14195,305,273,3,2,2,3,2,3,0,0,0,0,21,15,2,2,1,0,0,1,0,0,0,0,10,540213,912,32,1,-1,-1,0,0,6,0,1
KR_7718763183,13253,17592,251,289,2,9,9,2,4,9,0,1,0,0,15,15,4,2,0,3,1,0,0,1,0,0,10,540219,-4339,-38,-7,7,-5,-1,0,0,2,-3
KR_7718801942,14879,13958,269,291,5,1,1,5,7,0,0,1,0,0,16,18,6,2,0,2,1,0,0,1,0,0,10,540230,921,-22,4,-4,7,-1,0,-2,4,-2
KR_7718903247,13876,13648,274,301,2,0,0,2,2,0,0,1,0,0,25,19,3,5,0,2,1,0,0,1,0,0,10,540219,228,-27,2,-2,2,-1,0,6,-2,-2
KR_7718955156,17314,16123,273,237,10,7,7,10,7,13,1,0,0,0,18,13,4,3,1,0,1,0,1,0,0,0,10,540222,1191,36,3,-3,-6,1,0,5,1,1
KR_7718955409,15102,14985,253,241,6,6,6,6,6,6,0,1,0,0,21,20,0,3,1,1,0,1,0,1,0,0,10,540197,117,12,0,0,0,-1,0,1,-3,0
KR_7718967700,15904,15526,255,295,7,5,5,7,11,5,0,0,0,0,14,17,0,5,0,0,1,0,0,0,0,0,10,540216,378,-40,2,-2,6,0,0,-3,-5,0
KR_7719032306,14505,13862,294,282,2,1,1,2,2,1,1,0,0,0,20,18,5,6,1,1,1,0,1,0,0,0,10,540285,643,12,1,-1,1,1,0,2,-1,0
KR_7719080144,15814,13913,268,257,7,3,3,7,4,2,0,0,0,0,17,17,2,2,3,1,1,0,0,0,0,0,10,540255,1901,11,4,-4,2,0,0,0,0,2
KR_7719283271,15885,14558,257,228,6,5,5,6,7,7,0,0,0,0,129,36,3,4,2,0,1,0,0,0,0,0,10,540221,1327,29,1,-1,0,0,0,93,-1,2
KR_7719323314,13107,14218,280,280,0,3,3,0,0,5,0,0,0,0,15,14,1,2,0,0,0,1,0,0,0,0,10,540224,-1111,0,-3,3,-5,0,0,1,-1,0
KR_7719360649,14499,13991,246,272,4,3,3,4,4,1,0,0,0,0,16,163,1,4,0,0,0,1,0,0,0,0,10,540241,508,-26,1,-1,3,0,0,-147,-3,0
KR_7719380038,15603,14546,255,279,7,4,4,7,7,2,0,1,0,0,13,13,3,3,0,0,0,1,0,1,0,0,10,540217,1057,-24,3,-3,5,-1,0,0,0,0
KR_7719403764,13659,15259,270,304,1,3,3,1,2,8,0,0,0,0,24,17,1,3,0,0,0,1,0,0,0,0,10,540254,-1600,-34,-2,2,-6,0,0,7,-2,0
KR_7719420295,15526,13824,246,247,8,2,2,8,8,3,1,0,0,0,18,20,2,1,0,0,1,0,1,0,0,0,10,540236,1702,-1,6,-6,5,1,0,-2,1,0
KR_7719443404,14021,17191,286,254,3,10,10,3,0,10,0,0,0,0,16,53,2,4,1,1,0,1,0,0,0,0,10,540224,-3170,32,-7,7,-10,0,0,-37,-2,0
KR_7719456843,14068,14171,286,269,2,2,2,2,1,2,1,0,0,0,15,17,4,5,0,0,1,0,1,0,0,0,10,540219,-103,17,0,0,-1,1,0,-2,-1,0
KR_7719463201,12915,16824,223,256,2,9,9,2,6,17,0,1,0,0,16,16,1,5,0,0,0,1,0,1,0,0,10,540193,-3909,-33,-7,7,-11,-1,0,0,-4,0
KR_7719594719,15067,15428,243,267,5,5,5,5,5,6,0,1,0,0,16,14,3,2,2,1,1,0,0,1,0,0,10,540250,-361,-24,0,0,-1,-1,0,2,1,1
KR_7719630820,16313,14220,285,286,6,3,3,6,9,0,0,0,0,0,18,12,2,1,0,0,0,1,0,0,0,0,10,540226,2093,-1,3,-3,9,0,0,6,1,0
KR_7719654270,15299,14784,286,254,4,5,5,4,4,5,0,0,0,0,18,17,4,2,1,0,0,1,0,0,0,0,10,540305,515,32,-1,1,-1,0,0,1,2,1
KR_7719718865,15807,14174,242,220,7,4,4,7,10,8,0,0,0,0,20,16,4,4,2,0,1,0,0,0,0,0,10,540265,1633,22,3,-3,2,0,0,4,0,2
KR_7719772508,14793,14810,288,272,3,4,4,4,2,11,0,0,0,0,19,24,2,3,1,1,0,1,0,0,0,0,10,540223,-17,16,-1,0,-9,0,0,-5,-1,0
KR_7719802893,14317,15411,226,274,4,5,5,4,9,8,1,0,0,0,12,19,5,1,0,3,0,1,1,0,0,0,10,540121,-1094,-48,-1,1,1,1,0,-7,4,-3
KR_7719838777,15704,15892,279,261,6,7,7,6,11,14,0,1,0,0,16,15,4,3,0,0,1,0,0,1,0,0,10,540213,-188,18,-1,1,-3,-1,0,1,1,0
KR_7719844819,16424,16517,215,254,8,9,9,8,12,10,0,0,0,0,19,106,0,1,2,4,0,1,0,0,0,0,10,540224,-93,-39,-1,1,2,0,0,-87,-1,-2
KR_7719865478,16776,13808,301,228,6,3,3,6,6,3,0,1,0,0,16,15,4,0,1,0,0,1,0,1,0,0,10,540246,2968,73,3,-3,3,-1,0,1,4,1
KR_7719881048,15162,16012,237,267,6,8,8,6,10,9,1,0,0,0,37,16,5,3,0,0,1,0,1,0,0,0,10,540255,-850,-30,-2,2,1,1,0,21,2,0
KR_7719908388,14531,18299,239,300,5,9,9,5,7,15,0,0,0,0,23,111,1,4,0,1,1,0,0,0,0,0,10,540240,-3768,-61,-4,4,-8,0,0,-88,-3,-1
KR_7719919158,16342,14803,301,298,7,3,3,7,6,4,0,1,0,0,21,17,5,3,0,0,1,0,0,1,0,0,10,540206,1539,3,4,-4,2,-1,0,4,2,0
KR_7719923088,14073,16387,229,262,3,9,9,3,4,15,0,1,0,0,35,19,5,6,0,0,0,1,0,1,0,0,10,540236,-2314,-33,-6,6,-11,-1,0,16,-1,0
KR_7719930294,14503,13533,282,274,2,1,1,2,2,1,0,0,0,0,16,16,3,2,2,1,0,1,0,0,0,0,10,540204,970,8,1,-1,1,0,0,0,1,1
KR_7719945113,16006,15799,284,250,7,7,7,7,7,9,0,0,0,0,116,18,6,4,1,0,0,1,0,0,0,0,10,540212,207,34,0,0,-2,0,0,98,2,1
KR_7719963089,15501,14657,277,281,6,3,3,6,3,4,0,0,0,0,16,20,5,5,0,0,1,0,0,0,0,0,10,540204,844,-4,3,-3,-1,0,0,-4,0,0
KR_7719964104,15542,16357,255,243,5,9,9,5,6,6,0,0,0,0,32,16,1,2,2,0,0,1,0,0,0,0,10,540097,-815,12,-4,4,0,0,0,16,-1,2
KR_7719970784,14799,14035,246,250,5,3,3,5,6,4,0,0,0,0,16,15,2,3,0,1,1,0,0,0,0,0,10,540187,764,-4,2,-2,2,0,0,1,-1,-1
KR_7719997394,14269,15042,245,266,4,4,4,4,3,7,0,0,0,0,15,32,2,2,0,1,0,1,0,0,0,0,10,540181,-773,-21,0,0,-4,0,0,-17,0,-1
KR_7720026391,14354,16347,213,259,6,8,8,6,11,7,0,0,0,0,17,16,4,4,0,1,1,0,0,0,0,0,10,540249,-1993,-46,-2,2,4,0,0,1,0,-1
KR_7720058374,14339,15827,278,288,3,5,5,3,2,5,0,0,0,0,15,114,1,2,1,1,1,0,0,0,0,0,10,540254,-1488,-10,-2,2,-3,0,0,-99,-1,0
KR_7720066160,14191,14282,258,275,3,3,3,3,3,4,0,0,0,0,20,10,1,5,0,0,0,1,0,0,0,0,10,540197,-91,-17,0,0,-1,0,0,10,-4,0
KR_7720089229,15120,15721,271,278,5,6,6,5,5,4,1,0,0,0,13,17,7,4,0,1,0,1,1,0,0,0,10,540219,-601,-7,-1,1,1,1,0,-4,3,-1
KR_7720096786,15611,15379,274,257,5,6,6,5,7,6,1,0,0,0,18,37,7,2,1,0,1,0,1,0,0,0,10,540230,232,17,-1,1,1,1,0,-19,5,1
KR_7720313418,15103,12900,286,238,4,1,1,4,9,1,1,0,0,0,25,34,4,2,0,0,1,0,1,0,0,0,10,540205,2203,48,3,-3,8,1,0,-9,2,0
KR_7720358787,14736,16329,279,294,3,6,6,3,5,11,0,0,0,0,16,17,5,3,0,0,0,1,0,0,0,0,10,540274,-1593,-15,-3,3,-6,0,0,-1,2,0
KR_7720504262,14915,16510,259,276,4,7,7,4,3,11,0,0,0,0,205,14,2,2,1,2,0,1,0,0,0,0,10,540233,-1595,-17,-3,3,-8,0,0,191,0,-1
KR_7720540985,15529,14764,244,262,7,4,4,7,4,5,1,0,0,0,17,17,2,1,1,0,1,0,1,0,0,0,10,540233,765,-18,3,-3,-1,1,0,0,1,1
KR_7720596491,14222,15033,258,282,3,4,4,3,4,6,1,0,0,0,18,15,0,9,0,1,0,1,1,0,0,0,10,540235,-811,-24,-1,1,-2,1,0,3,-9,-1
KR_7720614971,15374,15232,252,232,7,6,6,7,7,7,0,1,0,0,16,15,0,4,0,0,0,1,0,1,0,0,10,540238,142,20,1,-1,0,-1,0,1,-4,0
KR_7720847961,12811,17634,238,288,1,13,13,1,2,9,0,1,0,0,10,12,1,4,0,1,0,1,0,1,0,0,10,540237,-4823,-50,-12,12,-7,-1,0,-2,-3,-1
KR_7720864932,13930,14033,293,270,1,3,3,1,0,3,0,0,0,0,21,36,2,4,1,0,0,1,0,0,0,0,10,540256,-103,23,-2,2,-3,0,0,-15,-2,1
KR_7720901000,15698,14093,278,238,8,4,5,8,5,3,0,0,0,0,20,26,2,6,2,0,1,0,0,0,0,0,10,540250,1605,40,4,-3,2,0,0,-6,-4,2
KR_7720935896,14348,16479,268,273,4,7,7,4,1,6,1,0,0,0,35,18,5,2,0,1,0,1,1,0,0,0,10,540251,-2131,-5,-3,3,-5,1,0,17,3,-1
KR_7720986096,14262,14487,246,254,3,4,4,3,3,4,0,0,0,0,14,41,2,5,1,0,1,0,0,0,0,0,10,540217,-225,-8,-1,1,-1,0,0,-27,-3,1
KR_7721026516,15238,14401,282,295,4,2,2,4,5,2,0,1,0,0,14,53,4,1,0,1,1,0,0,1,0,0,10,540204,837,-13,2,-2,3,-1,0,-39,3,-1
KR_7721062869,15736,15899,264,255,6,7,7,6,7,8,0,0,0,0,16,40,2,3,2,1,1,0,0,0,0,0,10,540208,-163,9,-1,1,-1,0,0,-24,-1,1
KR_7721089950,15221,15089,245,260,7,6,6,7,4,7,0,0,0,0,18,13,1,5,0,0,0,1,0,0,0,0,10,540250,132,-15,1,-1,-3,0,0,5,-4,0
KR_7721135827,15942,16131,242,265,8,7,7,8,13,13,0,1,0,0,15,14,1,2,0,0,0,1,0,1,0,0,10,540251,-189,-23,1,-1,0,-1,0,1,-1,0
KR_7721221178,14202,14621,231,231,5,5,6,5,4,7,0,0,0,0,15,20,5,1,0,2,1,0,0,0,0,0,10,540197,-419,0,0,1,-3,0,0,-5,4,-2
KR_7721448491,15793,13879,274,264,7,2,3,7,4,3,0,1,0,0,16,17,2,3,0,0,1,0,0,1,0,0,10,540118,1914,10,5,-4,1,-1,0,-1,-1,0
KR_7721549771,13856,14409,276,275,1,3,3,1,1,3,1,0,0,0,18,20,4,4,1,1,0,1,1,0,0,0,10,540278,-553,1,-2,2,-2,1,0,-2,0,0
KR_7721632840,15901,13974,262,222,8,4,4,8,10,3,0,0,0,0,19,17,5,1,2,0,0,1,0,0,0,0,10,540207,1927,40,4,-4,7,0,0,2,4,2
KR_7721697554,14658,15222,237,260,5,6,6,5,8,6,0,0,0,0,25,15,3,3,0,0,1,0,0,0,0,0,10,540265,-564,-23,-1,1,2,0,0,10,0,0
KR_7721742152,14481,14781,231,248,5,6,6,5,4,5,0,0,0,0,25,19,5,4,0,0,1,0,0,0,0,0,10,540202,-300,-17,-1,1,-1,0,0,6,1,0
KR_7721766988,14416,15400,266,247,3,6,6,3,3,6,0,0,0,0,14,16,1,4,0,0,1,0,0,0,0,0,10,540223,-984,19,-3,3,-3,0,0,-2,-3,0
KR_7721780150,15795,13159,303,274,5,1,1,5,8,1,0,0,0,0,11,15,3,0,0,0,1,0,0,0,0,0,10,540218,2636,29,4,-4,7,0,0,-4,3,0
KR_7721806178,16571,15843,236,250,9,8,8,9,12,9,0,0,0,0,18,19,10,3,2,0,0,1,0,0,0,0,10,540218,728,-14,1,-1,3,0,0,-1,7,2
KR_7721817569,15871,15192,281,272,6,5,5,6,7,5,0,0,0,0,17,11,3,6,1,0,0,1,0,0,0,0,10,540215,679,9,1,-1,2,0,0,6,-3,1
KR_7721838604,14933,14806,241,264,5,4,4,5,8,3,1,0,0,0,14,19,3,1,0,1,0,1,1,0,0,0,10,540185,127,-23,1,-1,5,1,0,-5,2,-1
KR_7721854383,17200,15337,265,249,10,7,7,10,10,7,0,0,0,0,16,17,0,2,0,0,1,0,0,0,0,0,10,540204,1863,16,3,-3,3,0,0,-1,-2,0
KR_7721861333,15063,16884,243,277,6,9,9,6,6,4,0,0,0,0,13,16,2,3,0,1,1,0,0,0,0,0,10,540200,-1821,-34,-3,3,2,0,0,-3,-1,-1
KR_7721872110,17751,14682,256,261,13,5,5,13,17,4,0,1,0,0,16,17,1,2,0,0,0,1,0,1,0,0,10,540210,3069,-5,8,-8,13,-1,0,-1,-1,0
KR_7721886809,14912,15620,249,294,4,5,5,4,4,5,0,1,0,0,16,13,1,3,3,2,0,1,0,1,0,0,10,540254,-708,-45,-1,1,-1,-1,0,3,-2,1
KR_7721902672,14474,15053,271,259,3,6,6,3,4,6,0,1,0,0,8,18,2,0,2,1,0,1,0,1,0,0,10,540275,-579,12,-3,3,-2,-1,0,-10,2,1
KR_7721902804,16774,15808,234,256,9,7,7,10,13,9,0,0,0,0,15,39,2,3,0,2,0,1,0,0,0,0,10,540251,966,-22,2,-3,4,0,0,-24,-1,-2
KR_7721903818,16089,14794,241,258,8,5,5,8,8,3,0,1,0,0,16,16,4,4,2,1,1,0,0,1,0,0,10,540269,1295,-17,3,-3,5,-1,0,0,0,1
KR_7721910793,16511,16068,236,251,9,7,7,9,8,11,0,0,0,0,19,19,3,5,0,1,0,1,0,0,0,0,10,540250,443,-15,2,-2,-3,0,0,0,-2,-1
KR_7721927785,14500,14249,266,258,4,3,3,5,3,2,0,0,0,0,16,25,4,2,0,1,1,0,0,0,0,0,10,540268,251,8,1,-2,1,0,0,-9,2,-1
KR_7721948463,15094,13919,257,242,6,3,3,6,10,7,0,1,0,0,19,20,6,4,0,0,0,1,0,1,0,0,10,540262,1175,15,3,-3,3,-1,0,-1,2,0
KR_7721951410,15071,14297,250,250,5,4,4,5,5,4,0,0,0,0,17,72,3,3,1,0,1,0,0,0,0,0,10,540104,774,0,1,-1,1,0,0,-55,0,1
KR_7721965895,15478,13803,242,231,7,3,3,8,5,4,1,0,0,0,18,36,2,3,2,0,1,0,1,0,0,0,10,540249,1675,11,4,-5,1,1,0,-18,-1,2
KR_7721968231,14566,15799,265,239,4,8,8,5,3,8,1,0,0,0,16,18,4,3,0,0,0,1,1,0,0,0,10,540231,-1233,26,-4,3,-5,1,0,-2,1,0
KR_7721969672,14072,14350,254,277,4,3,3,4,3,2,0,1,0,0,18,18,1,4,0,0,0,1,0,1,0,0,10,540260,-278,-23,1,-1,1,-1,0,0,-3,0
KR_7722000829,13129,16304,277,258,0,8,8,0,0,10,0,0,0,0,13,17,5,2,0,0,0,1,0,0,0,0,10,540206,-3175,19,-8,8,-10,0,0,-4,3,0
KR_7722002423,14315,15499,247,263,4,6,6,4,3,7,0,1,0,0,38,18,4,2,1,0,0,1,0,1,0,0,10,540272,-1184,-16,-2,2,-4,-1,0,20,2,1
KR_7722004632,14778,14642,270,250,4,5,5,4,4,5,0,1,0,0,15,67,2,3,1,0,0,1,0,1,0,0,10,540215,136,20,-1,1,-1,-1,0,-52,-1,1
KR_7722018282,15208,14240,272,220,5,5,5,5,7,5,1,0,0,0,15,37,5,0,0,0,0,1,1,0,0,0,10,540257,968,52,0,0,2,1,0,-22,5,0
KR_7722024621,16166,14145,311,260,5,2,2,5,5,3,0,0,0,0,22,22,2,2,0,1,1,0,0,0,0,0,10,540254,2021,51,3,-3,2,0,0,0,0,-1
KR_7722053721,15966,13517,276,271,7,2,2,7,7,2,0,0,0,0,10,15,2,3,1,1,1,0,0,0,0,0,10,540257,2449,5,5,-5,5,0,0,-5,-1,0
KR_7722058821,12684,16429,256,309,0,5,5,0,0,6,0,0,0,0,18,19,1,5,0,1,0,1,0,0,0,0,10,540241,-3745,-53,-5,5,-6,0,0,-1,-4,-1
KR_7722196719,16025,15281,224,264,9,4,4,9,12,2,0,0,0,0,16,15,3,3,2,2,1,0,0,0,0,0,10,540275,744,-40,5,-5,10,0,0,1,0,0
KR_7722215489,14850,14769,251,284,5,3,4,5,4,2,1,0,0,0,110,18,4,1,1,1,1,0,1,0,0,0,10,540253,81,-33,2,-1,2,1,0,92,3,0
KR_7722235717,15195,16360,248,244,5,9,9,5,5,10,0,0,0,0,14,16,4,4,0,0,0,1,0,0,0,0,10,540276,-1165,4,-4,4,-5,0,0,-2,0,0
KR_7722268576,2556,2577,0,1,0,0,0,0,0,0,0,0,0,0,0,1,0,0,0,0,0,0,0,0,0,0,3,105283,-21,-1,0,0,0,0,0,-1,0,0
KR_7722335164,14914,15725,291,266,3,6,6,3,5,13,0,0,0,0,26,36,1,4,2,0,1,0,0,0,0,0,10,540194,-811,25,-3,3,-8,0,0,-10,-3,2
KR_7722362934,16096,14356,272,270,7,2,2,7,10,4,0,0,0,0,32,35,0,2,1,0,1,0,0,0,0,0,10,540226,1740,2,5,-5,6,0,0,-3,-2,1
KR_7722368198,15764,15130,265,252,7,5,5,7,7,7,0,1,0,0,16,16,0,2,1,1,1,0,0,1,0,0,10,540217,634,13,2,-2,0,-1,0,0,-2,0
KR_7722416954,15180,17037,256,238,6,11,11,6,5,6,0,0,0,0,17,36,4,3,0,1,0,1,0,0,0,0,10,540229,-1857,18,-5,5,-1,0,0,-19,1,-1
KR_7722467576,16897,14806,286,270,8,3,3,8,9,3,0,1,0,0,17,19,5,4,0,0,1,0,0,1,0,0,10,540224,2091,16,5,-5,6,-1,0,-2,1,0
KR_7722550711,13530,16128,259,274,2,6,6,2,3,8,0,0,0,0,13,17,1,2,0,1,0,1,0,0,0,0,10,540229,-2598,-15,-4,4,-5,0,0,-4,-1,-1
KR_7722576313,15537,13627,284,265,5,2,2,5,6,1,1,0,0,0,21,11,5,4,0,1,1,0,1,0,0,0,10,540246,1910,19,3,-3,5,1,0,10,1,-1
KR_7722587860,13619,17338,211,271,4,11,11,4,4,12,0,0,0,0,12,120,1,3,0,1,0,1,0,0,0,0,10,540259,-3719,-60,-7,7,-8,0,0,-108,-2,-1
KR_7722611236,15194,15007,261,244,5,5,6,5,5,5,0,0,0,0,15,16,2,2,0,0,0,1,0,0,0,0,10,540218,187,17,0,1,0,0,0,-1,0,0
KR_7722659035,14393,15422,273,314,3,3,3,3,4,3,0,0,0,0,13,16,2,1,0,1,0,1,0,0,0,0,10,540221,-1029,-41,0,0,1,0,0,-3,1,-1
KR_7722702711,14378,14999,285,278,2,5,5,2,2,2,1,0,0,0,18,17,8,4,0,1,0,1,1,0,0,0,10,540261,-621,7,-3,3,0,1,0,1,4,-1
KR_7722715295,15589,14758,248,264,7,4,4,7,5,1,0,0,0,0,14,18,1,2,1,0,0,1,0,0,0,0,10,540208,831,-16,3,-3,4,0,0,-4,-1,1
KR_7722765945,16503,13011,283,263,7,0,0,7,7,0,0,0,0,0,23,43,6,2,1,0,1,0,0,0,0,0,10,540215,3492,20,7,-7,7,0,0,-20,4,1
KR_7722780183,14903,15154,266,291,4,4,4,4,3,7,0,1,0,0,16,19,5,3,0,0,1,0,0,1,0,0,10,540235,-251,-25,0,0,-4,-1,0,-3,2,0
KR_7722824824,14398,14709,261,278,3,3,3,3,5,6,1,0,0,0,37,19,3,2,2,1,1,0,1,0,0,0,10,540217,-311,-17,0,0,-1,1,0,18,1,1
KR_7722911914,14147,16701,280,274,2,9,9,2,2,6,0,0,0,0,16,22,3,4,1,1,0,1,0,0,0,0,10,540238,-2554,6,-7,7,-4,0,0,-6,-1,0
KR_7722958055,16471,12935,323,258,5,1,1,5,4,3,0,0,0,0,18,34,7,3,4,0,1,0,0,0,0,0,10,540124,3536,65,4,-4,1,0,0,-16,4,4
KR_7722988738,14964,14318,234,253,6,3,3,6,10,3,0,1,0,0,15,12,3,2,1,0,1,0,0,1,0,0,10,540121,646,-19,3,-3,7,-1,0,3,1,1
KR_7722996702,13851,15078,259,251,2,5,5,2,3,8,0,1,0,0,17,37,4,3,0,0,0,1,0,1,0,0,10,540263,-1227,8,-3,3,-5,-1,0,-20,1,0
KR_7723060598,17119,15681,263,263,9,7,7,9,9,3,1,0,0,0,14,19,5,4,2,0,0,1,1,0,0,0,10,540282,1438,0,2,-2,6,1,0,-5,1,2
KR_7723092478,14189,14162,298,291,2,1,1,2,2,1,1,0,0,0,18,38,4,3,0,2,1,0,1,0,0,0,10,540254,27,7,1,-1,1,1,0,-20,1,-2
KR_7723097332,15831,14258,281,231,6,5,5,6,3,3,0,0,0,0,14,16,2,3,1,0,0,1,0,0,0,0,10,540233,1573,50,1,-1,0,0,0,-2,-1,1
KR_7723114104,15195,15216,251,263,6,5,5,6,5,2,1,0,0,0,19,37,2,3,1,2,0,1,1,0,0,0,10,540208,-21,-12,1,-1,3,1,0,-18,-1,-1
KR_7723120945,15948,16792,278,234,7,10,10,7,1,10,0,0,0,0,34,13,5,2,1,0,1,0,0,0,0,0,10,540091,-844,44,-3,3,-9,0,0,21,3,1
KR_7723139382,15110,14281,303,308,3,1,1,3,3,1,0,0,0,0,16,16,5,8,1,0,0,1,0,0,0,0,10,540226,829,-5,2,-2,2,0,0,0,-3,1
KR_7723149681,14971,14746,285,270,4,4,4,4,1,3,0,1,0,0,14,18,3,2,1,0,0,1,0,1,0,0,10,540221,225,15,0,0,-2,-1,0,-4,1,1
KR_7723164506,12638,16775,240,251,1,10,10,1,0,12,0,0,0,0,16,38,1,4,0,0,0,1,0,0,0,0,10,540182,-4137,-11,-9,9,-12,0,0,-22,-3,0
KR_7723171289,16409,17229,243,213,8,12,12,8,11,24,0,1,0,0,15,18,4,4,1,0,1,0,0,1,0,0,10,540260,-820,30,-4,4,-13,-1,0,-3,0,1
KR_7723183410,14598,15055,285,262,3,5,5,3,1,7,0,1,0,0,12,14,4,5,1,1,0,1,0,1,0,0,10,540276,-457,23,-2,2,-6,-1,0,-2,-1,0
KR_7723211266,16235,15362,263,267,7,6,6,7,6,7,0,0,0,0,19,16,2,6,0,0,0,1,0,0,0,0,10,540179,873,-4,1,-1,-1,0,0,3,-4,0
KR_7723230293,15391,14545,252,245,7,5,5,7,6,3,0,0,0,0,35,17,5,7,0,1,1,0,0,0,0,0,10,540097,846,7,2,-2,3,0,0,18,-2,-1
KR_7723241850,14705,14922,226,231,6,6,6,6,6,4,1,0,0,0,42,20,1,3,0,2,1,0,1,0,0,0,10,540218,-217,-5,0,0,2,1,0,22,-2,-2
KR_7723261008,15321,15356,266,285,7,5,5,7,6,3,0,0,0,0,14,16,1,1,0,1,1,0,0,0,0,0,10,540136,-35,-19,2,-2,3,0,0,-2,0,-1
KR_7723265357,14509,16139,254,238,5,9,9,5,2,10,0,0,0,0,14,24,1,3,1,1,1,0,0,0,0,0,10,540252,-1630,16,-4,4,-8,0,0,-10,-2,0
KR_7723352024,16254,15428,242,252,7,7,7,8,10,11,0,0,0,0,17,23,3,2,1,0,0,1,0,0,0,0,10,540267,826,-10,0,-1,-1,0,0,-6,1,1
KR_7723367921,12882,17987,235,294,1,12,12,1,0,13,0,1,0,0,11,16,2,1,0,1,0,1,0,1,0,0,10,540236,-5105,-59,-11,11,-13,-1,0,-5,1,-1
KR_7723383816,14137,14382,272,258,3,4,4,3,4,6,0,1,0,0,13,32,2,2,0,0,0,1,0,1,0,0,10,540310,-245,14,-1,1,-2,-1,0,-19,0,0
KR_7723403389,15924,15232,283,265,5,6,6,5,10,15,0,1,0,0,21,17,6,9,0,0,0,1,0,1,0,0,10,540223,692,18,-1,1,-5,-1,0,4,-3,0
KR_7723443904,14244,15007,308,282,1,4,4,1,1,4,0,1,0,0,28,17,3,5,0,2,0,1,0,1,0,0,10,540261,-763,26,-3,3,-3,-1,0,11,-2,-2
KR_7723484087,16002,13469,294,284,6,0,1,6,5,0,0,0,0,0,17,21,6,2,1,0,1,0,0,0,0,0,10,540211,2533,10,6,-5,5,0,0,-4,4,1
KR_7723583617,15360,14921,279,258,5,5,5,5,9,4,1,0,0,0,35,16,3,5,1,0,0,1,1,0,0,0,10,540244,439,21,0,0,5,1,0,19,-2,1
KR_7723621463,15054,13809,253,256,6,2,2,6,4,3,0,1,0,0,18,21,3,4,1,1,1,0,0,1,0,0,10,540214,1245,-3,4,-4,1,-1,0,-3,-1,0
KR_7723623733,14549,13375,268,272,4,1,3,4,3,1,0,1,0,0,17,19,3,5,1,0,0,1,0,1,0,0,10,540292,1174,-4,3,-1,2,-1,0,-2,-2,1
KR_7723640759,16250,12972,278,267,7,0,0,7,12,0,0,1,0,0,17,13,3,1,0,0,1,0,0,1,0,0,10,540266,3278,11,7,-7,12,-1,0,4,2,0
KR_7723663570,14218,15127,263,299,3,4,4,3,2,1,1,0,0,0,14,15,3,3,0,3,0,1,1,0,0,0,10,540233,-909,-36,-1,1,1,1,0,-1,0,-3
KR_7723666547,15672,14771,271,269,7,4,4,7,7,5,0,1,0,0,17,11,3,3,0,0,1,0,0,1,0,0,10,540174,901,2,3,-3,2,-1,0,6,0,0
KR_7723748391,14435,15826,244,284,4,5,5,4,5,5,0,0,0,0,23,17,3,0,0,3,1,0,0,0,0,0,10,540257,-1391,-40,-1,1,0,0,0,6,3,-3
KR_7723751146,13762,14748,266,262,2,4,4,2,5,2,0,0,0,0,24,24,1,6,0,1,0,1,0,0,0,0,10,540128,-986,4,-2,2,3,0,0,0,-5,-1
KR_7723784100,14391,14478,271,252,4,4,4,4,1,6,0,0,0,0,18,23,3,1,0,0,1,0,0,0,0,0,10,540228,-87,19,0,0,-5,0,0,-5,2,0
KR_7723785460,16835,13163,257,225,10,3,3,10,8,4,0,0,0,0,14,11,2,2,3,0,0,1,0,0,0,0,10,540204,3672,32,7,-7,4,0,0,3,0,3
KR_7723806237,16197,17157,270,253,7,11,11,7,4,10,0,0,0,0,15,34,0,2,0,0,0,1,0,0,0,0,10,540239,-960,17,-4,4,-6,0,0,-19,-2,0
KR_7723816645,16481,16933,276,234,8,9,9,8,7,16,0,0,0,0,104,50,2,1,1,1,1,0,0,0,0,0,10,540277,-452,42,-1,1,-9,0,0,54,1,0
KR_7723827283,14883,17252,233,278,6,9,9,6,10,12,0,0,0,0,15,25,5,2,0,1,1,0,0,0,0,0,10,540108,-2369,-45,-3,3,-2,0,0,-10,3,-1
KR_7723853805,13700,14806,275,283,1,4,4,1,1,1,0,1,0,0,13,14,2,3,2,1,0,1,0,1,0,0,10,540171,-1106,-8,-3,3,0,-1,0,-1,-1,1
KR_7723861629,14281,15428,249,264,4,6,6,4,3,5,0,1,0,0,15,13,3,1,1,2,0,1,0,1,0,0,10,540216,-1147,-15,-2,2,-2,-1,0,2,2,-1
KR_7723876990,16367,16442,279,245,6,8,8,6,10,8,0,0,0,0,20,21,3,6,1,1,1,0,0,0,0,0,10,540149,-75,34,-2,2,2,0,0,-1,-3,0
KR_7723878793,14171,13699,283,300,3,0,0,3,1,0,0,0,0,0,12,38,5,5,0,1,1,0,0,0,0,0,10,540256,472,-17,3,-3,1,0,0,-26,0,-1
KR_7723916738,16160,15986,248,260,8,6,6,9,7,8,0,0,0,0,15,16,2,3,1,1,1,0,0,0,0,0,10,540272,174,-12,2,-3,-1,0,0,-1,-1,0
KR_7723938796,13159,14678,267,254,1,5,5,1,0,6,0,1,0,0,13,31,2,3,0,2,0,1,0,1,0,0,10,540264,-1519,13,-4,4,-6,-1,0,-18,-1,-2
KR_7723962900,15917,14073,257,238,9,3,3,9,13,3,0,0,0,0,17,16,4,3,0,0,1,0,0,0,0,0,10,540206,1844,19,6,-6,10,0,0,1,1,0
KR_7724022097,16022,14096,270,285,6,3,4,6,7,1,0,1,0,0,16,21,2,3,1,0,1,0,0,1,0,0,10,540221,1926,-15,3,-2,6,-1,0,-5,-1,1
KR_7724036597,16423,16645,256,250,8,7,7,8,10,11,0,0,0,0,15,14,4,2,1,2,1,0,0,0,0,0,10,540213,-222,6,1,-1,-1,0,0,1,2,-1
KR_7724078476,15556,15044,260,278,6,5,5,6,8,2,0,0,0,0,18,14,2,4,0,2,0,1,0,0,0,0,10,540217,512,-18,1,-1,6,0,0,4,-2,-2
KR_7724090612,13733,17944,267,263,2,12,12,2,1,14,0,0,0,0,15,17,2,4,0,0,0,1,0,0,0,0,10,540191,-4211,4,-10,10,-13,0,0,-2,-2,0
KR_7724099651,15645,15807,258,241,7,8,8,7,6,7,0,1,0,0,15,14,1,3,0,1,0,1,0,1,0,0,10,540177,-162,17,-1,1,-1,-1,0,1,-2,-1
KR_7724137979,14641,15706,257,268,4,6,6,4,7,10,0,1,0,0,18,24,1,4,0,0,0,1,0,1,0,0,10,540298,-1065,-11,-2,2,-3,-1,0,-6,-3,0
KR_7724152495,15559,15743,290,273,4,5,5,4,4,5,0,0,0,0,32,16,3,2,1,1,0,1,0,0,0,0,10,540206,-184,17,-1,1,-1,0,0,16,1,0
KR_7724156990,16340,15693,278,262,7,6,6,7,6,6,0,0,0,0,18,21,4,3,0,1,0,1,0,0,0,0,10,540267,647,16,1,-1,0,0,0,-3,1,-1
KR_7724190564,16511,14983,262,258,8,5,5,8,12,7,0,0,0,0,19,35,9,0,1,0,1,0,0,0,0,0,10,540182,1528,4,3,-3,5,0,0,-16,9,1
KR_7724212443,12839,18494,252,260,0,15,15,0,0,21,0,0,0,0,19,31,2,6,0,2,0,1,0,0,0,0,10,540223,-5655,-8,-15,15,-21,0,0,-12,-4,-2
KR_7724215078,15554,13025,287,255,6,1,1,6,5,0,0,0,0,0,18,69,5,4,1,0,1,0,0,0,0,0,10,540238,2529,32,5,-5,5,0,0,-51,1,1
KR_7724241532,15588,14742,274,269,6,4,4,6,5,3,1,0,0,0,18,20,0,4,0,1,1,0,1,0,0,0,10,540206,846,5,2,-2,2,1,0,-2,-4,-1
KR_7724253465,15908,16111,279,276,5,6,6,5,6,5,0,1,0,0,16,16,3,4,1,3,0,1,0,1,0,0,10,540207,-203,3,-1,1,1,-1,0,0,-1,-2
KR_7724284337,18517,14284,284,240,13,4,4,13,10,3,0,0,0,0,17,15,3,1,1,0,1,0,0,0,0,0,10,540205,4233,44,9,-9,7,0,0,2,2,1
KR_7724290596,13923,14328,269,290,2,2,2,2,3,2,0,0,0,0,18,36,3,3,0,0,1,0,0,0,0,0,10,540215,-405,-21,0,0,1,0,0,-18,0,0
KR_7724291330,16924,14939,282,258,8,4,4,8,9,7,0,0,0,0,23,16,4,2,1,1,1,0,0,0,0,0,10,540196,1985,24,4,-4,2,0,0,7,2,0
KR_7724301615,15035,14287,275,264,5,3,3,5,7,3,0,1,0,0,17,13,4,5,0,1,1,0,0,1,0,0,10,540171,748,11,2,-2,4,-1,0,4,-1,-1
KR_7724313871,14108,16271,233,209,4,11,11,4,3,11,0,0,0,0,33,27,4,1,1,1,0,1,0,0,0,0,10,540272,-2163,24,-7,7,-8,0,0,6,3,0
KR_7724315214,14085,16619,281,267,3,8,8,3,2,12,0,0,0,0,14,107,5,6,0,1,0,1,0,0,0,0,10,540220,-2534,14,-5,5,-10,0,0,-93,-1,-1
KR_7724330568,14931,13895,295,274,3,2,2,3,5,1,1,0,0,0,58,16,2,3,1,0,1,0,1,0,0,0,10,540267,1036,21,1,-1,4,1,0,42,-1,1
KR_7724332162,16356,14290,257,261,7,4,4,7,7,3,0,1,0,0,29,16,2,3,0,0,1,0,0,1,0,0,10,540191,2066,-4,3,-3,4,-1,0,13,-1,0
KR_7724335623,15686,15429,263,270,7,5,5,7,9,6,0,0,0,0,19,35,4,3,0,1,1,0,0,0,0,0,10,540192,257,-7,2,-2,3,0,0,-16,1,-1
KR_7724346098,15649,15915,267,281,6,6,6,6,5,4,1,0,0,0,17,21,6,5,0,0,1,0,1,0,0,0,10,540222,-266,-14,0,0,1,1,0,-4,1,0
KR_7724351231,18060,14352,293,238,10,4,4,10,7,4,0,0,0,0,18,18,3,2,3,1,1,0,0,0,0,0,10,540218,3708,55,6,-6,3,0,0,0,1,2
KR_7724356614,13671,14695,275,307,1,2,2,1,1,2,0,1,0,0,17,18,4,4,0,0,1,0,0,1,0,0,10,540215,-1024,-32,-1,1,-1,-1,0,-1,0,0
KR_7724365905,14310,15705,277,284,3,5,5,3,3,5,0,0,0,0,13,37,5,3,0,0,1,0,0,0,0,0,10,540287,-1395,-7,-2,2,-2,0,0,-24,2,0
KR_7724668707,15303,16759,207,250,7,9,9,7,11,9,0,0,0,0,12,14,2,3,0,0,0,1,0,0,0,0,10,540240,-1456,-43,-2,2,2,0,0,-2,-1,0
KR_7724687908,14328,16762,270,301,3,7,7,3,2,6,1,0,0,0,39,14,0,6,0,2,1,0,1,0,0,0,10,540253,-2434,-31,-4,4,-4,1,0,25,-6,-2
KR_7724694501,16483,14707,283,255,8,5,5,9,10,4,0,0,0,0,17,17,4,2,0,0,0,1,0,0,0,0,10,540233,1776,28,3,-4,6,0,0,0,2,0
KR_7724705507,17288,13353,309,255,6,1,1,6,7,2,0,1,0,0,18,17,1,7,1,0,1,0,0,1,0,0,10,540105,3935,54,5,-5,5,-1,0,1,-6,1
KR_7724711356,15093,13727,280,289,5,1,1,6,4,1,1,0,0,0,11,27,6,5,1,0,1,0,1,0,0,0,10,540220,1366,-9,4,-5,3,1,0,-16,1,1
KR_7724712813,18874,15415,266,241,12,7,7,12,14,10,0,1,0,0,22,15,4,2,4,0,1,0,0,1,1,0,10,540199,3459,25,5,-5,4,-1,0,7,2,4
KR_7724724909,14658,14230,293,298,2,2,2,2,1,2,0,1,0,0,11,13,2,3,0,0,0,1,0,1,0,0,10,540274,428,-5,0,0,-1,-1,0,-2,-1,0
KR_7724729038,16411,12494,292,245,7,0,1,7,9,0,0,1,0,0,18,16,2,1,0,0,1,0,0,1,0,0,10,540229,3917,47,7,-6,9,-1,0,2,1,0
KR_7724746612,15988,16077,301,250,5,8,8,5,6,9,0,1,0,0,35,13,2,4,1,0,0,1,0,1,0,0,10,540239,-89,51,-3,3,-3,-1,0,22,-2,1
KR_7724754824,16305,16450,220,222,8,11,11,8,11,15,0,0,0,0,19,39,4,8,3,0,0,1,0,0,0,0,10,540245,-145,-2,-3,3,-4,0,0,-20,-4,3
KR_7724755005,15835,13603,243,253,7,2,3,7,9,2,0,0,0,0,14,17,5,6,1,0,1,0,0,0,0,0,10,540209,2232,-10,5,-4,7,0,0,-3,-1,1
KR_7724757407,13396,13859,263,243,1,4,4,1,0,5,0,0,0,0,12,17,4,4,0,0,1,0,0,0,0,0,10,540216,-463,20,-3,3,-5,0,0,-5,0,0
KR_7724776697,15164,15939,234,269,7,7,7,7,6,7,0,0,0,0,17,17,2,4,0,0,1,0,0,0,0,0,10,540241,-775,-35,0,0,-1,0,0,0,-2,0
KR_7724793795,16942,15115,274,261,10,5,5,10,11,3,1,0,0,0,17,16,3,3,1,1,1,0,1,0,0,0,10,540264,1827,13,5,-5,8,1,0,1,0,0
KR_7724796085,15371,15558,251,245,6,7,8,6,7,10,1,0,0,0,15,20,2,4,0,1,0,1,1,0,0,0,10,540191,-187,6,-1,2,-3,1,0,-5,-2,-1
KR_7724805978,14301,16087,253,252,4,8,8,6,2,7,0,0,0,0,13,17,3,1,0,0,0,1,0,0,0,0,10,540213,-1786,1,-4,2,-5,0,0,-4,2,0
KR_7724839414,15305,15859,301,301,4,5,5,4,8,6,1,0,0,0,28,31,3,4,0,1,1,0,1,0,0,0,10,540205,-554,0,-1,1,2,1,0,-3,-1,-1
KR_7724848194,14597,14051,290,279,2,1,1,2,2,2,0,0,0,0,45,17,5,4,1,2,1,0,0,0,0,0,10,540259,546,11,1,-1,0,0,0,28,1,-1
KR_7724859144,16817,15508,253,247,10,6,6,10,11,7,1,0,0,0,21,14,1,1,0,0,1,0,1,0,0,0,10,540205,1309,6,4,-4,4,1,0,7,0,0
KR_7724864993,16334,12996,297,265,4,1,1,4,11,0,0,1,0,0,34,14,2,0,0,0,0,1,0,1,0,0,10,540204,3338,32,3,-3,11,-1,0,20,2,0
KR_7724884423,15166,14525,260,255,6,4,4,6,6,6,1,0,0,0,16,17,2,1,0,0,1,0,1,0,0,0,10,540230,641,5,2,-2,0,1,0,-1,1,0
KR_7724897992,14851,14353,274,262,4,3,4,4,7,4,0,1,0,0,19,20,4,3,1,1,0,1,0,1,0,0,10,540247,498,12,1,0,3,-1,0,-1,1,0
KR_7724908791,15510,13952,241,233,7,3,3,7,6,5,0,0,0,0,46,14,4,4,0,2,0,1,0,0,0,0,10,540206,1558,8,4,-4,1,0,0,32,0,-2
KR_7724939783,16987,14967,236,245,10,5,5,10,17,7,0,0,0,0,17,13,1,4,0,1,1,0,0,0,0,0,10,540224,2020,-9,5,-5,10,0,0,4,-3,-1
KR_7724940761,14664,15428,290,277,3,4,4,3,5,6,0,0,0,0,11,15,3,4,1,0,1,0,0,0,0,0,10,540240,-764,13,-1,1,-1,0,0,-4,-1,1
KR_7724947886,16097,14296,257,230,8,5,7,8,5,11,0,0,0,0,20,14,1,4,0,1,0,1,0,0,0,0,10,540254,1801,27,3,-1,-6,0,0,6,-3,-1
KR_7724977623,15299,14362,267,272,6,2,2,6,9,1,0,0,0,0,18,16,3,3,0,1,0,1,0,0,0,0,10,540218,937,-5,4,-4,8,0,0,2,0,-1
KR_7724981559,14259,16693,217,246,5,9,9,5,10,12,0,0,0,0,46,16,4,2,1,2,1,0,0,0,0,0,10,540226,-2434,-29,-4,4,-2,0,0,30,2,-1
KR_7724989866,13660,14619,266,268,1,4,4,1,2,7,0,0,0,0,16,15,3,5,0,0,0,1,0,0,0,0,10,540237,-959,-2,-3,3,-5,0,0,1,-2,0
KR_7725015999,15750,17179,266,270,6,9,9,6,7,11,0,0,0,0,100,17,4,4,1,0,0,1,0,0,0,0,10,540202,-1429,-4,-3,3,-4,0,0,83,0,1
KR_7725040776,14850,14635,260,229,5,5,5,5,5,9,0,0,0,0,16,125,2,2,1,2,0,1,0,0,0,0,10,540249,215,31,0,0,-4,0,0,-109,0,-1
KR_7725042016,16233,13543,266,268,8,2,2,8,10,1,0,1,0,0,18,18,4,2,0,0,1,0,0,1,0,0,10,540284,2690,-2,6,-6,9,-1,0,0,2,0
KR_7725045831,16207,16997,211,225,10,12,12,10,13,13,0,0,0,0,13,21,2,1,1,2,0,1,0,0,0,0,10,540270,-790,-14,-2,2,0,0,0,-8,1,-1
KR_7725055080,17559,16320,284,238,9,9,9,9,11,8,0,0,0,0,16,19,8,2,0,1,1,0,0,0,0,0,10,540270,1239,46,0,0,3,0,0,-3,6,-1
KR_7725062100,15276,13735,285,264,4,2,3,4,5,2,0,0,0,0,16,19,3,3,1,0,0,1,0,0,0,0,10,540207,1541,21,2,-1,3,0,0,-3,0,1
KR_7725087425,15116,14993,269,264,5,4,4,5,3,5,0,0,0,0,13,15,3,3,2,1,0,1,0,0,0,0,10,540273,123,5,1,-1,-2,0,0,-2,0,1
KR_7725095938,14033,14436,269,224,2,6,6,2,3,7,0,0,0,0,13,16,2,3,0,0,0,1,0,0,0,0,10,540106,-403,45,-4,4,-4,0,0,-3,-1,0
KR_7725107695,14301,15626,272,322,3,5,5,3,4,0,0,0,0,0,15,13,1,2,0,1,0,1,0,0,0,0,10,540258,-1325,-50,-2,2,4,0,0,2,-1,-1
KR_7725153122,16417,13937,284,250,7,3,3,7,7,2,0,0,0,0,12,17,6,4,0,0,1,0,0,0,0,0,10,540133,2480,34,4,-4,5,0,0,-5,2,0
KR_7725223536,15642,14514,292,277,4,3,3,4,5,4,0,0,0,0,19,121,0,2,1,1,1,0,0,0,0,0,10,540222,1128,15,1,-1,1,0,0,-102,-2,0
KR_7725242286,14847,14135,243,281,5,2,2,5,6,1,0,1,0,0,12,13,1,3,0,2,0,1,0,1,0,0,10,540213,712,-38,3,-3,5,-1,0,-1,-2,-2
KR_7725258669,15205,14676,278,271,5,3,3,5,5,3,0,0,0,0,20,18,4,5,0,0,1,0,0,0,0,0,10,540265,529,7,2,-2,2,0,0,2,-1,0
KR_7725275258,17486,16191,258,258,10,7,7,10,8,12,1,0,0,0,21,17,6,3,1,1,1,0,1,0,0,0,10,540177,1295,0,3,-3,-4,1,0,4,3,0
KR_7725294044,15050,14899,237,237,5,7,7,5,6,1,1,0,0,0,18,34,3,4,1,1,0,1,1,0,0,0,10,540240,151,0,-2,2,5,1,0,-16,-1,0
KR_7725315261,15977,16280,220,253,11,7,7,11,6,8,1,0,0,0,15,29,3,4,1,1,1,0,1,0,0,0,10,540209,-303,-33,4,-4,-2,1,0,-14,-1,0
KR_7725321175,14805,13588,262,226,4,4,4,4,3,4,0,1,0,0,20,19,3,4,0,0,1,0,0,1,0,0,10,540262,1217,36,0,0,-1,-1,0,1,-1,0
KR_7725322696,15524,13485,258,250,6,2,2,6,5,3,0,0,0,0,19,15,0,4,1,0,0,1,0,0,0,0,10,540211,2039,8,4,-4,2,0,0,4,-4,1
KR_7725343119,13826,13443,287,285,1,1,1,1,2,0,0,1,0,0,25,22,5,2,0,0,0,1,0,1,0,0,10,540253,383,2,0,0,2,-1,0,3,3,0
KR_7725353723,13607,17479,239,271,2,10,10,2,3,10,0,1,0,0,11,70,1,3,0,3,0,1,0,1,0,0,10,540173,-3872,-32,-8,8,-7,-1,0,-59,-2,-3
KR_7725369985,15211,16213,272,288,5,6,6,5,3,6,0,0,0,0,20,23,4,6,0,0,0,1,0,0,0,0,10,540161,-1002,-16,-1,1,-3,0,0,-3,-2,0
KR_7725392281,16828,16691,280,270,9,7,7,9,8,8,0,1,0,0,19,19,4,3,0,1,0,1,0,1,0,0,10,540186,137,10,2,-2,0,-1,0,0,1,-1
KR_7725398022,13260,15620,284,294,0,5,5,0,0,3,0,1,0,0,13,17,5,4,0,0,0,1,0,1,0,0,10,540249,-2360,-10,-5,5,-3,-1,0,-4,1,0
KR_7725420005,14015,15020,250,253,4,5,5,4,1,4,0,0,0,0,17,18,2,4,0,1,1,0,0,0,0,0,10,540205,-1005,-3,-1,1,-3,0,0,-1,-2,-1
KR_7725429874,15842,17332,245,244,6,11,11,6,3,10,0,0,0,0,13,16,2,2,0,1,0,1,0,0,0,0,10,540208,-1490,1,-5,5,-7,0,0,-3,0,-1
KR_7725452031,15164,16864,256,277,5,7,7,5,4,12,1,0,0,0,13,38,3,4,1,3,0,1,1,0,0,0,10,540282,-1700,-21,-2,2,-8,1,0,-25,-1,-2
KR_7725457656,14301,14898,277,251,3,5,5,3,3,6,1,0,0,0,22,17,2,3,0,0,1,0,1,0,0,0,10,540186,-597,26,-2,2,-3,1,0,5,-1,0
KR_7725470747,15027,12855,288,271,4,0,0,4,1,0,0,1,0,0,17,20,7,4,1,0,1,0,0,1,0,0,10,540191,2172,17,4,-4,1,-1,0,-3,3,1
KR_7725480004,16610,16683,264,217,7,11,11,8,11,17,0,0,0,0,15,16,3,3,1,0,0,1,0,0,0,0,10,540269,-73,47,-4,3,-6,0,0,-1,0,1
KR_7725487220,15330,15766,244,260,6,7,7,6,8,7,0,0,0,0,22,108,5,1,0,0,1,0,0,0,0,0,10,540222,-436,-16,-1,1,1,0,0,-86,4,0
KR_7725492095,14936,15744,262,285,4,6,6,4,6,7,0,0,0,0,16,18,6,1,0,0,0,1,0,0,0,0,10,540160,-808,-23,-2,2,-1,0,0,-2,5,0
KR_7725500231,14349,17711,206,257,6,12,12,6,5,15,0,0,0,0,10,28,1,1,1,2,0,1,0,0,0,0,10,540284,-3362,-51,-6,6,-10,0,0,-18,0,-1
KR_7725514701,14705,16352,244,291,5,7,7,6,5,5,0,1,0,0,11,33,18,5,0,1,0,1,0,1,0,0,10,540104,-1647,-47,-2,1,0,-1,0,-22,13,-1
KR_7725531352,16801,16255,242,269,10,7,7,10,19,7,0,0,0,0,15,12,1,4,1,1,1,0,0,0,0,0,10,540223,546,-27,3,-3,12,0,0,3,-3,0
KR_7725536297,15758,16173,264,284,6,5,5,6,4,5,0,1,0,0,29,18,4,3,0,3,0,1,0,1,0,0,10,540170,-415,-20,1,-1,-1,-1,0,11,1,-3
KR_7725541042,16598,13341,274,231,9,3,3,9,7,3,0,0,0,0,18,17,3,2,1,0,0,1,0,0,0,0,10,540092,3257,43,6,-6,4,0,0,1,1,1
KR_7725543464,14610,16085,243,260,4,7,7,4,7,13,0,1,0,0,16,19,2,2,0,1,1,0,0,1,0,0,10,540282,-1475,-17,-3,3,-6,-1,0,-3,0,-1
KR_7725556125,15557,14690,245,238,7,5,5,7,11,7,0,0,0,0,16,15,1,1,0,0,1,0,0,0,0,0,10,540233,867,7,2,-2,4,0,0,1,0,0
KR_7725562041,16615,13241,259,258,9,1,1,9,13,1,1,0,0,0,18,13,2,2,0,0,1,0,1,0,0,0,10,540272,3374,1,8,-8,12,1,0,5,0,0
KR_7725569410,14497,14335,271,281,3,3,3,3,3,1,0,0,0,0,17,13,3,2,1,1,1,0,0,0,0,0,10,540210,162,-10,0,0,2,0,0,4,1,0
KR_7725586446,13823,15424,263,302,2,4,4,2,4,3,0,1,0,0,17,22,3,2,0,1,0,1,0,1,0,0,10,540284,-1601,-39,-2,2,1,-1,0,-5,1,-1
KR_7725669357,15512,16579,274,285,5,7,7,5,8,7,0,0,0,0,12,16,2,2,0,2,1,0,0,0,0,0,10,540277,-1067,-11,-2,2,1,0,0,-4,0,-2
KR_7725751664,14966,14221,285,276,4,2,2,4,2,1,1,0,0,0,138,15,1,3,2,1,1,0,1,0,0,0,10,540235,745,9,2,-2,1,1,0,123,-2,1
KR_7725756967,15236,14884,241,274,6,6,6,7,6,1,0,0,0,0,15,13,4,2,0,1,1,0,0,0,0,0,10,540203,352,-33,0,-1,5,0,0,2,2,-1
KR_7725784604,16818,13791,272,236,11,3,3,11,6,4,0,0,0,0,106,17,2,3,0,0,1,0,0,0,0,0,10,540212,3027,36,8,-8,2,0,0,89,-1,0
KR_7725805541,15029,14984,279,291,4,3,3,4,4,5,1,0,0,0,16,107,4,5,2,0,1,0,1,0,0,0,10,540196,45,-12,1,-1,-1,1,0,-91,-1,2
KR_7725843302,13849,13393,264,261,3,2,2,3,0,1,0,0,0,0,136,14,0,4,1,1,1,0,0,0,0,0,10,540283,456,3,1,-1,-1,0,0,122,-4,0
KR_7725864614,16438,14452,253,275,9,3,3,9,8,2,0,0,0,0,20,15,5,5,0,1,1,0,0,0,0,0,10,540256,1986,-22,6,-6,6,0,0,5,0,-1
KR_7725867339,17149,16352,246,257,11,8,8,11,9,11,0,0,0,0,15,18,3,2,0,0,1,0,0,0,0,0,10,540265,797,-11,3,-3,-2,0,0,-3,1,0
KR_7725870611,15060,15056,255,238,5,6,6,5,8,11,0,0,0,0,35,15,2,2,0,0,0,1,0,0,0,0,10,540230,4,17,-1,1,-3,0,0,20,0,0
KR_7725893000,14053,15542,278,263,2,7,7,2,1,5,0,1,0,0,15,20,4,2,0,0,0,1,0,1,0,0,10,540250,-1489,15,-5,5,-4,-1,0,-5,2,0
KR_7725895603,15914,15973,254,242,7,8,8,7,5,10,0,0,0,0,16,26,2,3,0,0,0,1,0,0,0,0,10,540251,-59,12,-1,1,-5,0,0,-10,-1,0
KR_7725928725,15492,17363,280,259,6,12,12,6,2,9,0,0,0,0,30,21,4,4,0,0,1,0,0,0,0,0,10,540229,-1871,21,-6,6,-7,0,0,9,0,0
KR_7725960779,14556,14654,251,248,5,5,5,5,5,4,0,1,0,0,38,13,4,1,0,0,1,0,0,1,0,0,10,540278,-98,3,0,0,1,-1,0,25,3,0
KR_7725992443,14764,16635,231,236,5,9,9,5,6,11,0,1,0,0,15,16,4,1,1,2,1,0,0,1,0,0,10,540242,-1871,-5,-4,4,-5,-1,0,-1,3,-1
KR_7726023902,13786,13542,261,223,3,3,3,3,1,2,1,0,0,0,14,14,0,2,0,0,0,1,1,0,0,0,10,540241,244,38,0,0,-1,1,0,0,-2,0
KR_7726096884,16640,14554,256,251,9,4,4,9,14,6,0,1,0,0,15,13,2,4,2,0,1,0,0,1,0,0,10,540208,2086,5,5,-5,8,-1,0,2,-2,2
KR_7726122956,14558,15239,246,274,5,4,4,5,5,3,0,1,0,0,26,18,4,5,0,1,1,0,0,1,0,0,10,540197,-681,-28,1,-1,2,-1,0,8,-1,-1
KR_7726154630,14727,14841,275,262,4,4,4,4,4,4,1,0,0,0,42,25,3,1,1,1,1,0,1,0,0,0,10,540120,-114,13,0,0,0,1,0,17,2,0
KR_7726163963,15690,13448,285,238,5,4,4,5,8,1,1,0,0,0,13,15,6,1,0,0,0,1,1,0,0,0,10,540243,2242,47,1,-1,7,1,0,-2,5,0
KR_7726178908,14053,13503,263,271,3,2,2,3,3,1,0,0,0,0,11,14,2,0,0,0,1,0,0,0,0,0,10,540219,550,-8,1,-1,2,0,0,-3,2,0
KR_7726184435,16508,15725,259,273,7,6,6,7,7,5,0,1,0,0,13,140,4,3,1,0,1,0,0,1,0,0,10,540222,783,-14,1,-1,2,-1,0,-127,1,1
KR_7726204337,17404,16221,279,255,9,8,8,9,7,5,1,0,0,0,15,38,2,1,1,0,1,0,1,0,0,0,10,540245,1183,24,1,-1,2,1,0,-23,1,1
KR_7726205196,16230,14835,245,270,8,5,6,8,12,3,1,0,0,0,36,19,4,6,1,0,0,1,1,0,0,0,10,540193,1395,-25,3,-2,9,1,0,17,-2,1
KR_7726240994,16091,13898,251,233,9,3,3,9,8,3,1,0,0,0,16,16,1,1,2,0,1,0,1,0,0,0,10,540223,2193,18,6,-6,5,1,0,0,0,2
KR_7726248844,15455,13908,255,268,6,3,3,6,8,1,0,0,0,0,12,44,1,4,0,0,0,1,0,0,0,0,10,540252,1547,-13,3,-3,7,0,0,-32,-3,0
KR_7726260469,14716,16323,270,311,2,7,7,2,6,9,0,0,0,0,17,15,2,5,0,0,0,1,0,0,0,0,10,540195,-1607,-41,-5,5,-3,0,0,2,-3,0
KR_7726290839,16327,17333,227,248,10,11,11,11,10,12,1,0,0,0,18,35,2,4,0,0,0,1,1,0,0,0,10,540218,-1006,-21,-1,0,-2,1,0,-17,-2,0
KR_7726294309,15408,15567,246,238,5,7,7,5,6,7,0,0,0,0,13,14,1,0,3,1,1,0,0,0,0,0,10,540255,-159,8,-2,2,-1,0,0,-1,1,2
KR_7726302424,14415,14948,260,281,4,2,2,4,3,2,0,1,0,0,16,18,3,4,1,2,1,0,0,1,0,0,10,540277,-533,-21,2,-2,1,-1,0,-2,-1,-1
KR_7726324848,15574,14777,261,257,7,4,4,7,6,3,0,0,0,0,14,12,0,2,1,2,1,0,0,0,0,0,10,540256,797,4,3,-3,3,0,0,2,-2,-1
KR_7726369539,2541,2557,0,1,0,0,0,0,0,0,0,0,0,0,0,2,0,0,0,0,0,0,0,0,0,0,3,108342,-16,-1,0,0,0,0,0,-2,0,0
KR_7726400169,13567,14166,286,281,1,2,2,1,0,1,0,1,0,0,15,15,2,2,0,1,1,0,0,1,0,0,10,540214,-599,5,-1,1,-1,-1,0,0,0,-1
KR_7726412295,15622,14333,266,284,8,3,3,8,6,1,0,1,0,0,15,17,2,2,0,0,1,0,0,1,0,0,10,540191,1289,-18,5,-5,5,-1,0,-2,0,0
KR_7726416168,18550,15722,260,196,13,7,7,13,14,16,0,1,0,0,21,50,2,9,1,0,0,1,0,1,0,0,10,540229,2828,64,6,-6,-2,-1,0,-29,-7,1
KR_7726440477,13256,15967,260,256,1,8,8,1,2,9,0,1,0,0,15,16,1,2,2,1,0,1,0,1,0,0,10,540242,-2711,4,-7,7,-7,-1,0,-1,-1,1
KR_7726475779,16552,13449,263,290,8,1,1,8,7,0,0,1,0,0,26,13,3,3,1,0,0,1,0,1,0,0,10,540218,3103,-27,7,-7,7,-1,0,13,0,1
KR_7726482795,14232,13919,281,290,2,1,1,2,2,2,0,0,0,0,19,14,2,6,1,0,1,0,0,0,0,0,10,540216,313,-9,1,-1,0,0,0,5,-4,1
KR_7726486510,15145,15446,265,271,6,5,5,6,7,9,1,0,0,0,15,17,4,6,1,0,1,0,1,0,0,0,10,540201,-301,-6,1,-1,-2,1,0,-2,-2,1
KR_7726526931,13524,16447,238,231,2,10,10,2,4,10,0,1,0,0,20,29,2,3,1,2,0,1,0,1,0,0,10,540199,-2923,7,-8,8,-6,-1,0,-9,-1,-1
KR_7726541702,14837,17284,283,289,3,8,8,3,5,11,0,0,0,0,22,85,1,5,0,4,1,0,0,0,0,0,10,540228,-2447,-6,-5,5,-6,0,0,-63,-4,-4
KR_7726542048,15658,15426,262,282,6,4,5,6,8,5,0,0,0,0,12,20,1,1,0,2,0,1,0,0,0,0,10,540241,232,-20,2,-1,3,0,0,-8,0,-2
KR_7726545574,15651,15780,286,259,5,6,7,5,5,8,0,0,0,0,15,19,2,4,1,0,1,0,0,0,0,0,10,540193,-129,27,-1,2,-3,0,0,-4,-2,1
KR_7726569361,15927,15903,256,264,7,6,6,7,10,9,0,1,0,0,14,16,2,2,0,1,0,1,0,1,0,0,10,540185,24,-8,1,-1,1,-1,0,-2,0,-1
KR_7726572794,15143,14944,255,257,5,5,5,5,6,3,0,1,0,0,19,17,4,8,1,1,0,1,0,1,0,0,10,540238,199,-2,0,0,3,-1,0,2,-4,0
KR_7726575545,14378,15447,238,246,4,6,6,4,8,5,0,1,0,0,24,14,2,2,0,2,1,0,0,1,0,0,10,540220,-1069,-8,-2,2,3,-1,0,10,0,-2
KR_7726590966,16653,15259,282,283,7,3,3,7,12,3,1,0,0,0,27,18,7,2,0,3,1,0,1,0,0,0,10,540251,1394,-1,4,-4,9,1,0,9,5,-3
KR_7726594300,15311,15384,259,269,6,6,6,6,6,5,0,0,0,0,24,23,3,4,1,0,1,0,0,0,0,0,10,540248,-73,-10,0,0,1,0,0,1,-1,1
KR_7726603398,16970,16932,241,198,10,14,14,11,14,19,0,1,0,0,17,18,2,3,3,0,0,1,0,1,0,0,10,540291,38,43,-4,3,-5,-1,0,-1,-1,3
KR_7726606486,14710,13964,238,249,5,4,4,6,11,5,1,0,0,0,21,14,3,3,1,0,1,0,1,0,0,0,10,540210,746,-11,1,-2,6,1,0,7,0,1
KR_7726663658,17484,15650,239,216,13,8,8,13,16,12,0,0,0,0,40,16,3,8,1,0,1,0,0,0,0,0,10,540221,1834,23,5,-5,4,0,0,24,-5,1
KR_7726677271,14082,16314,257,280,3,8,8,3,4,9,0,1,0,0,11,18,2,1,0,0,0,1,0,1,0,0,10,540196,-2232,-23,-5,5,-5,-1,0,-7,1,0
KR_7726680706,14655,15712,265,254,4,7,7,4,2,3,0,0,0,0,19,12,2,4,0,1,1,0,0,0,0,0,10,540197,-1057,11,-3,3,-1,0,0,7,-2,-1
KR_7726724308,13661,14208,285,263,1,3,3,1,0,2,0,0,0,0,17,12,1,4,1,0,0,1,0,0,0,0,10,540216,-547,22,-2,2,-2,0,0,5,-3,1
KR_7726774493,16021,15774,251,270,8,6,6,8,7,4,0,0,0,0,18,19,5,2,1,1,1,0,0,0,0,0,10,540250,247,-19,2,-2,3,0,0,-1,3,0
KR_7726792628,14682,15946,236,264,5,7,7,5,6,7,0,0,0,0,137,14,7,3,0,0,1,0,0,0,0,0,10,540276,-1264,-28,-2,2,-1,0,0,123,4,0
KR_7726823551,16454,12741,314,236,6,1,1,6,9,1,0,0,0,0,24,54,7,7,1,0,1,0,0,0,0,0,10,540278,3713,78,5,-5,8,0,0,-30,0,1
KR_7726832486,15332,15806,270,294,5,5,5,5,7,9,0,0,0,0,12,12,1,2,0,1,0,1,0,0,0,0,10,540142,-474,-24,0,0,-2,0,0,0,-1,-1
KR_7726852551,15940,14304,292,319,5,1,1,5,6,0,0,1,0,0,13,16,5,1,0,1,0,1,0,1,0,0,10,540203,1636,-27,4,-4,6,-1,0,-3,4,-1
KR_7726872078,15400,15559,252,255,5,7,7,5,4,10,0,1,0,0,18,21,5,3,0,1,1,0,0,1,0,0,10,540215,-159,-3,-2,2,-6,-1,0,-3,2,-1
KR_7726883758,16514,14195,289,259,8,3,3,8,7,3,0,0,0,0,15,15,3,3,0,0,1,0,0,0,0,0,10,540209,2319,30,5,-5,4,0,0,0,0,0
KR_7726894171,16888,16719,264,284,10,8,8,10,10,4,0,0,0,0,107,25,2,2,0,0,1,0,0,0,0,0,10,540191,169,-20,2,-2,6,0,0,82,0,0
KR_7726895484,17433,16842,227,243,11,9,9,11,26,17,0,0,0,0,19,15,1,4,0,0,0,1,0,0,0,0,10,540222,591,-16,2,-2,9,0,0,4,-3,0
KR_7726907588,15699,15048,264,257,7,6,6,7,6,9,0,1,0,0,14,15,2,3,0,1,0,1,0,1,0,0,10,540215,651,7,1,-1,-3,-1,0,-1,-1,-1
KR_7726919762,16967,14458,257,258,10,5,5,10,13,6,0,1,0,0,15,16,3,1,1,0,0,1,0,1,0,0,10,540244,2509,-1,5,-5,7,-1,0,-1,2,1
KR_7726926725,17476,15252,262,247,11,6,6,11,15,4,1,0,0,0,14,17,2,1,1,0,1,0,1,0,0,0,10,540218,2224,15,5,-5,11,1,0,-3,1,1
KR_7726949324,15610,13691,278,222,5,4,4,5,6,6,0,1,0,0,375,16,4,4,1,0,1,0,0,1,0,0,10,540325,1919,56,1,-1,0,-1,0,359,0,1
KR_7726957249,16099,15173,282,273,6,4,4,6,9,7,0,1,0,0,17,16,6,1,0,0,1,0,0,1,0,0,10,540246,926,9,2,-2,2,-1,0,1,5,0
KR_7726963333,15187,14450,288,288,3,2,2,3,4,5,1,0,0,0,21,16,5,6,2,1,0,1,1,0,0,0,10,540206,737,0,1,-1,-1,1,0,5,-1,1
KR_7726976535,16032,15087,264,248,9,5,5,9,3,5,0,0,0,0,16,19,3,3,2,0,1,0,0,0,0,0,10,540218,945,16,4,-4,-2,0,0,-3,0,2
KR_7726982963,13793,16162,248,272,3,7,7,3,4,10,1,0,0,0,26,21,4,7,0,0,1,0,1,0,0,0,10,540227,-2369,-24,-4,4,-6,1,0,5,-3,0
KR_7726992113,18319,16181,274,251,12,7,7,12,21,9,0,0,0,0,19,17,5,4,1,0,0,1,0,0,0,0,10,540131,2138,23,5,-5,12,0,0,2,1,1
KR_7726994751,13615,16340,246,300,3,7,7,3,2,7,0,0,0,0,18,17,2,3,0,1,0,1,0,0,0,0,10,540206,-2725,-54,-4,4,-5,0,0,1,-1,-1
KR_7727018959,15054,16311,221,231,6,9,9,6,11,12,0,0,0,0,295,36,0,3,0,1,1,0,0,0,0,0,10,540242,-1257,-10,-3,3,-1,0,0,259,-3,-1
KR_7727039104,15450,15480,265,243,7,6,6,7,7,10,0,0,0,0,20,20,3,3,0,0,1,0,0,0,0,0,10,540113,-30,22,1,-1,-3,0,0,0,0,0
KR_7727068375,14004,15318,274,278,2,5,5,2,2,5,0,0,0,0,17,21,5,4,0,0,0,1,0,0,0,0,10,540212,-1314,-4,-3,3,-3,0,0,-4,1,0
KR_7727073333,2599,2701,0,6,0,0,0,0,0,0,0,0,0,0,2,3,0,1,0,0,0,0,0,0,0,0,3,106319,-102,-6,0,0,0,0,0,-1,-1,0
KR_7727083965,14198,14959,246,280,4,3,3,4,6,4,1,0,0,0,18,16,2,3,0,2,1,0,1,0,0,0,10,540280,-761,-34,1,-1,2,1,0,2,-1,-2
KR_7727113810,18094,17242,253,244,12,9,9,12,23,19,1,0,0,0,17,16,5,2,0,2,0,1,1,0,0,0,10,540238,852,9,3,-3,4,1,0,1,3,-2
KR_7727140747,19399,13898,288,213,13,5,5,13,26,6,0,0,0,0,19,16,4,5,1,0,1,0,0,0,0,0,10,540249,5501,75,8,-8,20,0,0,3,-1,1
KR_7727205638,16095,14724,260,251,7,5,5,7,8,4,0,0,0,0,17,102,5,2,0,1,0,1,0,0,0,0,10,540189,1371,9,2,-2,4,0,0,-85,3,-1
KR_7727261211,15713,15664,285,298,5,5,5,5,4,3,0,0,0,0,18,19,5,2,1,1,0,1,0,0,0,0,10,540253,49,-13,0,0,1,0,0,-1,3,0
KR_7727281724,15136,16606,248,270,6,7,7,6,3,9,1,0,0,0,13,22,3,2,0,5,1,0,1,0,0,0,10,540229,-1470,-22,-1,1,-6,1,0,-9,1,-5
KR_7727298289,17079,15378,284,274,9,4,4,10,15,4,0,1,0,0,17,18,1,2,1,0,1,0,0,1,0,0,10,540230,1701,10,5,-6,11,-1,0,-1,-1,1
KR_7727299492,15198,15349,271,284,4,5,5,4,5,8,0,1,0,0,17,36,2,5,0,1,1,0,0,1,0,0,10,540230,-151,-13,-1,1,-3,-1,0,-19,-3,-1
KR_7727324227,15201,15546,266,232,5,7,7,5,5,5,0,0,0,0,14,20,2,2,1,0,0,1,0,0,0,0,10,540255,-345,34,-2,2,0,0,0,-6,0,1
KR_7727327247,14589,14749,266,246,3,5,5,3,6,6,1,0,0,0,25,19,4,0,2,1,1,0,1,0,0,0,10,540241,-160,20,-2,2,0,1,0,6,4,1
KR_7727341274,14561,14778,249,254,4,5,5,4,7,4,0,1,0,0,18,17,4,4,0,0,0,1,0,1,0,0,10,540255,-217,-5,-1,1,3,-1,0,1,0,0
KR_7727413312,16955,16033,234,241,11,9,9,11,19,16,0,1,0,0,15,14,0,4,0,1,0,1,0,1,0,0,10,540253,922,-7,2,-2,3,-1,0,1,-4,-1
KR_7727473170,14886,16340,257,250,4,8,8,4,6,11,0,0,0,0,16,18,3,4,4,0,0,1,0,0,0,0,10,540112,-1454,7,-4,4,-5,0,0,-2,-1,4
KR_7727479506,15500,15238,295,269,4,5,5,4,7,10,1,0,0,0,13,16,5,3,0,0,1,0,1,0,0,0,10,540243,262,26,-1,1,-3,1,0,-3,2,0
KR_7727483902,13160,18093,239,295,1,12,12,2,2,10,0,0,0,0,14,17,4,5,0,3,0,1,0,0,0,0,10,540224,-4933,-56,-11,10,-8,0,0,-3,-1,-3
KR_7727526509,16063,15438,268,258,7,6,6,7,8,11,1,0,0,0,16,18,3,3,1,0,0,1,1,0,0,0,10,540217,625,10,1,-1,-3,1,0,-2,0,1
KR_7727528270,15669,15333,291,267,6,4,4,6,7,4,0,0,0,0,18,42,5,4,0,2,1,0,0,0,0,0,10,540233,336,24,2,-2,3,0,0,-24,1,-2
KR_7727536897,13710,13273,280,287,2,0,0,2,2,0,0,0,0,0,14,15,4,5,0,0,1,0,0,0,0,0,10,540215,437,-7,2,-2,2,0,0,-1,-1,0
KR_7727574276,14176,15240,252,253,3,6,6,3,5,10,0,0,0,0,11,16,2,3,1,1,0,1,0,0,0,0,10,540230,-1064,-1,-3,3,-5,0,0,-5,-1,0
KR_7727579226,14578,16160,241,285,5,6,6,5,5,6,0,0,0,0,27,16,4,6,0,3,1,0,0,0,0,0,10,540212,-1582,-44,-1,1,-1,0,0,11,-2,-3
KR_7727581245,14684,16115,238,271,5,8,8,5,3,3,0,1,0,0,11,19,5,2,1,1,0,1,0,1,0,0,10,540235,-1431,-33,-3,3,0,-1,0,-8,3,0
KR_7727605271,17910,14418,309,274,10,3,3,10,19,4,0,0,0,0,17,114,5,5,0,0,1,0,0,0,0,0,10,540247,3492,35,7,-7,15,0,0,-97,0,0
KR_7727647605,16974,15485,253,246,8,6,6,8,13,15,0,1,0,0,32,23,4,2,0,0,0,1,0,1,0,0,10,540112,1489,7,2,-2,-2,-1,0,9,2,0
KR_7727671964,15337,16149,264,280,7,7,7,7,5,7,0,0,0,0,19,21,4,5,0,0,0,1,0,0,0,0,10,540195,-812,-16,0,0,-2,0,0,-2,-1,0
KR_7727682171,13910,13584,229,261,4,2,2,4,4,1,0,0,0,0,13,19,4,3,1,1,0,1,0,0,0,0,10,540201,326,-32,2,-2,3,0,0,-6,1,0
KR_7727691392,17668,14974,226,223,14,6,7,14,14,6,0,0,0,0,12,17,4,4,2,0,1,0,0,0,0,0,10,540285,2694,3,8,-7,8,0,0,-5,0,2
KR_7727735665,12548,16414,242,286,1,8,8,1,0,7,0,0,0,0,17,11,1,2,0,1,1,0,0,0,0,0,10,540122,-3866,-44,-7,7,-7,0,0,6,-1,-1
KR_7727738363,14476,14575,262,269,3,4,4,3,3,5,0,0,0,0,14,19,4,3,0,0,1,0,0,0,0,0,10,540173,-99,-7,-1,1,-2,0,0,-5,1,0
KR_7727741036,15765,14131,274,274,7,2,2,7,10,2,0,0,0,0,13,17,7,3,0,0,1,0,0,0,0,0,10,540195,1634,0,5,-5,8,0,0,-4,4,0
KR_7727754761,13411,16806,266,270,1,8,8,1,2,15,0,0,0,0,46,139,4,4,0,1,0,1,0,0,0,0,10,540224,-3395,-4,-7,7,-13,0,0,-93,0,-1
KR_7727762937,14156,15789,256,293,4,4,4,4,3,3,1,0,0,0,15,115,3,3,1,3,1,0,1,0,0,0,10,540240,-1633,-37,0,0,0,1,0,-100,0,-2
KR_7727776552,14469,15035,282,276,2,4,4,2,3,2,0,0,0,0,20,39,3,3,0,2,0,1,0,0,0,0,10,540177,-566,6,-2,2,1,0,0,-19,0,-2
KR_7727780862,15945,15448,268,224,6,7,7,6,12,10,1,0,0,0,15,33,3,3,1,1,0,1,1,0,0,0,10,540274,497,44,-1,1,2,1,0,-18,0,0
KR_7727785800,14276,15827,268,238,3,7,7,3,2,13,0,0,0,0,16,35,4,2,0,0,0,1,0,0,0,0,10,540229,-1551,30,-4,4,-11,0,0,-19,2,0
KR_7727800261,14394,16175,267,260,3,7,7,3,4,10,0,0,0,0,16,19,4,1,1,1,1,0,0,0,0,0,10,540281,-1781,7,-4,4,-6,0,0,-3,3,0
KR_7727816384,16219,16540,236,276,8,8,8,8,9,10,0,0,0,0,13,23,1,2,0,1,0,1,0,0,0,0,10,540203,-321,-40,0,0,-1,0,0,-10,-1,-1
KR_7727828851,14048,15350,245,229,4,7,7,4,3,12,0,0,0,0,38,15,2,1,0,0,0,1,0,0,0,0,10,540243,-1302,16,-3,3,-9,0,0,23,1,0
KR_7727838258,15314,15846,250,281,6,6,6,6,6,9,0,0,0,0,19,17,1,3,0,0,1,0,0,0,0,0,10,540208,-532,-31,0,0,-3,0,0,2,-2,0
KR_7727845258,16153,13121,260,274,7,0,0,7,9,0,0,1,0,0,16,53,0,4,2,0,1,0,0,1,0,0,10,540259,3032,-14,7,-7,9,-1,0,-37,-4,2
KR_7727856655,14306,14577,261,276,4,3,3,4,3,5,0,0,0,0,18,17,1,2,0,0,1,0,0,0,0,0,10,540216,-271,-15,1,-1,-2,0,0,1,-1,0
KR_7727865818,13235,14779,242,289,2,2,2,2,1,2,0,0,0,0,41,14,1,5,0,5,0,1,0,0,0,0,10,540245,-1544,-47,0,0,-1,0,0,27,-4,-5
KR_7727871259,16676,14306,256,255,9,3,3,9,16,3,0,0,0,0,28,14,5,3,0,0,0,1,0,0,0,0,10,540277,2370,1,6,-6,13,0,0,14,2,0
KR_7727876786,14968,15723,264,278,4,6,6,4,7,6,0,0,0,0,13,18,5,4,1,0,1,0,0,0,0,0,10,540213,-755,-14,-2,2,1,0,0,-5,1,1
KR_7727885540,13885,18139,243,279,3,13,13,3,4,14,0,1,0,0,11,17,3,1,1,2,0,1,0,1,0,0,10,540224,-4254,-36,-10,10,-10,-1,0,-6,2,-1
KR_7727890818,14194,17385,261,263,3,11,11,3,2,13,0,0,0,0,14,31,2,1,1,2,0,1,0,0,0,0,10,540172,-3191,-2,-8,8,-11,0,0,-17,1,-1
KR_7727894075,18016,15264,242,223,12,7,7,12,21,12,1,0,0,0,21,15,2,3,1,0,1,0,1,0,0,0,10,540230,2752,19,5,-5,9,1,0,6,-1,1
KR_7727904673,16095,13609,292,260,5,2,3,5,10,2,0,0,0,0,17,19,4,3,0,0,0,1,0,0,0,0,10,540216,2486,32,3,-2,8,0,0,-2,1,0
KR_7727907562,14204,15280,250,271,3,5,5,3,5,3,0,1,0,0,16,172,1,5,0,3,0,1,0,1,0,0,10,540227,-1076,-21,-2,2,2,-1,0,-156,-4,-3
KR_7727915205,13977,15949,313,307,1,5,5,1,0,5,0,0,0,0,15,17,3,5,1,1,0,1,0,0,0,0,10,540097,-1972,6,-4,4,-5,0,0,-2,-2,0
KR_7727916664,14210,15147,269,269,3,6,6,3,2,4,0,0,0,0,15,16,2,2,0,1,1,0,0,0,0,0,10,540206,-937,0,-3,3,-2,0,0,-1,0,-1
KR_7727916747,16664,17344,247,258,8,9,9,8,11,19,0,0,0,0,13,31,4,2,1,0,1,0,0,0,0,0,10,540211,-680,-11,-1,1,-8,0,0,-18,2,1
KR_7727925630,14972,14355,285,299,4,2,2,4,5,2,0,0,0,0,13,15,2,0,0,0,1,0,0,0,0,0,10,540222,617,-14,2,-2,3,0,0,-2,2,0
KR_7727926766,10772,9237,166,93,6,5,5,6,2,7,0,0,0,0,6,5,1,0,0,0,1,0,0,0,0,0,7,319921,1535,73,1,-1,-5,0,0,1,1,0
KR_7727933994,15181,14224,259,235,6,4,4,6,5,5,0,1,0,0,114,14,0,3,0,1,1,0,0,1,0,0,10,540201,957,24,2,-2,0,-1,0,100,-3,-1
KR_7727937399,15744,14896,273,262,6,5,5,6,6,5,0,0,0,0,61,13,0,17,0,1,1,0,0,0,0,0,10,540200,848,11,1,-1,1,0,0,48,-17,-1
KR_7727943999,15719,15826,262,233,7,8,8,7,6,10,0,1,0,0,14,12,0,0,0,0,1,0,0,1,0,0,10,540261,-107,29,-1,1,-4,-1,0,2,0,0
KR_7727956209,14528,16125,272,277,3,7,7,3,3,11,0,1,0,0,18,34,1,4,0,0,1,0,0,1,0,0,10,540248,-1597,-5,-4,4,-8,-1,0,-16,-3,0
KR_7727961525,15111,17907,203,257,5,10,10,5,8,10,0,0,0,0,13,26,3,3,2,2,0,1,0,0,0,0,10,540246,-2796,-54,-5,5,-2,0,0,-13,0,0
KR_7728005183,15209,16401,259,284,5,6,6,5,6,9,1,0,0,0,17,13,1,4,0,1,0,1,1,0,0,0,10,540257,-1192,-25,-1,1,-3,1,0,4,-3,-1
KR_7728024882,13488,14776,238,229,3,6,7,3,1,10,0,0,0,0,16,13,3,1,0,0,0,1,0,0,0,0,10,540253,-1288,9,-3,4,-9,0,0,3,2,0
KR_7728026663,14293,17971,232,282,4,12,12,4,3,8,0,1,0,0,16,13,3,2,0,0,0,1,0,1,0,0,10,540217,-3678,-50,-8,8,-5,-1,0,3,1,0
KR_7728046853,17994,13185,281,229,9,2,2,9,12,6,0,0,0,0,20,26,1,1,5,0,1,0,0,0,1,0,10,540246,4809,52,7,-7,6,0,0,-6,0,5
KR_7728055440,19369,14315,263,236,16,4,4,16,21,3,0,0,0,0,31,12,0,2,2,0,1,0,0,0,0,0,10,540225,5054,27,12,-12,18,0,0,19,-2,2
KR_7728089503,15452,14364,252,253,6,4,4,6,7,7,0,1,0,0,17,32,1,3,0,0,0,1,0,1,0,0,10,540246,1088,-1,2,-2,0,-1,0,-15,-2,0
KR_7728148189,14262,15140,255,266,3,5,5,3,3,6,0,1,0,0,18,14,2,2,1,0,0,1,0,1,0,0,10,540248,-878,-11,-2,2,-3,-1,0,4,0,1
KR_7728253025,16036,14069,277,244,7,3,3,7,11,5,0,0,0,0,23,35,8,6,0,0,1,0,0,0,0,0,10,540272,1967,33,4,-4,6,0,0,-12,2,0
KR_7728310594,16719,15202,273,279,8,4,4,8,12,5,0,1,0,0,52,17,5,3,1,1,1,0,0,1,0,0,10,540274,1517,-6,4,-4,7,-1,0,35,2,0
KR_7728325369,15008,14653,268,243,4,6,6,4,3,5,0,0,0,0,13,16,4,2,2,1,1,0,0,0,0,0,10,540225,355,25,-2,2,-2,0,0,-3,2,1
KR_7728362108,13941,15353,252,300,3,3,3,3,3,3,0,1,0,0,14,15,1,3,0,1,0,1,0,1,0,0,10,540261,-1412,-48,0,0,0,-1,0,-1,-2,-1
KR_7728370897,15767,16976,220,270,8,10,10,8,7,9,1,0,0,0,20,61,3,6,1,1,0,1,1,0,0,0,10,540218,-1209,-50,-2,2,-2,1,0,-41,-3,0
KR_7728395581,13334,17092,248,291,2,10,10,2,3,10,0,1,0,0,106,20,3,3,0,0,1,0,0,1,0,0,10,540166,-3758,-43,-8,8,-7,-1,0,86,0,0
KR_7728413018,16423,15283,282,238,8,6,6,8,6,4,1,0,0,0,15,19,4,3,2,2,0,1,1,0,0,0,10,540215,1140,44,2,-2,2,1,0,-4,1,0
KR_7728418094,16059,14461,281,294,6,2,2,6,6,2,0,0,0,0,15,36,4,2,1,0,0,1,0,0,0,0,10,540169,1598,-13,4,-4,4,0,0,-21,2,1
KR_7728423808,12955,16541,229,270,2,9,9,3,2,6,0,0,0,0,17,15,4,1,0,1,0,1,0,0,0,0,10,540227,-3586,-41,-7,6,-4,0,0,2,3,-1
KR_7728430083,15863,15007,234,257,8,5,5,8,10,3,0,0,0,0,19,16,4,5,0,1,1,0,0,0,0,0,10,540228,856,-23,3,-3,7,0,0,3,-1,-1
KR_7728437715,13922,16672,267,270,3,8,8,3,1,6,0,0,0,0,12,21,1,3,0,1,0,1,0,0,0,0,10,540179,-2750,-3,-5,5,-5,0,0,-9,-2,-1
KR_7728448464,13180,16901,251,269,1,9,9,1,0,14,0,0,0,0,34,15,6,3,0,0,0,1,0,0,0,0,10,540270,-3721,-18,-8,8,-14,0,0,19,3,0
KR_7728466756,14910,17322,265,263,4,10,10,4,3,18,0,0,0,0,50,15,2,4,1,1,0,1,0,0,0,0,10,540162,-2412,2,-6,6,-15,0,0,35,-2,0
KR_7728468161,15700,14380,299,279,5,2,2,5,6,1,0,1,0,0,12,16,5,3,0,0,1,0,0,1,0,0,10,540194,1320,20,3,-3,5,-1,0,-4,2,0
KR_7728479148,13397,17542,235,255,3,10,10,3,2,21,0,1,0,0,18,21,4,4,0,1,0,1,0,1,0,0,10,540207,-4145,-20,-7,7,-19,-1,0,-3,0,-1
KR_7728485173,16598,13843,273,261,8,2,2,8,10,1,0,0,0,0,18,102,2,3,1,1,1,0,0,0,0,0,10,540211,2755,12,6,-6,9,0,0,-84,-1,0
KR_7728504743,15694,15609,222,229,9,8,8,9,10,4,1,0,0,0,16,14,5,1,1,1,1,0,1,0,0,0,10,540195,85,-7,1,-1,6,1,0,2,4,0
KR_7728518117,16711,15853,284,267,8,6,6,8,9,5,0,1,0,0,19,20,4,3,0,0,1,0,0,1,0,0,10,540276,858,17,2,-2,4,-1,0,-1,1,0
KR_7728521956,14390,13587,282,255,2,2,2,2,2,3,0,0,0,0,16,18,4,5,1,0,1,0,0,0,0,0,10,540226,803,27,0,0,-1,0,0,-2,-1,1
KR_7728536322,14299,14753,270,280,3,4,4,3,1,2,0,1,0,0,20,13,1,3,0,2,1,0,0,1,0,0,10,540194,-454,-10,-1,1,-1,-1,0,7,-2,-2
KR_7728536779,15837,13561,257,239,8,2,2,8,9,3,0,0,0,0,19,16,3,5,1,0,1,0,0,0,0,0,10,540232,2276,18,6,-6,6,0,0,3,-2,1
KR_7728567960,17633,16074,253,265,13,6,6,13,10,6,0,0,0,0,123,14,2,1,2,1,1,0,0,0,0,0,10,540120,1559,-12,7,-7,4,0,0,109,1,1
KR_7728579599,15323,15726,264,243,6,7,7,6,9,9,0,0,0,0,28,18,2,0,1,0,1,0,0,0,0,0,10,540107,-403,21,-1,1,0,0,0,10,2,1
KR_7728584020,17215,16339,267,245,10,8,8,10,8,8,0,0,0,0,15,21,0,3,2,0,1,0,0,0,0,0,10,540313,876,22,2,-2,0,0,0,-6,-3,2
KR_7728589448,16134,14436,243,260,7,3,3,7,8,3,0,0,0,0,17,43,17,3,1,1,1,0,0,0,0,0,10,540205,1698,-17,4,-4,5,0,0,-26,14,0
KR_7728611177,14431,16613,254,259,4,10,10,5,5,5,0,0,0,0,49,18,4,1,1,1,0,1,0,0,0,0,10,540230,-2182,-5,-6,5,0,0,0,31,3,0
KR_7728629972,15606,16430,265,260,5,7,7,5,4,10,0,1,0,0,13,18,5,2,0,3,0,1,0,1,0,0,10,540264,-824,5,-2,2,-6,-1,0,-5,3,-3
KR_7728649461,15531,14938,269,269,6,4,4,6,9,5,0,0,0,0,20,19,2,4,0,0,1,0,0,0,0,0,10,540230,593,0,2,-2,4,0,0,1,-2,0
KR_7728650833,16624,14968,250,233,9,6,6,9,9,9,0,0,0,0,18,99,4,2,1,0,0,1,0,0,0,0,10,540210,1656,17,3,-3,0,0,0,-81,2,1
KR_7728693908,16530,18443,263,264,7,11,11,7,11,23,1,0,0,0,17,14,3,3,2,2,0,1,1,0,0,0,10,540227,-1913,-1,-4,4,-12,1,0,3,0,0
KR_7728717309,13024,15080,219,249,2,6,6,2,3,11,0,1,0,0,72,17,0,10,0,0,0,1,0,1,0,0,10,540214,-2056,-30,-4,4,-8,-1,0,55,-10,0
KR_7728773222,14765,15104,265,313,3,3,3,3,4,2,0,0,0,0,21,17,2,8,0,0,0,1,0,0,0,0,10,540236,-339,-48,0,0,2,0,0,4,-6,0
KR_7728773483,13861,14927,279,278,1,4,4,1,2,4,0,1,0,0,89,20,5,3,1,0,0,1,0,1,0,0,10,540252,-1066,1,-3,3,-2,-1,0,69,2,1
KR_7728791752,14650,14716,279,299,3,2,2,3,7,2,0,0,0,0,59,17,4,3,1,1,1,0,0,0,0,0,10,540209,-66,-20,1,-1,5,0,0,42,1,0
KR_7728829862,13757,15709,271,267,1,7,7,1,1,5,0,0,0,0,27,19,6,1,1,0,0,1,0,0,0,0,10,540187,-1952,4,-6,6,-4,0,0,8,5,1
KR_7728850612,15615,15767,254,274,6,7,7,7,10,8,0,1,0,0,44,17,1,3,0,1,0,1,0,1,0,0,10,540276,-152,-20,-1,0,2,-1,0,27,-2,-1
KR_7728861166,16595,15768,273,255,8,7,7,8,15,12,0,0,0,0,19,27,5,1,0,0,1,0,0,0,0,0,10,540283,827,18,1,-1,3,0,0,-8,4,0
KR_7728885163,15366,15461,240,262,5,6,7,5,6,4,0,1,0,0,14,16,4,3,1,0,1,0,0,1,0,0,10,540239,-95,-22,-1,2,2,-1,0,-2,1,1
KR_7728918177,15631,14427,300,282,4,2,2,4,5,3,1,0,0,0,17,26,0,4,0,0,1,0,1,0,0,0,10,540231,1204,18,2,-2,2,1,0,-9,-4,0
KR_7728942599,15394,14934,263,255,6,5,5,6,2,5,0,0,0,0,36,18,2,4,1,1,0,1,0,0,0,0,10,540256,460,8,1,-1,-3,0,0,18,-2,0
KR_7728949911,15582,15394,279,301,4,4,4,5,6,7,0,1,0,0,109,18,2,7,0,0,1,0,0,1,0,0,10,540271,188,-22,0,-1,-1,-1,0,91,-5,0
KR_7728970727,16091,14624,248,238,8,6,6,8,8,3,0,1,0,0,15,14,1,4,0,0,1,0,0,1,0,0,10,540247,1467,10,2,-2,5,-1,0,1,-3,0
KR_7728993844,16285,16103,283,275,6,7,7,6,7,9,0,0,0,0,15,20,1,1,0,0,1,0,0,0,0,0,10,540251,182,8,-1,1,-2,0,0,-5,0,0
KR_7729014160,12998,15474,253,280,1,5,5,1,3,8,0,1,0,0,16,17,2,3,0,0,0,1,0,1,0,0,10,540224,-2476,-27,-4,4,-5,-1,0,-1,-1,0
KR_7729027248,13928,15234,242,259,3,6,6,3,2,10,0,1,0,0,19,19,3,8,1,0,0,1,0,1,0,0,10,540252,-1306,-17,-3,3,-8,-1,0,0,-5,1
KR_7729029313,16440,15169,257,230,7,6,6,8,8,6,0,0,0,0,13,12,1,3,2,0,1,0,0,0,0,0,10,540102,1271,27,1,-2,2,0,0,1,-2,2
KR_7729101292,13919,15917,225,283,3,5,5,3,7,8,0,1,0,0,17,47,0,4,1,3,0,1,0,1,0,0,10,540271,-1998,-58,-2,2,-1,-1,0,-30,-4,-2
KR_7729101726,14380,14167,243,250,5,3,3,5,6,2,1,0,0,0,21,37,4,4,0,0,0,1,1,0,0,0,10,540254,213,-7,2,-2,4,1,0,-16,0,0
KR_7729122653,15489,15223,260,241,8,6,6,8,5,9,0,0,0,0,15,13,3,3,1,0,1,0,0,0,0,0,10,540232,266,19,2,-2,-4,0,0,2,0,1
KR_7729161557,17827,15242,259,215,12,6,6,12,17,7,1,0,0,0,37,12,3,2,1,0,1,0,1,0,0,0,10,540223,2585,44,6,-6,10,1,0,25,1,1
KR_7729162209,17001,14242,272,279,9,2,2,9,18,1,0,0,0,0,24,39,6,2,0,1,1,0,0,0,0,0,10,540191,2759,-7,7,-7,17,0,0,-15,4,-1
KR_7729174243,15638,16107,281,281,6,6,6,6,7,8,1,0,0,0,34,16,5,2,0,2,1,0,1,0,0,0,10,540244,-469,0,0,0,-1,1,0,18,3,-2
KR_7729190480,13503,15449,238,233,3,7,7,3,1,13,0,0,0,0,18,15,4,2,0,3,0,1,0,0,0,0,10,540253,-1946,5,-4,4,-12,0,0,3,2,-3
KR_7729204160,14028,14523,253,259,3,4,5,3,3,7,0,0,0,0,13,32,4,2,0,0,0,1,0,0,0,0,10,540217,-495,-6,-1,2,-4,0,0,-19,2,0
KR_7729212456,15311,15093,220,286,8,4,4,8,10,4,0,0,0,0,14,32,1,2,0,1,0,1,0,0,0,0,10,540268,218,-66,4,-4,6,0,0,-18,-1,-1
KR_7729227049,15774,14722,248,244,7,6,6,7,8,8,0,1,0,0,25,15,2,1,1,1,1,0,0,1,0,0,10,540208,1052,4,1,-1,0,-1,0,10,1,0
KR_7729239913,15401,14045,291,269,5,2,2,5,5,3,0,0,0,0,24,112,7,5,0,0,1,0,0,0,0,0,10,540215,1356,22,3,-3,2,0,0,-88,2,0
KR_7729255936,14956,13671,245,242,6,2,2,6,8,2,0,0,0,0,17,20,3,2,0,2,0,1,0,0,0,0,10,540245,1285,3,4,-4,6,0,0,-3,1,-2
KR_7729264498,18404,14162,253,234,16,3,3,16,14,3,0,1,0,0,17,17,3,3,0,0,1,0,0,1,0,0,10,540251,4242,19,13,-13,11,-1,0,0,0,0
KR_7729267283,13031,15368,223,284,2,6,7,2,6,3,0,0,0,0,20,15,0,4,0,1,1,0,0,0,0,0,10,540253,-2337,-61,-4,5,3,0,0,5,-4,-1
KR_7729280400,15008,14263,269,258,5,3,3,6,4,7,0,1,0,0,18,9,1,7,0,0,0,1,0,1,0,0,10,540278,745,11,2,-3,-3,-1,0,9,-6,0
KR_7729307385,14738,13668,297,266,3,1,1,3,4,1,0,0,0,0,32,14,2,1,0,1,1,0,0,0,0,0,10,540208,1070,31,2,-2,3,0,0,18,1,-1
KR_7729352322,15085,16264,248,271,5,8,8,5,5,5,1,0,0,0,16,32,4,1,0,2,1,0,1,0,0,0,10,540201,-1179,-23,-3,3,0,1,0,-16,3,-2
KR_7729362207,13533,16876,242,223,1,12,12,1,0,14,0,0,0,0,44,13,5,19,2,0,0,1,0,0,0,0,10,540265,-3343,19,-11,11,-14,0,0,31,-14,2
KR_7729369182,14865,16588,249,231,5,10,10,5,3,15,0,0,0,0,38,20,3,14,4,0,0,1,0,0,0,0,10,540287,-1723,18,-5,5,-12,0,0,18,-11,4
KR_7729381427,14727,13747,269,259,5,2,2,5,2,3,0,0,0,0,16,30,4,4,1,1,1,0,0,0,0,0,10,540246,980,10,3,-3,-1,0,0,-14,0,0
KR_7729393715,14769,15094,277,285,3,4,4,3,4,5,0,0,0,0,16,15,2,5,1,0,0,1,0,0,0,0,10,540204,-325,-8,-1,1,-1,0,0,1,-3,1
KR_7729408465,15936,13433,256,204,8,4,4,8,5,2,0,0,0,0,14,25,5,4,0,0,1,0,0,0,0,0,10,540281,2503,52,4,-4,3,0,0,-11,1,0
KR_7729423731,18173,15560,257,242,11,6,6,11,11,7,0,0,0,0,15,12,4,3,4,3,0,1,0,0,0,0,10,540231,2613,15,5,-5,4,0,0,3,1,1
KR_7729449538,13699,14514,245,275,3,3,3,3,3,3,0,0,0,0,19,35,2,5,1,1,0,1,0,0,0,0,10,540248,-815,-30,0,0,0,0,0,-16,-3,0
KR_7729478220,14181,14077,243,262,3,3,3,3,3,4,0,0,0,0,18,13,0,8,0,1,0,1,0,0,0,0,10,540202,104,-19,0,0,-1,0,0,5,-8,-1
KR_7729554578,16293,14670,300,276,6,3,3,6,11,7,0,0,0,0,40,18,1,5,1,0,1,0,0,0,0,0,10,540215,1623,24,3,-3,4,0,0,22,-4,1
KR_7729614280,15415,13583,285,295,6,1,1,6,4,0,1,0,0,0,14,23,5,1,0,0,1,0,1,0,0,0,10,540195,1832,-10,5,-5,4,1,0,-9,4,0
KR_7729673734,15190,13238,225,259,6,1,1,6,11,0,1,0,0,0,21,16,2,3,0,1,0,1,1,0,0,0,10,540206,1952,-34,5,-5,11,1,0,5,-1,-1
KR_7729700556,14242,15442,270,288,3,3,3,3,7,7,0,1,0,0,103,21,4,0,0,0,0,1,0,1,0,0,10,540253,-1200,-18,0,0,0,-1,0,82,4,0
KR_7729723286,16650,16910,220,248,10,10,10,10,16,11,0,0,0,0,111,35,1,0,0,0,0,1,0,0,0,0,10,540200,-260,-28,0,0,5,0,0,76,1,0
KR_7729766775,16656,15551,253,241,7,7,7,7,9,7,0,1,0,0,115,18,3,2,0,0,0,1,0,1,0,0,10,540271,1105,12,0,0,2,-1,0,97,1,0
KR_7729809728,15367,17172,232,248,7,11,11,7,7,13,0,1,0,0,17,11,0,3,0,0,0,1,0,1,0,0,10,540229,-1805,-16,-4,4,-6,-1,0,6,-3,0
KR_7729828105,14121,18648,251,303,3,11,11,3,4,10,0,0,0,0,37,20,4,2,0,5,1,0,0,0,0,0,10,540219,-4527,-52,-8,8,-6,0,0,17,2,-5
KR_7729847166,16991,13449,286,261,10,2,2,10,11,0,1,0,0,0,15,14,2,2,0,1,1,0,1,0,0,0,10,540196,3542,25,8,-8,11,1,0,1,0,-1
KR_7729857660,14754,15563,242,252,5,8,8,5,3,4,0,1,0,0,14,61,1,3,0,1,1,0,0,1,0,0,10,540096,-809,-10,-3,3,-1,-1,0,-47,-2,-1
KR_7729859230,15306,15907,269,299,4,5,5,5,3,7,0,1,0,0,13,15,3,3,0,3,0,1,0,1,0,0,10,540282,-601,-30,-1,0,-4,-1,0,-2,0,-3
KR_7729881741,16173,16658,211,254,9,10,10,9,8,8,0,1,0,0,18,17,2,4,0,2,0,1,0,1,0,0,10,540240,-485,-43,-1,1,0,-1,0,1,-2,-2
KR_7729903120,14710,14551,264,250,3,5,5,3,5,3,0,0,0,0,14,14,4,3,1,0,0,1,0,0,0,0,10,540242,159,14,-2,2,2,0,0,0,1,1
KR_7729916078,13586,16642,231,269,3,8,8,3,4,11,0,1,0,0,11,15,2,2,0,0,1,0,0,1,0,0,10,540268,-3056,-38,-5,5,-7,-1,0,-4,0,0
KR_7729918046,17681,14526,276,246,11,5,6,11,15,5,0,0,0,0,37,15,5,5,2,0,1,0,0,0,0,0,10,540112,3155,30,6,-5,10,0,0,22,0,2
KR_7729922202,16937,14463,294,277,9,3,3,9,6,3,1,0,0,0,17,13,4,3,0,0,1,0,1,0,0,0,10,540201,2474,17,6,-6,3,1,0,4,1,0
KR_7729934074,14083,14650,258,292,3,2,2,3,3,2,0,0,0,0,33,16,5,4,0,1,0,1,0,0,0,0,10,540253,-567,-34,1,-1,1,0,0,17,1,-1
KR_7729943163,14160,15197,247,274,3,5,5,3,5,6,0,0,0,0,13,16,2,1,0,1,0,1,0,0,0,0,10,540312,-1037,-27,-2,2,-1,0,0,-3,1,-1
KR_7729947395,13850,15000,263,266,2,6,6,2,3,8,0,1,0,0,20,15,1,2,0,0,0,1,0,1,0,0,10,540252,-1150,-3,-4,4,-5,-1,0,5,-1,0
KR_7729951947,15622,15057,263,281,7,3,3,7,12,5,0,0,0,0,13,12,3,1,0,1,1,0,0,0,0,0,10,540207,565,-18,4,-4,7,0,0,1,2,-1
KR_7729961001,15653,15057,271,268,8,5,5,8,3,2,0,1,0,0,17,15,2,5,0,0,1,0,0,1,0,0,10,540261,596,3,3,-3,1,-1,0,2,-3,0
KR_7729992330,15533,15411,282,258,5,7,7,5,3,9,0,0,0,0,15,13,3,1,1,1,1,0,0,0,0,0,10,540282,122,24,-2,2,-6,0,0,2,2,0
KR_7730008534,17471,14478,261,271,11,3,3,11,15,2,0,0,0,0,11,17,4,2,0,1,1,0,0,0,0,0,10,540189,2993,-10,8,-8,13,0,0,-6,2,-1
KR_7730009651,14369,15333,274,279,2,6,6,2,3,8,1,0,0,0,29,14,2,6,1,0,0,1,1,0,0,0,10,540265,-964,-5,-4,4,-5,1,0,15,-4,1
KR_7730031900,16586,16013,281,260,9,6,6,9,5,10,0,0,0,0,51,14,4,5,1,2,1,0,0,0,0,0,10,540195,573,21,3,-3,-5,0,0,37,-1,-1
KR_7730039685,14654,16759,275,260,3,10,10,3,2,9,0,0,0,0,15,17,2,4,1,2,1,0,0,0,0,0,10,540241,-2105,15,-7,7,-7,0,0,-2,-2,-1
KR_7730058238,15625,14852,287,239,6,4,4,6,0,2,0,0,0,0,19,11,0,3,1,3,1,0,0,0,0,0,10,540212,773,48,2,-2,-2,0,0,8,-3,-2
KR_7730062888,14170,17327,238,244,4,11,11,4,2,15,0,0,0,0,24,14,5,3,0,3,0,1,0,0,0,0,10,540263,-3157,-6,-7,7,-13,0,0,10,2,-3
KR_7730078737,14264,14656,242,229,5,6,6,5,4,6,0,0,0,0,14,16,3,2,0,0,0,1,0,0,0,0,10,540119,-392,13,-1,1,-2,0,0,-2,1,0
KR_7730102848,14020,14484,253,263,3,3,3,3,2,1,1,0,0,0,19,28,4,3,0,2,0,1,1,0,0,0,10,540297,-464,-10,0,0,1,1,0,-9,1,-2
KR_7730122641,14341,17055,262,287,3,8,8,3,2,7,0,0,0,0,30,31,5,4,0,1,1,0,0,0,0,0,10,540248,-2714,-25,-5,5,-5,0,0,-1,1,-1
KR_7730128771,15353,14720,231,237,7,5,5,7,7,7,0,0,0,0,14,31,4,2,1,0,1,0,0,0,0,0,10,540263,633,-6,2,-2,0,0,0,-17,2,1
KR_7730129253,2530,2550,1,2,0,0,0,0,0,0,0,0,0,0,1,1,1,0,0,0,0,0,0,0,0,0,3,101545,-20,-1,0,0,0,0,0,0,1,0
KR_7730147679,16146,15799,253,256,10,6,6,10,9,6,1,0,0,0,14,17,4,5,0,0,1,0,1,0,0,0,10,540239,347,-3,4,-4,3,1,0,-3,-1,0
KR_7730177591,17720,14598,252,251,10,5,5,10,14,6,0,0,0,0,15,13,4,2,1,0,1,0,0,0,0,0,10,540256,3122,1,5,-5,8,0,0,2,2,1
KR_7730192216,14426,14692,282,286,3,4,4,3,2,2,0,1,0,0,21,35,2,6,1,1,1,0,0,1,0,0,10,540274,-266,-4,-1,1,0,-1,0,-14,-4,0
KR_7730200683,12656,13901,244,245,1,4,4,1,1,4,1,0,0,0,9,20,4,1,0,2,0,1,1,0,0,0,10,540230,-1245,-1,-3,3,-3,1,0,-11,3,-2
KR_7730217443,16526,13800,268,234,9,3,3,9,9,1,0,0,0,0,16,18,2,1,1,1,1,0,0,0,0,0,10,540265,2726,34,6,-6,8,0,0,-2,1,0
KR_7730233752,16396,17573,250,252,8,12,12,8,8,16,0,1,0,0,27,37,3,4,0,1,0,1,0,1,0,0,10,540230,-1177,-2,-4,4,-8,-1,0,-10,-1,-1
KR_7730267670,15274,14446,283,276,5,3,3,5,4,4,0,0,0,0,11,106,3,0,1,0,1,0,0,0,0,0,10,540128,828,7,2,-2,0,0,0,-95,3,1
KR_7730268328,14132,17065,276,273,2,9,9,2,2,10,0,1,0,0,16,15,1,5,0,0,0,1,0,1,0,0,10,540239,-2933,3,-7,7,-8,-1,0,1,-4,0
KR_7730282017,14319,15588,257,258,4,7,7,4,2,9,0,1,0,0,13,19,3,0,0,0,0,1,0,1,0,0,10,540120,-1269,-1,-3,3,-7,-1,0,-6,3,0
KR_7730286984,17238,15264,282,242,9,5,5,9,13,8,0,0,0,0,14,15,4,3,1,0,0,1,0,0,0,0,10,540169,1974,40,4,-4,5,0,0,-1,1,1
KR_7730301462,14985,15956,235,246,6,8,8,6,7,8,0,0,0,0,19,43,2,3,0,1,0,1,0,0,0,0,10,540244,-971,-11,-2,2,-1,0,0,-24,-1,-1
KR_7730304899,13940,16368,250,284,2,8,8,2,0,9,0,0,0,0,28,17,1,3,1,0,0,1,0,0,0,0,10,540222,-2428,-34,-6,6,-9,0,0,11,-2,1
KR_7730340767,15306,15076,263,267,6,3,3,6,8,3,0,0,0,0,34,19,5,4,1,1,1,0,0,0,0,0,10,540257,230,-4,3,-3,5,0,0,15,1,0
KR_7730342296,15359,14151,278,272,5,3,3,5,4,2,0,0,0,0,23,21,2,4,2,0,0,1,0,0,0,0,10,540149,1208,6,2,-2,2,0,0,2,-2,2
KR_7730344217,15195,15788,241,228,6,8,8,6,8,3,0,0,0,0,15,7,1,2,1,1,0,1,0,0,0,0,10,540267,-593,13,-2,2,5,0,0,8,-1,0
KR_7730359464,17032,14986,267,264,8,5,5,9,15,4,0,1,0,0,119,19,6,4,1,1,0,1,0,1,0,0,10,540182,2046,3,3,-4,11,-1,0,100,2,0
KR_7730363336,15567,13437,294,292,4,0,0,4,4,0,1,0,0,0,37,11,4,2,0,0,1,0,1,0,0,0,10,540248,2130,2,4,-4,4,1,0,26,2,0
KR_7730364597,15784,15180,276,273,6,5,6,6,6,4,0,1,0,0,15,17,5,3,0,0,0,1,0,1,0,0,10,540241,604,3,1,0,2,-1,0,-2,2,0
KR_7730373731,15837,15127,268,273,6,4,4,6,11,6,0,0,0,0,39,14,1,5,0,0,1,0,0,0,0,0,10,540180,710,-5,2,-2,5,0,0,25,-4,0
KR_7730393072,17311,14741,251,265,10,4,4,10,12,4,0,0,0,0,18,14,1,1,0,0,1,0,0,0,0,0,10,540227,2570,-14,6,-6,8,0,0,4,0,0
KR_7730410709,16697,16784,296,275,6,8,8,6,4,9,0,1,0,0,12,102,1,1,0,0,1,0,0,1,0,0,10,540219,-87,21,-2,2,-5,-1,0,-90,0,0
KR_7730414720,14157,14913,255,273,3,4,4,3,4,5,0,0,0,0,74,38,3,4,0,0,0,1,0,0,0,0,10,540252,-756,-18,-1,1,-1,0,0,36,-1,0
KR_7730420432,14184,15430,284,292,2,4,4,2,2,8,0,1,0,0,36,16,3,3,0,1,1,0,0,1,0,0,10,540215,-1246,-8,-2,2,-6,-1,0,20,0,-1
KR_7730421071,14691,16571,259,262,4,8,8,4,2,13,0,0,0,0,16,57,0,2,3,2,1,0,0,0,0,0,10,540169,-1880,-3,-4,4,-11,0,0,-41,-2,1
KR_7730451846,15253,15272,250,261,6,6,6,6,4,8,0,1,0,0,21,14,3,4,1,1,0,1,0,1,0,0,10,540205,-19,-11,0,0,-4,-1,0,7,-1,0
KR_7730457181,14731,15505,282,281,3,5,5,3,4,10,0,1,0,0,35,16,2,4,1,1,0,1,0,1,0,0,10,540219,-774,1,-2,2,-6,-1,0,19,-2,0
KR_7730469725,15183,13351,281,211,5,4,4,5,1,3,0,0,0,0,28,12,3,2,2,0,0,1,0,0,0,0,10,540206,1832,70,1,-1,-2,0,0,16,1,2
KR_7730483331,15703,15308,245,278,8,6,6,8,4,0,1,0,0,0,20,15,4,2,1,1,1,0,1,0,0,0,10,540229,395,-33,2,-2,4,1,0,5,2,0
KR_7730490612,14826,13877,264,293,5,2,2,5,3,2,0,1,0,0,16,18,5,6,1,0,0,1,0,1,0,0,10,540210,949,-29,3,-3,1,-1,0,-2,-1,1
KR_7730494672,15252,17517,241,264,6,10,10,6,5,12,0,0,0,0,21,55,5,6,0,0,1,0,0,0,0,0,10,540198,-2265,-23,-4,4,-7,0,0,-34,-1,0
KR_7730499910,17892,13494,297,259,12,2,2,12,15,2,0,0,0,0,15,15,2,1,1,0,1,0,0,0,0,0,10,540237,4398,38,10,-10,13,0,0,0,1,1
KR_7730522078,15620,14230,261,252,6,3,3,6,9,5,0,0,0,0,13,16,4,3,0,0,1,0,0,0,0,0,10,540211,1390,9,3,-3,4,0,0,-3,1,0
KR_7730542943,14441,17860,276,250,2,12,12,2,2,17,0,0,0,0,37,19,5,3,1,0,0,1,0,0,0,0,10,540249,-3419,26,-10,10,-15,0,0,18,2,1
KR_7730555579,18170,14772,272,211,11,6,6,11,16,8,0,0,0,0,25,17,5,2,1,0,1,0,0,0,0,0,10,540214,3398,61,5,-5,8,0,0,8,3,1
KR_7730578968,13717,15164,270,289,2,4,4,2,4,5,0,0,0,0,14,21,2,2,0,2,0,1,0,0,0,0,10,540270,-1447,-19,-2,2,-1,0,0,-7,0,-2
KR_7730583019,14438,14471,271,250,2,4,4,2,5,4,0,0,0,0,16,27,6,2,1,0,0,1,0,0,0,0,10,540194,-33,21,-2,2,1,0,0,-11,4,1
KR_7730589133,17403,16600,250,229,11,9,9,11,11,18,0,1,0,0,20,141,3,2,0,0,1,0,0,1,0,0,10,540237,803,21,2,-2,-7,-1,0,-121,1,0
KR_7730591976,13878,15042,269,266,2,4,4,2,0,6,0,0,0,0,16,14,1,7,0,1,0,1,0,0,0,0,10,540208,-1164,3,-2,2,-6,0,0,2,-6,-1
KR_7730609910,17169,16041,231,213,12,8,8,12,24,11,0,1,0,0,41,21,3,2,0,0,1,0,0,1,0,0,10,540171,1128,18,4,-4,13,-1,0,20,1,0
KR_7730619340,16813,13898,273,209,8,4,4,8,9,4,0,0,0,0,17,10,1,2,2,1,0,1,0,0,0,0,10,540205,2915,64,4,-4,5,0,0,7,-1,1
KR_7730631910,14253,13930,243,262,4,2,2,4,2,2,0,0,0,0,16,17,1,3,0,0,1,0,0,0,0,0,10,540191,323,-19,2,-2,0,0,0,-1,-2,0
KR_7730635604,15311,13808,247,261,7,2,2,7,6,3,1,0,0,0,15,14,0,5,1,0,1,0,1,0,0,0,10,540190,1503,-14,5,-5,3,1,0,1,-5,1
KR_7730638642,15604,14412,255,241,7,4,4,8,3,6,1,0,0,0,11,40,8,2,1,2,0,1,1,0,0,0,10,540244,1192,14,3,-4,-3,1,0,-29,6,-1
KR_7730655613,14188,15752,242,286,4,6,6,4,4,2,1,0,0,0,14,19,5,3,1,3,0,1,1,0,0,0,10,540246,-1564,-44,-2,2,2,1,0,-5,2,-2
KR_7730659574,16433,15641,290,267,7,5,5,7,7,6,0,0,0,0,22,17,3,2,1,0,1,0,0,0,0,0,10,540251,792,23,2,-2,1,0,0,5,1,1
KR_7730661142,16459,15530,262,259,8,6,6,8,10,9,0,0,0,0,21,15,3,3,1,0,0,1,0,0,0,0,10,540256,929,3,2,-2,1,0,0,6,0,1
KR_7730662933,15272,15878,251,247,6,8,8,6,5,8,0,0,0,0,36,35,4,5,0,1,0,1,0,0,0,0,10,540250,-606,4,-2,2,-3,0,0,1,-1,-1
KR_7730678505,15176,16110,234,260,8,8,8,8,4,4,0,0,0,0,18,29,3,4,0,3,0,1,0,0,0,0,10,540195,-934,-26,0,0,0,0,0,-11,-1,-3
KR_7730685165,16410,14163,256,270,8,2,2,8,13,5,0,0,0,0,23,17,2,3,0,0,1,0,0,0,0,0,10,540083,2247,-14,6,-6,8,0,0,6,-1,0
KR_7730705132,14876,14143,301,282,3,2,2,3,5,2,1,0,0,0,19,19,1,3,0,1,1,0,1,0,0,0,10,540240,733,19,1,-1,3,1,0,0,-2,-1
KR_7730716032,16438,13795,265,257,7,2,2,7,10,5,0,0,0,0,16,28,6,3,1,0,1,0,0,0,0,0,10,540237,2643,8,5,-5,5,0,0,-12,3,1
KR_7730719799,15622,13753,263,252,7,2,2,7,8,1,0,0,0,0,12,20,6,2,0,1,1,0,0,0,0,0,10,540095,1869,11,5,-5,7,0,0,-8,4,-1
KR_7730728334,14946,14784,231,272,6,4,4,6,11,6,0,0,0,0,13,15,3,4,1,1,1,0,0,0,0,0,10,540208,162,-41,2,-2,5,0,0,-2,-1,0
KR_7730737508,15333,15519,244,266,7,7,7,7,5,6,0,1,0,0,15,24,2,2,1,1,1,0,0,1,0,0,10,540240,-186,-22,0,0,-1,-1,0,-9,0,0
KR_7730748164,14780,14973,265,281,4,4,4,4,5,3,0,0,0,0,17,16,1,1,0,1,1,0,0,0,0,0,10,540242,-193,-16,0,0,2,0,0,1,0,-1
KR_7730753557,15940,16490,260,255,7,7,7,7,9,11,0,0,0,0,38,16,3,7,0,0,0,1,0,0,0,0,10,540226,-550,5,0,0,-2,0,0,22,-4,0
KR_7730774832,13320,15322,260,264,1,6,6,1,2,4,0,1,0,0,13,13,1,3,0,2,0,1,0,1,0,0,10,540257,-2002,-4,-5,5,-2,-1,0,0,-2,-2
KR_7730794095,13723,14583,254,276,3,3,3,3,6,3,0,1,0,0,18,16,3,3,0,1,1,0,0,1,0,0,10,540215,-860,-22,0,0,3,-1,0,2,0,-1
KR_7730810827,17882,16152,255,244,12,9,9,12,15,8,0,0,0,0,17,30,0,1,1,0,1,0,0,0,0,0,10,540222,1730,11,3,-3,7,0,0,-13,-1,1
KR_7730836543,14989,13905,284,260,3,3,3,3,4,4,0,0,0,0,16,14,4,3,0,0,0,1,0,0,0,0,10,540211,1084,24,0,0,0,0,0,2,1,0
KR_7730864410,15269,16829,235,249,5,10,10,5,6,10,0,0,0,0,17,17,4,1,0,2,0,1,0,0,0,0,10,540196,-1560,-14,-5,5,-4,0,0,0,3,-2
KR_7730877940,13791,15662,271,296,1,5,5,1,2,5,0,0,0,0,19,14,2,5,0,0,0,1,0,0,0,0,10,540224,-1871,-25,-4,4,-3,0,0,5,-3,0
KR_7730880462,16155,15292,252,244,7,5,5,7,12,8,0,0,0,0,16,15,5,1,1,1,0,1,0,0,0,0,10,540257,863,8,2,-2,4,0,0,1,4,0
KR_7730900326,17949,14194,261,265,10,3,3,10,15,4,1,0,0,0,18,19,4,5,1,1,0,1,1,0,0,0,10,540290,3755,-4,7,-7,11,1,0,-1,-1,0
KR_7730906632,16605,15092,244,248,10,5,5,10,13,2,1,0,0,0,14,20,2,3,1,0,1,0,1,0,0,0,10,540251,1513,-4,5,-5,11,1,0,-6,-1,1
KR_7730918445,13770,15365,284,320,1,3,3,1,1,3,0,1,0,0,42,14,2,5,0,0,1,0,0,1,0,0,10,540135,-1595,-36,-2,2,-2,-1,0,28,-3,0
KR_7730930101,15089,14770,296,263,3,6,6,3,5,4,0,1,0,0,16,13,2,7,0,0,0,1,0,1,0,0,10,540168,319,33,-3,3,1,-1,0,3,-5,0
KR_7730951480,14255,13661,234,274,5,2,3,5,8,0,0,1,0,0,15,14,2,2,0,2,1,0,0,1,0,0,10,540197,594,-40,3,-2,8,-1,0,1,0,-2
KR_7730953562,15714,13652,299,263,5,1,1,5,4,2,1,0,0,0,14,104,2,2,1,0,1,0,1,0,0,0,10,540238,2062,36,4,-4,2,1,0,-90,0,1
KR_7730972740,15136,16085,250,251,5,9,9,5,5,5,0,1,0,0,37,16,6,3,1,1,0,1,0,1,0,0,10,540207,-949,-1,-4,4,0,-1,0,21,3,0
KR_7730980773,14794,15814,290,297,3,6,6,3,2,6,0,0,0,0,15,17,2,3,0,1,0,1,0,0,0,0,10,540209,-1020,-7,-3,3,-4,0,0,-2,-1,-1
KR_7730984097,14446,15002,289,260,2,5,5,2,3,5,0,1,0,0,17,17,4,4,0,0,1,0,0,1,0,0,10,540220,-556,29,-3,3,-2,-1,0,0,0,0
KR_7731005212,15710,15648,294,293,5,5,5,5,3,4,0,0,0,0,114,13,3,5,1,1,1,0,0,0,0,0,10,540209,62,1,0,0,-1,0,0,101,-2,0
KR_7731006850,14107,14830,278,252,2,6,6,2,2,8,0,1,0,0,14,17,2,3,1,0,0,1,0,1,0,0,10,540225,-723,26,-4,4,-6,-1,0,-3,-1,1
KR_7731008407,15295,14513,283,251,5,4,4,5,5,5,0,1,0,0,15,19,2,1,1,0,1,0,0,1,0,0,10,540089,782,32,1,-1,0,-1,0,-4,1,1
KR_7731022487,13752,15154,231,266,3,5,5,3,2,7,0,1,0,0,12,15,2,1,1,2,1,0,0,1,0,0,10,540229,-1402,-35,-2,2,-5,-1,0,-3,1,-1
KR_7731024944,15133,14513,303,249,3,4,4,3,5,8,0,1,0,0,17,35,5,4,0,0,1,0,0,1,0,0,10,540217,620,54,-1,1,-3,-1,0,-18,1,0
KR_7731036353,14908,14765,282,279,4,4,4,4,5,3,0,0,0,0,38,18,4,4,0,0,0,1,0,0,0,0,10,540209,143,3,0,0,2,0,0,20,0,0
KR_7731045662,15931,16384,233,252,8,8,8,8,13,11,0,0,0,0,16,116,1,1,0,2,0,1,0,0,0,0,10,540314,-453,-19,0,0,2,0,0,-100,0,-2
KR_7731046723,16172,13473,304,245,5,2,2,5,3,2,0,1,0,0,36,13,1,4,1,1,1,0,0,1,0,0,10,540255,2699,59,3,-3,1,-1,0,23,-3,0
KR_7731069864,16977,16865,276,215,8,11,11,8,8,16,0,0,0,0,18,33,1,5,2,0,0,1,0,0,0,0,10,540211,112,61,-3,3,-8,0,0,-15,-4,2
KR_7731078192,15722,15818,255,267,7,6,6,7,8,11,0,1,0,0,19,18,3,7,1,0,1,0,0,1,0,0,10,540190,-96,-12,1,-1,-3,-1,0,1,-4,1
KR_7731086218,16929,14925,249,230,9,5,5,9,12,8,0,0,0,0,18,158,4,3,1,0,1,0,0,0,0,0,10,540195,2004,19,4,-4,4,0,0,-140,1,1
KR_7731110062,15724,13312,287,276,4,0,0,4,8,0,0,0,0,0,15,19,3,2,0,0,1,0,0,0,0,0,10,540201,2412,11,4,-4,8,0,0,-4,1,0
KR_7731117802,15554,14956,217,227,7,7,7,7,13,16,0,0,0,0,163,51,3,2,0,0,1,0,0,0,0,0,10,540238,598,-10,0,0,-3,0,0,112,1,0
KR_7731120105,18458,15382,276,231,12,8,8,12,14,8,0,0,0,0,15,36,4,1,1,0,1,0,0,0,0,0,10,540178,3076,45,4,-4,6,0,0,-21,3,1
KR_7731132186,14882,14407,276,307,4,2,2,4,2,0,0,0,0,0,24,19,3,3,1,1,1,0,0,0,0,0,10,540210,475,-31,2,-2,2,0,0,5,0,0
KR_7731141585,17201,13355,272,232,9,3,3,9,10,2,0,0,0,0,16,27,2,3,2,0,0,1,0,0,0,0,10,540271,3846,40,6,-6,8,0,0,-11,-1,2
KR_7731156120,17253,14025,252,255,13,3,3,13,11,1,0,0,0,0,19,16,2,4,1,0,0,1,0,0,0,0,10,540237,3228,-3,10,-10,10,0,0,3,-2,1
KR_7731168154,16585,13491,261,233,9,2,3,9,7,2,0,0,0,0,15,19,8,2,1,0,1,0,0,0,0,0,10,540255,3094,28,7,-6,5,0,0,-4,6,1
KR_7731168246,14300,15676,251,295,4,5,5,4,3,8,1,0,0,0,12,16,1,1,0,0,1,0,1,0,0,0,10,540295,-1376,-44,-1,1,-5,1,0,-4,0,0
KR_7731186885,14527,14813,291,278,2,4,4,2,0,3,0,0,0,0,52,22,8,1,1,1,0,1,0,0,0,0,10,540224,-286,13,-2,2,-3,0,0,30,7,0
KR_7731199950,15339,14571,277,263,5,4,4,5,7,6,1,0,0,0,14,17,3,0,1,0,1,0,1,0,0,0,10,540247,768,14,1,-1,1,1,0,-3,3,1
KR_7731201461,14185,15760,290,299,2,3,3,2,2,3,0,0,0,0,108,68,3,3,1,2,1,0,0,0,0,0,10,540251,-1575,-9,-1,1,-1,0,0,40,0,-1
KR_7731214260,17275,16049,277,251,11,5,5,11,7,7,0,0,0,0,35,10,4,1,1,2,1,0,0,0,0,0,10,540246,1226,26,6,-6,0,0,0,25,3,-1
KR_7731228511,16243,14806,253,267,9,4,4,9,13,2,0,0,0,0,16,13,1,3,1,2,1,0,0,0,0,0,10,540233,1437,-14,5,-5,11,0,0,3,-2,-1
KR_7731234309,14423,16064,265,272,3,8,8,3,5,8,0,1,0,0,23,14,0,4,0,0,0,1,0,1,0,0,10,540252,-1641,-7,-5,5,-3,-1,0,9,-4,0
KR_7731260852,12967,14216,242,253,1,4,4,1,1,1,0,1,0,0,36,14,5,3,0,0,0,1,0,1,0,0,10,540195,-1249,-11,-3,3,0,-1,0,22,2,0
KR_7731284722,16363,15833,266,261,7,5,5,7,7,9,0,0,0,0,18,16,3,0,2,2,1,0,0,0,0,0,10,540209,530,5,2,-2,-2,0,0,2,3,0
KR_7731286763,15925,16009,288,252,5,8,8,5,4,10,0,0,0,0,34,15,6,8,1,1,1,0,0,0,0,0,10,540211,-84,36,-3,3,-6,0,0,19,-2,0
KR_7731290195,17451,15074,265,265,12,5,5,12,16,3,1,0,0,0,18,105,3,5,1,0,0,1,1,0,0,0,10,540287,2377,0,7,-7,13,1,0,-87,-2,1
KR_7731312121,17797,18259,245,250,12,9,9,12,18,17,0,0,0,0,24,41,3,6,0,1,1,0,0,0,0,0,10,540213,-462,-5,3,-3,1,0,0,-17,-3,-1
KR_7731315520,14184,15684,261,268,2,6,6,2,3,10,0,1,0,0,12,18,0,3,1,0,0,1,0,1,0,0,10,540179,-1500,-7,-4,4,-7,-1,0,-6,-3,1
KR_7731327025,16700,14888,265,247,8,6,6,8,8,3,0,0,0,0,17,21,2,6,2,0,1,0,0,0,0,0,10,540246,1812,18,2,-2,5,0,0,-4,-4,2
KR_7731345964,15310,12150,288,230,4,0,0,4,5,0,0,0,0,0,14,24,5,5,2,0,1,0,0,0,0,0,10,540206,3160,58,4,-4,5,0,0,-10,0,2
KR_7731365484,14288,14192,294,300,1,1,1,1,1,1,1,0,0,0,18,14,3,3,1,1,1,0,1,0,0,0,10,540252,96,-6,0,0,0,1,0,4,0,0
KR_7731366911,13792,17740,252,273,3,12,12,3,2,13,0,0,0,0,17,28,2,5,0,0,0,1,0,0,0,0,10,540309,-3948,-21,-9,9,-11,0,0,-11,-3,0
KR_7731385365,15760,16205,275,301,6,5,6,6,15,6,0,0,0,0,36,16,3,3,0,1,1,0,0,0,0,0,10,540253,-445,-26,1,0,9,0,0,20,0,-1
KR_7731400764,15739,14595,255,205,6,7,7,6,7,12,0,0,0,0,15,16,5,1,2,0,0,1,0,0,0,0,10,540223,1144,50,-1,1,-5,0,0,-1,4,2
KR_7731406614,14836,15259,279,274,4,6,6,4,3,4,0,0,0,0,13,17,6,0,1,0,0,1,0,0,0,0,10,540252,-423,5,-2,2,-1,0,0,-4,6,1
KR_7731468044,15188,13790,253,252,7,2,3,7,5,1,0,0,0,0,53,14,2,2,1,2,1,0,0,0,0,0,10,540245,1398,1,5,-4,4,0,0,39,0,-1
KR_7731468954,14627,14282,292,291,3,2,2,3,2,2,0,0,0,0,11,17,3,4,0,0,0,1,0,0,0,0,10,540251,345,1,1,-1,0,0,0,-6,-1,0
KR_7731486805,14077,15421,211,245,5,7,7,5,3,10,0,0,0,0,22,18,0,2,2,2,1,0,0,0,0,0,10,540253,-1344,-34,-2,2,-7,0,0,4,-2,0
KR_7731490218,14143,14682,260,247,3,5,5,3,4,5,0,0,0,0,16,19,3,2,0,1,0,1,0,0,0,0,10,540221,-539,13,-2,2,-1,0,0,-3,1,-1
KR_7731531343,16052,15046,245,243,8,6,6,9,9,5,1,0,0,0,16,14,3,3,4,2,0,1,1,0,0,0,10,540257,1006,2,2,-3,4,1,0,2,0,2
KR_7731539890,14156,14449,265,268,2,3,3,2,2,5,0,0,0,0,41,17,1,6,2,1,1,0,0,0,0,0,10,540274,-293,-3,-1,1,-3,0,0,24,-5,1
KR_7731541511,14940,17023,272,267,4,10,10,4,6,7,0,0,0,0,14,111,6,4,1,2,0,1,0,0,0,0,10,540218,-2083,5,-6,6,-1,0,0,-97,2,-1
KR_7731560440,13224,16037,237,264,2,7,7,2,4,6,0,0,0,0,15,17,0,1,0,1,1,0,0,0,0,0,10,540253,-2813,-27,-5,5,-2,0,0,-2,-1,-1
KR_7731579427,16903,14483,261,239,11,4,4,11,12,4,0,0,0,0,31,14,1,4,0,0,1,0,0,0,0,0,10,540261,2420,22,7,-7,8,0,0,17,-3,0
KR_7731598019,13699,14882,315,313,0,2,2,0,0,3,0,1,0,0,15,32,2,1,1,1,0,1,0,1,0,0,10,540235,-1183,2,-2,2,-3,-1,0,-17,1,0
KR_7731603024,16098,16006,277,249,6,7,7,6,6,11,1,0,0,0,17,34,3,4,2,0,0,1,1,0,0,0,10,540266,92,28,-1,1,-5,1,0,-17,-1,2
KR_7731604433,14399,14339,264,269,3,2,2,3,4,3,0,0,0,0,20,39,5,3,1,2,1,0,0,0,0,0,10,540212,60,-5,1,-1,1,0,0,-19,2,-1
KR_7731605262,2515,2536,0,1,0,0,0,0,0,0,0,0,0,0,2,1,0,0,0,0,0,0,0,0,0,0,3,101184,-21,-1,0,0,0,0,0,1,0,0
KR_7731611582,14432,14872,291,280,3,4,4,3,2,5,0,0,0,0,18,18,2,7,0,0,0,1,0,0,0,0,10,540269,-440,11,-1,1,-3,0,0,0,-5,0
KR_7731627272,16402,14662,286,260,8,4,4,8,9,4,1,0,0,0,19,36,6,5,0,0,1,0,1,0,0,0,10,540250,1740,26,4,-4,5,1,0,-17,1,0
KR_7731630760,18318,15112,264,236,13,4,4,13,13,4,0,0,0,0,21,24,7,4,1,0,1,0,0,0,0,0,10,540282,3206,28,9,-9,9,0,0,-3,3,1
KR_7731633092,15358,15728,269,288,5,5,5,5,8,9,0,1,0,0,19,16,1,0,0,1,0,1,0,1,0,0,10,540215,-370,-19,0,0,-1,-1,0,3,1,-1
KR_7731642923,15844,13776,284,256,6,3,3,6,4,4,0,0,0,0,15,16,5,3,1,0,1,0,0,0,0,0,10,540260,2068,28,3,-3,0,0,0,-1,2,1
KR_7731643945,13941,16679,237,306,2,8,8,2,3,4,0,1,0,0,17,15,1,2,1,0,0,1,0,1,0,0,10,540238,-2738,-69,-6,6,-1,-1,0,2,-1,1
KR_7731657471,15071,14002,302,280,4,2,2,4,2,0,0,0,0,0,13,13,2,5,1,1,1,0,0,0,0,0,10,540213,1069,22,2,-2,2,0,0,0,-3,0
KR_7731669732,14743,16156,257,288,4,6,6,4,5,13,0,1,0,0,125,171,7,5,0,0,1,0,0,1,0,0,10,540233,-1413,-31,-2,2,-8,-1,0,-46,2,0
KR_7731671414,14893,15600,268,257,5,7,8,5,2,7,0,1,0,0,22,18,2,4,0,0,1,0,0,1,0,0,10,540243,-707,11,-2,3,-5,-1,0,4,-2,0
KR_7731679703,13968,16837,246,280,2,7,7,2,3,8,0,0,0,0,35,102,4,4,0,3,0,1,0,0,0,0,10,540266,-2869,-34,-5,5,-5,0,0,-67,0,-3
KR_7731684321,14068,13410,255,280,3,0,0,3,3,0,0,0,0,0,35,17,3,7,0,0,1,0,0,0,0,0,10,540222,658,-25,3,-3,3,0,0,18,-4,0
KR_7731690156,14258,14826,258,268,3,5,5,3,2,4,0,0,0,0,28,14,3,1,0,0,0,1,0,0,0,0,10,540202,-568,-10,-2,2,-2,0,0,14,2,0
KR_7731694724,16138,14094,307,280,5,2,3,5,3,2,0,0,0,0,123,15,3,3,2,0,0,1,0,0,0,0,10,540268,2044,27,3,-2,1,0,0,108,0,2
KR_7731702529,16599,14332,281,266,7,3,3,7,9,4,1,0,0,0,11,15,3,1,0,2,1,0,1,0,0,0,10,540184,2267,15,4,-4,5,1,0,-4,2,-2
KR_7731708174,14821,13496,280,256,4,2,2,4,1,4,0,1,0,0,20,15,2,7,0,0,1,0,0,1,0,0,10,540237,1325,24,2,-2,-3,-1,0,5,-5,0
KR_7731716237,15646,15258,289,268,5,6,6,5,7,7,0,0,0,0,15,23,3,2,0,0,0,1,0,0,0,0,10,540097,388,21,-1,1,0,0,0,-8,1,0
KR_7731716625,14088,16630,235,267,3,9,9,3,5,6,0,0,0,0,19,21,3,1,0,3,0,1,0,0,0,0,10,540275,-2542,-32,-6,6,-1,0,0,-2,2,-3
KR_7731729266,14171,16959,234,280,5,9,9,5,5,10,0,1,0,0,17,12,0,2,0,0,0,1,0,1,0,0,10,540107,-2788,-46,-4,4,-5,-1,0,5,-2,0
KR_7731730473,15900,16759,239,248,9,10,10,9,7,10,0,0,0,0,14,19,3,5,1,0,0,1,0,0,0,0,10,540232,-859,-9,-1,1,-3,0,0,-5,-2,1
KR_7731735990,15525,16117,260,257,6,7,7,6,6,5,0,0,0,0,20,30,2,4,0,1,0,1,0,0,0,0,10,540262,-592,3,-1,1,1,0,0,-10,-2,-1
KR_7731737171,13925,15797,220,258,5,7,7,6,5,6,0,0,0,0,130,16,2,5,0,2,1,0,0,0,0,0,10,540237,-1872,-38,-2,1,-1,0,0,114,-3,-2
KR_7731738059,14325,13358,274,250,3,2,2,3,4,2,0,0,0,0,19,13,3,4,2,0,1,0,0,0,0,0,10,540218,967,24,1,-1,2,0,0,6,-1,2
KR_7731743162,14140,13858,264,277,3,2,2,3,3,1,0,1,0,0,15,18,4,2,0,1,1,0,0,1,0,0,10,540232,282,-13,1,-1,2,-1,0,-3,2,-1
KR_7731748320,16155,15244,264,245,8,6,6,8,5,4,0,0,0,0,112,25,3,1,0,1,1,0,0,0,0,0,10,540214,911,19,2,-2,1,0,0,87,2,-1
KR_7731751829,15605,15184,284,287,5,4,4,5,10,4,0,0,0,0,16,19,4,2,0,1,1,0,0,0,0,0,10,540208,421,-3,1,-1,6,0,0,-3,2,-1
KR_7731761968,16024,15219,270,278,7,4,4,7,10,4,0,0,0,0,38,15,1,4,0,0,1,0,0,0,0,0,10,540217,805,-8,3,-3,6,0,0,23,-3,0
KR_7731766322,16370,14379,261,270,9,3,3,9,6,3,1,0,0,0,13,10,3,2,1,3,1,0,1,0,0,0,10,540227,1991,-9,6,-6,3,1,0,3,1,-2
KR_7731766916,17471,12982,269,227,10,2,2,10,9,1,0,1,0,0,15,11,2,1,1,1,1,0,0,1,0,0,10,540233,4489,42,8,-8,8,-1,0,4,1,0
KR_7731770753,15802,15266,284,255,6,6,6,6,4,6,0,0,0,0,19,44,5,3,1,2,0,1,0,0,0,0,10,540233,536,29,0,0,-2,0,0,-25,2,-1
KR_7731774206,14596,13979,260,288,4,1,1,4,5,1,0,1,0,0,14,13,2,2,0,0,1,0,0,1,0,0,10,540213,617,-28,3,-3,4,-1,0,1,0,0
KR_7731784348,15960,14121,262,271,8,2,2,9,8,2,0,0,0,0,17,19,3,4,0,0,1,0,0,0,0,0,10,540207,1839,-9,6,-7,6,0,0,-2,-1,0
KR_7731792636,14670,16593,254,258,4,7,7,4,4,11,0,0,0,0,15,15,1,4,0,2,0,1,0,0,0,0,10,540266,-1923,-4,-3,3,-7,0,0,0,-3,-2
KR_7731793057,16613,15230,264,280,8,4,4,8,8,6,0,0,0,0,23,108,1,2,1,0,1,0,0,0,0,0,10,540188,1383,-16,4,-4,2,0,0,-85,-1,1
KR_7731794760,12970,16206,208,228,3,9,9,4,2,8,0,0,0,0,18,18,3,3,0,0,0,1,0,0,0,0,10,540211,-3236,-20,-6,5,-6,0,0,0,0,0
KR_7731807825,16172,15009,237,269,11,3,3,11,12,5,0,0,0,0,25,116,2,3,1,1,1,0,0,0,0,0,10,540156,1163,-32,8,-8,7,0,0,-91,-1,0
KR_7731809666,17205,15911,277,251,8,6,6,8,8,11,0,0,0,0,30,16,4,6,1,1,1,0,0,0,0,0,10,540209,1294,26,2,-2,-3,0,0,14,-2,0
KR_7731812439,14920,14438,269,259,5,4,4,5,6,2,0,1,0,0,15,16,4,2,1,0,0,1,0,1,0,0,10,540208,482,10,1,-1,4,-1,0,-1,2,1
KR_7731813439,15353,14422,244,257,7,4,4,7,8,4,1,0,0,0,21,16,1,4,0,0,0,1,1,0,0,0,10,540264,931,-13,3,-3,4,1,0,5,-3,0
KR_7731820141,14454,16766,236,269,4,9,9,4,6,10,0,1,0,0,17,20,1,4,0,0,0,1,0,1,0,0,10,540215,-2312,-33,-5,5,-4,-1,0,-3,-3,0
KR_7731822414,14518,15417,255,240,4,7,8,4,4,5,0,1,0,0,15,16,1,0,0,2,0,1,0,1,0,0,10,540273,-899,15,-3,4,-1,-1,0,-1,1,-2
KR_7731824580,15695,15690,270,255,5,7,7,5,7,12,0,0,0,0,158,40,4,3,2,1,0,1,0,0,0,0,10,540249,5,15,-2,2,-5,0,0,118,1,1
KR_7731828819,14308,14318,212,230,6,5,5,6,5,4,0,0,0,0,17,13,0,0,0,0,1,0,0,0,0,0,10,540178,-10,-18,1,-1,1,0,0,4,0,0
KR_7731837134,15665,14787,280,301,4,3,3,4,5,4,0,1,0,0,15,19,5,1,2,1,1,0,0,1,0,0,10,540212,878,-21,1,-1,1,-1,0,-4,4,1
KR_7731856043,14335,14168,258,235,3,5,5,3,2,2,0,0,0,0,18,17,5,3,2,0,1,0,0,0,0,0,10,540237,167,23,-2,2,0,0,0,1,2,2
KR_7731857901,13995,15255,251,275,3,4,4,3,5,6,0,0,0,0,15,19,3,5,0,3,1,0,0,0,0,0,10,540165,-1260,-24,-1,1,-1,0,0,-4,-2,-3
KR_7731870972,14384,14485,255,256,5,5,5,5,3,2,1,0,0,0,15,11,0,6,0,1,1,0,1,0,0,0,10,540175,-101,-1,0,0,1,1,0,4,-6,-1
KR_7731882649,14491,17211,262,289,4,9,10,4,4,7,0,1,0,0,16,13,1,3,0,2,1,0,0,1,0,0,10,540231,-2720,-27,-5,6,-3,-1,0,3,-2,-2
KR_7731894359,15976,14401,264,240,7,4,4,7,7,5,0,0,0,0,14,15,4,2,0,2,1,0,0,0,0,0,10,540227,1575,24,3,-3,2,0,0,-1,2,-2
KR_7731902290,16603,14299,273,248,10,4,4,10,7,6,0,1,0,0,17,14,2,4,0,0,1,0,0,1,0,0,10,540224,2304,25,6,-6,1,-1,0,3,-2,0
KR_7731967091,15464,15523,277,280,5,4,4,5,6,7,0,0,0,0,14,111,4,2,0,3,1,0,0,0,0,0,10,540096,-59,-3,1,-1,-1,0,0,-97,2,-3
KR_7732013012,14014,17393,223,242,4,12,12,4,4,13,0,1,0,0,14,15,1,3,1,1,0,1,0,1,0,0,10,540236,-3379,-19,-8,8,-9,-1,0,-1,-2,0
KR_7732037264,15628,15858,288,281,4,6,6,4,4,8,1,0,0,0,13,20,3,3,0,1,1,0,1,0,0,0,10,540252,-230,7,-2,2,-4,1,0,-7,0,-1
KR_7732056688,16135,14186,286,246,6,3,3,6,10,5,0,0,0,0,109,20,2,0,1,0,0,1,0,0,0,0,10,540289,1949,40,3,-3,5,0,0,89,2,1
KR_7732064421,15465,17340,256,246,6,10,10,6,10,13,0,0,0,0,11,36,4,2,0,1,0,1,0,0,0,0,10,540208,-1875,10,-4,4,-3,0,0,-25,2,-1
KR_7732071035,16523,13889,271,269,9,1,1,9,7,1,1,0,0,0,23,15,6,3,1,0,1,0,1,0,0,0,10,540224,2634,2,8,-8,6,1,0,8,3,1
KR_7732076414,13184,18553,246,265,1,14,14,1,3,18,0,1,0,0,15,16,2,4,0,1,0,1,0,1,0,0,10,540251,-5369,-19,-13,13,-15,-1,0,-1,-2,-1
KR_7732083918,15044,14063,276,270,5,2,2,5,5,2,1,0,0,0,17,28,7,2,0,2,1,0,1,0,0,0,10,540238,981,6,3,-3,3,1,0,-11,5,-2
KR_7732114815,14714,16469,283,289,4,8,8,4,4,7,0,1,0,0,24,16,2,4,0,0,0,1,0,1,0,0,10,540259,-1755,-6,-4,4,-3,-1,0,8,-2,0
KR_7732160495,13728,14396,254,273,2,3,3,2,1,3,0,0,0,0,27,14,4,2,1,0,1,0,0,0,0,0,10,540236,-668,-19,-1,1,-2,0,0,13,2,1
KR_7732169139,15861,14326,243,256,7,4,4,7,4,3,0,0,0,0,24,16,2,2,4,1,0,1,0,0,0,0,10,540245,1535,-13,3,-3,1,0,0,8,0,3
KR_7732181176,14003,13033,276,257,2,0,0,2,1,0,0,0,0,0,13,26,2,3,1,1,1,0,0,0,0,0,10,540179,970,19,2,-2,1,0,0,-13,-1,0
KR_7732185021,15255,14543,246,242,6,5,5,6,7,6,0,1,0,0,20,18,3,6,0,0,0,1,0,1,0,0,10,540249,712,4,1,-1,1,-1,0,2,-3,0
KR_7732209113,14565,15736,249,268,3,6,6,3,4,5,0,0,0,0,34,21,4,0,1,1,0,1,0,0,0,0,10,540239,-1171,-19,-3,3,-1,0,0,13,4,0
KR_7732212146,15188,15169,280,273,4,4,4,4,5,5,0,0,0,0,19,11,3,3,1,0,1,0,0,0,0,0,10,540239,19,7,0,0,0,0,0,8,0,1
KR_7732259194,13117,16009,221,265,3,7,7,3,2,8,0,0,0,0,17,34,2,3,0,0,0,1,0,0,0,0,10,540196,-2892,-44,-4,4,-6,0,0,-17,-1,0
KR_7732260136,15969,13977,237,269,9,2,2,9,14,2,0,0,0,0,9,18,4,2,0,1,1,0,0,0,0,0,10,540237,1992,-32,7,-7,12,0,0,-9,2,-1
KR_7732276034,15502,16380,294,253,5,9,9,5,3,15,0,1,0,0,17,18,2,3,2,0,0,1,0,1,0,0,10,540189,-878,41,-4,4,-12,-1,0,-1,-1,2
KR_7732287380,2561,2530,2,0,0,0,0,0,0,0,0,0,0,0,11,2,0,0,0,0,0,0,0,0,0,0,3,102633,31,2,0,0,0,0,0,9,0,0
KR_7732291828,15547,15848,212,268,8,6,6,8,14,5,0,0,0,0,15,41,2,5,0,1,1,0,0,0,0,0,10,540234,-301,-56,2,-2,9,0,0,-26,-3,-1
KR_7732314474,14547,14853,264,260,4,5,5,4,4,7,0,0,0,0,16,36,3,2,1,1,0,1,0,0,0,0,10,540222,-306,4,-1,1,-3,0,0,-20,1,0
KR_7732338313,14178,15816,258,258,3,7,7,3,4,7,0,0,0,0,18,22,3,2,0,2,0,1,0,0,0,0,10,540244,-1638,0,-4,4,-3,0,0,-4,1,-2
KR_7732341836,14762,16179,297,289,3,6,6,4,3,5,0,0,0,0,13,16,2,1,1,0,0,1,0,0,0,0,10,540158,-1417,8,-3,2,-2,0,0,-3,1,1
KR_7732354524,14748,13912,276,271,3,2,2,3,6,5,0,0,0,0,22,18,4,0,0,0,1,0,0,0,0,0,10,540276,836,5,1,-1,1,0,0,4,4,0
KR_7732360494,16161,14918,275,256,6,3,3,6,9,6,0,0,0,0,16,27,3,2,0,1,1,0,0,0,0,0,10,540299,1243,19,3,-3,3,0,0,-11,1,-1
KR_7732367947,15982,16401,265,249,5,9,9,5,5,10,0,0,0,0,12,52,9,1,1,0,1,0,0,0,0,0,10,540266,-419,16,-4,4,-5,0,0,-40,8,1
KR_7732371787,15148,15251,256,265,6,6,6,6,6,6,0,0,0,0,12,16,3,1,0,0,0,1,0,0,0,0,10,540263,-103,-9,0,0,0,0,0,-4,2,0
KR_7732382788,13536,13165,255,257,3,1,1,3,1,0,0,0,0,0,13,14,2,2,0,1,0,1,0,0,0,0,10,540213,371,-2,2,-2,1,0,0,-1,0,-1
KR_7732398536,14086,15526,273,292,2,5,5,2,2,6,0,1,0,0,21,71,4,2,2,0,1,0,0,1,0,0,10,540197,-1440,-19,-3,3,-4,-1,0,-50,2,2
KR_7732403753,16124,13494,280,271,6,1,1,6,6,1,0,0,0,0,20,15,4,3,2,1,1,0,0,0,0,0,10,540256,2630,9,5,-5,5,0,0,5,1,1
KR_7732404216,15357,15395,279,254,3,6,6,3,4,9,0,0,0,0,18,14,3,4,1,0,0,1,0,0,0,0,10,540243,-38,25,-3,3,-5,0,0,4,-1,1
KR_7732411574,15448,15002,280,284,5,3,3,5,4,2,0,0,0,0,19,29,2,4,1,1,1,0,0,0,0,0,10,540266,446,-4,2,-2,2,0,0,-10,-2,0
KR_7732434782,13524,15234,273,294,1,4,4,1,1,9,0,1,0,0,15,18,6,1,0,0,0,1,0,1,0,0,10,540195,-1710,-21,-3,3,-8,-1,0,-3,5,0
KR_7732435021,16272,14192,253,224,9,5,5,9,15,6,0,0,0,0,19,17,2,2,1,1,0,1,0,0,0,0,10,540244,2080,29,4,-4,9,0,0,2,0,0
KR_7732436607,15541,15404,263,303,6,3,3,6,7,2,0,0,0,0,22,16,4,4,1,1,1,0,0,0,0,0,10,540219,137,-40,3,-3,5,0,0,6,0,0
KR_7732445613,13828,18724,256,275,2,15,15,3,1,22,0,1,0,0,29,24,0,1,0,3,0,1,0,1,0,0,10,540236,-4896,-19,-13,12,-21,-1,0,5,-1,-3
KR_7732469954,13954,13920,271,269,2,2,2,2,4,4,0,1,0,0,16,42,3,1,0,1,1,0,0,1,0,0,10,540195,34,2,0,0,0,-1,0,-26,2,-1
KR_7732480223,15508,14741,284,285,5,4,4,5,7,3,0,0,0,0,18,16,4,3,1,0,0,1,0,0,0,0,10,540273,767,-1,1,-1,4,0,0,2,1,1
KR_7732493728,17016,16097,292,273,8,7,7,8,12,6,0,0,0,0,27,19,3,10,0,0,1,0,0,0,0,0,10,540234,919,19,1,-1,6,0,0,8,-7,0
KR_7732499526,14203,16672,283,282,2,6,6,2,1,12,0,1,0,0,37,13,1,2,0,2,0,1,0,1,0,0,10,540264,-2469,1,-4,4,-11,-1,0,24,-1,-2
KR_7732500831,16615,15290,270,249,8,6,6,8,6,7,0,0,0,0,15,35,3,2,1,0,0,1,0,0,0,0,10,540212,1325,21,2,-2,-1,0,0,-20,1,1
KR_7732513761,16434,13509,296,265,7,2,4,8,6,0,1,0,0,0,14,15,4,2,0,0,1,0,1,0,0,0,10,540223,2925,31,5,-4,6,1,0,-1,2,0
KR_7732527886,16085,16639,218,245,9,8,8,9,10,10,0,1,0,0,17,15,3,2,0,0,1,0,0,1,0,0,10,540207,-554,-27,1,-1,0,-1,0,2,1,0
KR_7732581711,14681,14934,259,273,4,5,5,4,9,9,0,0,0,0,36,18,3,3,0,0,0,1,0,0,0,0,10,540214,-253,-14,-1,1,0,0,0,18,0,0
KR_7732595588,17359,14659,254,258,11,3,3,11,17,4,0,1,0,0,12,36,7,3,0,2,1,0,0,1,0,0,10,540110,2700,-4,8,-8,13,-1,0,-24,4,-2
KR_7732616639,15874,15738,261,254,6,7,7,6,7,8,1,0,0,0,16,30,3,3,2,1,0,1,1,0,0,0,10,540221,136,7,-1,1,-1,1,0,-14,0,1
KR_7732625685,15199,15229,279,248,4,5,5,4,6,7,0,1,0,0,17,38,4,5,2,1,1,0,0,1,0,0,10,540199,-30,31,-1,1,-1,-1,0,-21,-1,1
KR_7732664062,14298,14358,287,280,1,2,2,1,2,3,0,0,0,0,19,17,5,3,0,0,0,1,0,0,0,0,10,540182,-60,7,-1,1,-1,0,0,2,2,0
KR_7732687003,15907,14687,291,258,6,4,4,6,8,7,1,0,0,0,30,12,6,1,3,0,1,0,1,0,0,0,10,540176,1220,33,2,-2,1,1,0,18,5,3
KR_7732699183,16177,12865,258,246,8,1,2,8,13,0,0,0,0,0,17,35,2,6,1,1,1,0,0,0,0,0,10,540221,3312,12,7,-6,13,0,0,-18,-4,0
KR_7732723396,15052,13671,313,269,3,1,1,4,1,1,1,0,0,0,15,17,6,4,1,0,1,0,1,0,0,0,10,540190,1381,44,2,-3,0,1,0,-2,2,1
KR_7732724760,15827,15291,228,268,9,6,6,9,7,2,0,0,0,0,14,19,8,3,0,0,0,1,0,0,0,0,10,540207,536,-40,3,-3,5,0,0,-5,5,0
KR_7732725582,15177,14780,265,285,5,4,4,5,5,3,0,0,0,0,19,18,2,2,0,0,0,1,0,0,0,0,10,540224,397,-20,1,-1,2,0,0,1,0,0
KR_7732738839,15025,16119,248,261,5,7,7,5,8,13,0,1,0,0,15,45,5,2,1,1,0,1,0,1,0,0,10,540234,-1094,-13,-2,2,-5,-1,0,-30,3,0
KR_7732768431,14503,16334,253,267,4,8,8,4,4,4,0,0,0,0,17,215,6,2,0,0,0,1,0,0,0,0,10,540252,-1831,-14,-4,4,0,0,0,-198,4,0
KR_7732777462,14733,14190,249,230,5,4,4,6,4,7,0,0,0,0,17,26,2,9,1,0,0,1,0,0,0,0,10,540237,543,19,1,-2,-3,0,0,-9,-7,1
KR_7732791154,16554,15084,278,255,7,5,5,7,11,5,1,0,0,0,19,17,4,2,1,0,1,0,1,0,0,0,10,540244,1470,23,2,-2,6,1,0,2,2,1
KR_7732792934,16056,16173,232,230,10,8,8,10,10,9,0,0,0,0,31,17,0,5,1,2,0,1,0,0,0,0,10,540108,-117,2,2,-2,1,0,0,14,-5,-1
KR_7732795542,16047,15358,257,260,8,5,5,8,11,3,0,0,0,0,17,41,5,3,0,3,1,0,0,0,0,0,10,540206,689,-3,3,-3,8,0,0,-24,2,-3
KR_7732815087,18737,13702,287,237,12,3,3,12,16,4,0,0,0,0,39,20,6,1,5,0,0,1,0,0,0,0,10,540195,5035,50,9,-9,12,0,0,19,5,5
KR_7732819568,15417,16577,289,266,5,7,7,5,1,6,0,1,0,0,13,119,5,2,1,1,1,0,0,1,0,0,10,540213,-1160,23,-2,2,-5,-1,0,-106,3,0
KR_7732833759,14036,15166,289,265,2,5,5,2,2,9,0,0,0,0,22,15,2,2,0,1,0,1,0,0,0,0,10,540207,-1130,24,-3,3,-7,0,0,7,0,-1
KR_7732839592,13807,15831,292,289,1,6,6,1,2,4,0,1,0,0,16,17,2,2,0,2,0,1,0,1,0,0,10,540181,-2024,3,-5,5,-2,-1,0,-1,0,-2
KR_7732847296,15743,13567,234,241,7,3,3,7,12,6,0,0,0,0,24,32,5,4,2,0,1,0,0,0,0,0,10,540239,2176,-7,4,-4,6,0,0,-8,1,2
KR_7732849143,15579,15859,273,281,6,6,6,6,7,7,0,0,0,0,17,34,5,2,0,1,0,1,0,0,0,0,10,540180,-280,-8,0,0,0,0,0,-17,3,-1
KR_7732850911,15255,14797,288,299,5,2,2,5,3,3,0,0,0,0,19,16,3,2,0,0,1,0,0,0,0,0,10,540183,458,-11,3,-3,0,0,0,3,1,0
KR_7732867940,14752,15246,269,272,4,5,5,4,3,3,0,1,0,0,14,14,3,3,0,0,0,1,0,1,0,0,10,540248,-494,-3,-1,1,0,-1,0,0,0,0
KR_7732871052,15338,14090,282,258,4,3,3,4,3,1,0,0,0,0,18,12,0,3,3,0,1,0,0,0,0,0,10,540279,1248,24,1,-1,2,0,0,6,-3,3
KR_7732873030,12938,14392,270,287,0,3,3,0,0,1,1,0,0,0,19,21,3,4,0,2,0,1,1,0,0,0,10,540090,-1454,-17,-3,3,-1,1,0,-2,-1,-2
KR_7732879390,14539,14850,257,283,4,4,5,4,3,3,0,1,0,0,16,114,5,5,0,0,0,1,0,1,0,0,10,540280,-311,-26,0,1,0,-1,0,-98,0,0
KR_7732884461,16947,13180,248,213,9,3,3,9,9,2,0,0,0,0,16,13,3,1,2,0,1,0,0,0,0,0,10,540110,3767,35,6,-6,7,0,0,3,2,2
KR_7732889722,16177,14079,246,277,7,2,2,7,10,4,0,0,0,0,30,23,4,4,2,2,0,1,0,0,0,0,10,540211,2098,-31,5,-5,6,0,0,7,0,0
KR_7732901276,16517,16864,244,219,9,9,9,9,11,8,0,0,0,0,18,108,3,2,1,3,0,1,0,0,0,0,10,540250,-347,25,0,0,3,0,0,-90,1,-2
KR_7732903628,15252,14347,251,243,7,5,5,7,9,1,1,0,0,0,14,15,2,4,0,1,1,0,1,0,0,0,10,540224,905,8,2,-2,8,1,0,-1,-2,-1
KR_7732904887,15295,17421,268,271,6,10,10,6,3,8,1,0,0,0,21,14,1,3,1,3,0,1,1,0,0,0,10,540193,-2126,-3,-4,4,-5,1,0,7,-2,-2
KR_7732912066,16253,15298,260,265,8,5,5,8,11,7,0,0,0,0,16,17,3,5,0,0,1,0,0,0,0,0,10,540255,955,-5,3,-3,4,0,0,-1,-2,0
KR_7732912252,16821,13878,275,247,8,2,2,8,10,2,0,0,0,0,49,17,1,3,2,1,1,0,0,0,0,0,10,540293,2943,28,6,-6,8,0,0,32,-2,1
KR_7732915690,14434,15233,275,261,3,6,6,3,4,10,0,0,0,0,19,21,8,6,0,1,0,1,0,0,0,0,10,540233,-799,14,-3,3,-6,0,0,-2,2,-1
KR_7732916412,15702,14226,287,270,6,3,3,6,5,3,0,0,0,0,35,13,1,4,1,0,1,0,0,0,0,0,10,540174,1476,17,3,-3,2,0,0,22,-3,1
KR_7732918341,14553,15323,241,261,4,5,5,4,5,6,0,1,0,0,28,14,3,4,1,2,1,0,0,1,0,0,10,540226,-770,-20,-1,1,-1,-1,0,14,-1,-1
KR_7732932904,15250,14426,290,282,4,2,2,4,5,2,0,0,0,0,15,116,2,4,0,0,0,1,0,0,0,0,10,540195,824,8,2,-2,3,0,0,-101,-2,0
KR_7732934919,15788,15366,233,259,9,3,3,9,7,4,1,0,0,0,15,34,1,5,1,4,1,0,1,0,0,0,10,540261,422,-26,6,-6,3,1,0,-19,-4,-3
KR_7732938838,15045,13680,239,254,6,3,3,6,8,1,0,0,0,0,17,12,2,0,1,0,0,1,0,0,0,0,10,540233,1365,-15,3,-3,7,0,0,5,2,1
KR_7732944300,16222,15431,266,218,9,8,8,9,7,11,0,1,0,0,20,20,3,2,1,1,1,0,0,1,0,0,10,540245,791,48,1,-1,-4,-1,0,0,1,0
KR_7732947223,15318,15940,234,261,6,7,7,6,4,10,0,0,0,0,34,20,2,3,1,0,0,1,0,0,0,0,10,540289,-622,-27,-1,1,-6,0,0,14,-1,1
KR_7732947585,14790,15963,241,262,5,7,7,5,5,6,0,0,0,0,38,14,2,5,0,1,1,0,0,0,0,0,10,540229,-1173,-21,-2,2,-1,0,0,24,-3,-1
KR_7732949775,15394,16601,296,288,4,7,7,4,6,8,0,1,0,0,16,18,2,3,0,0,0,1,0,1,0,0,10,540198,-1207,8,-3,3,-2,-1,0,-2,-1,0
KR_7732960546,16963,14004,279,263,9,3,3,9,13,2,1,0,0,0,20,19,3,4,1,0,0,1,1,0,0,0,10,540241,2959,16,6,-6,11,1,0,1,-1,1
KR_7732963844,14064,14567,238,265,4,5,5,4,2,1,0,1,0,0,15,16,3,3,1,0,1,0,0,1,0,0,10,540229,-503,-27,-1,1,1,-1,0,-1,0,1
KR_7732966606,16891,14137,290,287,9,2,2,9,8,1,0,1,0,0,29,16,2,6,1,0,1,0,0,1,0,0,10,540257,2754,3,7,-7,7,-1,0,13,-4,1
KR_7732974187,13921,13672,276,269,3,1,1,3,1,2,0,0,0,0,105,35,2,5,0,0,1,0,0,0,0,0,10,540264,249,7,2,-2,-1,0,0,70,-3,0
KR_7732981838,14899,14411,211,225,7,5,5,7,4,4,0,1,0,0,17,14,0,3,1,0,1,0,0,1,0,0,10,540226,488,-14,2,-2,0,-1,0,3,-3,1
KR_7732986180,13943,15044,244,267,3,6,6,3,4,6,1,0,0,0,19,14,5,3,2,0,0,1,1,0,0,0,10,540246,-1101,-23,-3,3,-2,1,0,5,2,2
KR_7732995871,15061,17076,242,276,5,9,9,5,6,9,0,1,0,0,14,18,5,5,0,2,1,0,0,1,0,0,10,540257,-2015,-34,-4,4,-3,-1,0,-4,0,-2
KR_7732997452,14612,17666,218,294,6,9,9,6,10,9,0,1,0,0,14,16,5,4,0,3,0,1,0,1,0,0,10,540260,-3054,-76,-3,3,1,-1,0,-2,1,-3
KR_7733001302,17899,13482,246,248,13,2,2,13,16,3,0,0,0,0,18,16,3,0,1,0,1,0,0,0,0,0,10,540210,4417,-2,11,-11,13,0,0,2,3,1
KR_7733006847,15547,14684,239,280,7,3,3,7,13,3,0,0,0,0,20,15,3,6,0,1,1,0,0,0,0,0,10,540210,863,-41,4,-4,10,0,0,5,-3,-1
KR_7733006848,14650,17574,243,245,4,12,12,4,5,16,0,0,0,0,19,16,2,4,1,0,1,0,0,0,0,0,10,540241,-2924,-2,-8,8,-11,0,0,3,-2,1
KR_7733020754,14674,14130,275,263,3,3,3,3,4,3,0,0,0,0,10,16,4,2,2,0,0,1,0,0,0,0,10,540191,544,12,0,0,1,0,0,-6,2,2
KR_7733026323,13600,14105,266,254,1,3,3,1,1,4,0,1,0,0,16,17,1,6,2,0,0,1,0,1,0,0,10,540199,-505,12,-2,2,-3,-1,0,-1,-5,2
KR_7733029606,15500,16556,283,256,5,10,10,5,3,11,0,0,0,0,22,20,6,4,2,0,0,1,0,0,0,0,10,540193,-1056,27,-5,5,-8,0,0,2,2,2
KR_7733077653,12824,15894,231,240,2,8,8,2,1,7,1,0,0,0,19,153,3,2,0,0,1,0,1,0,0,0,10,540202,-3070,-9,-6,6,-6,1,0,-134,1,0
KR_7733089678,14562,15807,271,283,4,6,6,4,8,4,1,0,0,0,18,23,4,4,0,1,0,1,1,0,0,0,10,540206,-1245,-12,-2,2,4,1,0,-5,0,-1
KR_7733097728,3459,3027,30,8,0,0,0,0,0,0,0,0,0,0,2,1,0,0,0,0,0,0,0,0,0,0,4,134513,432,22,0,0,0,0,0,1,0,0
KR_7733101704,17234,17343,226,256,12,11,11,12,14,10,0,1,0,0,200,17,3,2,1,0,0,1,0,1,0,0,10,540175,-109,-30,1,-1,4,-1,0,183,1,1
KR_7733125424,15070,13825,257,277,5,2,2,5,6,2,0,1,0,0,13,190,6,1,0,0,0,1,0,1,0,0,10,540223,1245,-20,3,-3,4,-1,0,-177,5,0
KR_7733228979,16454,14597,254,241,9,4,4,9,7,6,1,0,0,0,14,17,3,3,1,0,1,0,1,0,0,0,10,540250,1857,13,5,-5,1,1,0,-3,0,1
KR_7733249551,14781,15773,257,256,4,6,6,4,2,10,0,0,0,0,12,42,1,3,1,1,1,0,0,0,0,0,10,540181,-992,1,-2,2,-8,0,0,-30,-2,0
KR_7733279364,16285,15020,250,272,8,4,4,8,7,4,0,0,0,0,17,15,3,3,0,1,1,0,0,0,0,0,10,540190,1265,-22,4,-4,3,0,0,2,0,-1
KR_7733281773,16456,17670,252,263,8,10,10,8,6,8,0,0,0,0,11,23,3,1,1,4,0,1,0,0,0,0,10,540171,-1214,-11,-2,2,-2,0,0,-12,2,-3
KR_7733308032,13968,16011,237,274,4,6,6,4,3,10,0,0,0,0,12,21,2,2,0,1,1,0,0,0,0,0,10,540214,-2043,-37,-2,2,-7,0,0,-9,0,-1
KR_7733341398,15180,14036,265,264,5,2,2,5,4,2,0,0,0,0,16,14,3,4,0,0,0,1,0,0,0,0,10,540270,1144,1,3,-3,2,0,0,2,-1,0
KR_7733344402,13787,14556,268,267,2,4,4,2,3,9,0,1,0,0,15,40,6,4,0,0,0,1,0,1,0,0,10,540236,-769,1,-2,2,-6,-1,0,-25,2,0
KR_7733353450,16302,15750,269,258,7,6,6,7,13,8,0,0,0,0,17,14,3,4,0,0,1,0,0,0,0,0,10,540220,552,11,1,-1,5,0,0,3,-1,0
KR_7733383241,16121,16038,293,293,5,5,5,5,11,9,1,0,0,0,13,42,3,1,0,1,0,1,1,0,0,0,10,540263,83,0,0,0,2,1,0,-29,2,-1
KR_7733387941,18227,13934,279,246,11,3,3,11,18,4,0,0,0,0,192,16,5,2,0,0,1,0,0,0,0,0,10,540218,4293,33,8,-8,14,0,0,176,3,0
KR_7733436057,17999,16312,267,258,12,9,9,12,15,11,0,0,0,0,13,14,1,3,3,0,1,0,0,0,0,0,10,540199,1687,9,3,-3,4,0,0,-1,-2,3
KR_7733456642,13482,15253,264,291,2,4,4,2,4,5,0,0,0,0,11,37,4,2,0,0,0,1,0,0,0,0,10,540205,-1771,-27,-2,2,-1,0,0,-26,2,0
KR_7733475764,13018,15124,263,280,1,4,4,1,0,4,0,0,0,0,15,16,4,5,0,1,0,1,0,0,0,0,10,540208,-2106,-17,-3,3,-4,0,0,-1,-1,-1
KR_7733491929,15171,15800,263,273,6,7,8,6,2,6,0,1,0,0,36,14,2,3,1,0,1,0,0,1,0,0,10,540222,-629,-10,-1,2,-4,-1,0,22,-1,1
KR_7733493236,16155,16283,241,256,9,9,10,9,9,13,1,0,0,0,14,19,2,2,1,1,0,1,1,0,0,0,10,540258,-128,-15,0,1,-4,1,0,-5,0,0
KR_7733524526,17248,16070,228,255,11,7,8,11,10,7,0,0,0,0,14,17,1,1,1,2,0,1,0,0,0,0,10,540235,1178,-27,4,-3,3,0,0,-3,0,-1
KR_7733536256,13398,16924,219,271,3,9,9,3,3,7,0,1,0,0,15,19,1,4,0,2,0,1,0,1,0,0,10,540199,-3526,-52,-6,6,-4,-1,0,-4,-3,-2
KR_7733545522,15122,16035,282,296,4,6,6,4,6,6,0,1,0,0,12,17,3,3,0,1,0,1,0,1,0,0,10,540216,-913,-14,-2,2,0,-1,0,-5,0,-1
KR_7733565006,15132,16626,285,264,4,9,9,4,2,10,0,0,0,0,40,16,6,7,0,0,1,0,0,0,0,0,10,540094,-1494,21,-5,5,-8,0,0,24,-1,0
KR_7733586959,14349,14083,243,241,5,4,4,5,2,3,0,1,0,0,18,18,4,0,1,0,1,0,0,1,0,0,10,540298,266,2,1,-1,-1,-1,0,0,4,1
KR_7733589950,15329,15733,256,269,5,6,6,5,5,10,0,0,0,0,12,20,3,4,0,0,0,1,0,0,0,0,10,540256,-404,-13,-1,1,-5,0,0,-8,-1,0
KR_7733610723,17814,14197,285,210,10,5,6,10,7,5,0,0,0,0,15,16,4,0,1,0,1,0,0,0,0,0,10,540097,3617,75,5,-4,2,0,0,-1,4,1
KR_7733613080,14294,14512,258,256,4,4,4,4,4,3,1,0,0,0,14,15,3,3,0,0,1,0,1,0,0,0,10,540219,-218,2,0,0,1,1,0,-1,0,0
KR_7733616863,16093,16595,282,262,6,10,10,6,6,7,1,0,0,0,16,71,3,3,0,0,0,1,1,0,0,0,10,540228,-502,20,-4,4,-1,1,0,-55,0,0
KR_7733621236,15153,18868,250,254,7,14,14,8,1,14,0,0,0,0,15,13,1,5,2,0,0,1,0,0,0,0,10,540209,-3715,-4,-7,6,-13,0,0,2,-4,2
KR_7733638220,14853,14094,287,280,3,2,2,3,5,1,1,0,0,0,18,25,7,2,1,0,0,1,1,0,0,0,10,540276,759,7,1,-1,4,1,0,-7,5,1
KR_7733646294,15462,16522,247,252,6,9,9,7,5,9,0,0,0,0,14,34,1,3,1,0,0,1,0,0,0,0,10,540242,-1060,-5,-3,2,-4,0,0,-20,-2,1
KR_7733646503,13792,15981,244,269,3,8,8,3,4,10,0,1,0,0,18,26,1,5,0,0,1,0,0,1,0,0,10,540220,-2189,-25,-5,5,-6,-1,0,-8,-4,0
KR_7733651023,15338,16513,251,249,6,9,9,6,8,14,0,0,0,0,19,19,7,7,0,3,0,1,0,0,0,0,10,540217,-1175,2,-3,3,-6,0,0,0,0,-3
KR_7733692502,18618,14880,212,219,15,5,5,15,21,6,0,0,0,0,18,20,6,2,1,0,1,0,0,0,0,0,10,540221,3738,-7,10,-10,15,0,0,-2,4,1
KR_7733708019,14029,15126,252,291,3,3,3,4,3,4,0,0,0,0,15,17,1,4,0,0,1,0,0,0,0,0,10,540212,-1097,-39,0,-1,-1,0,0,-2,-3,0
KR_7733723857,14145,16919,240,280,3,8,8,3,4,9,0,1,0,0,26,18,2,2,1,1,0,1,0,1,0,0,10,540220,-2774,-40,-5,5,-5,-1,0,8,0,0
KR_7733725196,14134,16203,258,269,3,8,8,3,2,7,0,0,0,0,15,15,2,3,0,1,1,0,0,0,0,0,10,540257,-2069,-11,-5,5,-5,0,0,0,-1,-1
KR_7733751998,14478,16639,242,299,4,6,6,4,6,7,0,1,0,0,17,36,3,3,0,2,1,0,0,1,0,0,10,540189,-2161,-57,-2,2,-1,-1,0,-19,0,-2
KR_7733752930,12896,14753,256,281,1,4,4,1,0,2,0,0,0,0,22,37,2,6,0,0,0,1,0,0,0,0,10,540160,-1857,-25,-3,3,-2,0,0,-15,-4,0
KR_7733776025,16106,15108,292,269,6,3,4,6,5,5,0,0,0,0,20,13,3,6,1,0,1,0,0,0,0,0,10,540191,998,23,3,-2,0,0,0,7,-3,1
KR_7733785741,16319,14362,283,266,6,3,3,6,10,3,0,1,0,0,138,15,5,3,0,0,1,0,0,1,0,0,10,540242,1957,17,3,-3,7,-1,0,123,2,0
KR_7733815812,17095,14145,286,245,9,3,3,9,8,3,0,1,0,0,17,33,3,2,2,0,1,0,0,1,0,0,10,540269,2950,41,6,-6,5,-1,0,-16,1,2
KR_7733817592,12858,16581,231,289,1,7,7,1,1,10,0,0,0,0,14,15,1,3,0,0,0,1,0,0,0,0,10,540237,-3723,-58,-6,6,-9,0,0,-1,-2,0
KR_7733840776,15710,18110,264,272,5,11,11,5,6,15,0,0,0,0,25,18,4,4,0,1,0,1,0,0,0,0,10,540266,-2400,-8,-6,6,-9,0,0,7,0,-1
KR_7733865221,16628,14469,296,266,8,2,2,8,5,3,1,0,0,0,15,14,4,1,2,2,1,0,1,0,0,0,10,540256,2159,30,6,-6,2,1,0,1,3,0
KR_7733873963,14883,15174,259,265,5,5,5,5,3,5,0,1,0,0,23,16,2,5,0,1,1,0,0,1,0,0,10,540271,-291,-6,0,0,-2,-1,0,7,-3,-1
KR_7733917614,14478,14526,263,266,4,4,4,4,4,3,0,1,0,0,18,13,0,5,0,0,0,1,0,1,0,0,10,540235,-48,-3,0,0,1,-1,0,5,-5,0
KR_7733936381,14935,15824,304,254,3,9,9,3,0,14,0,0,0,0,15,15,2,3,2,0,0,1,0,0,0,0,10,540223,-889,50,-6,6,-14,0,0,0,-1,2
KR_7733938859,14907,17766,226,289,6,9,9,6,7,12,0,1,0,0,14,17,3,5,1,1,0,1,0,1,0,0,10,540241,-2859,-63,-3,3,-5,-1,0,-3,-2,0
KR_7733960454,15761,13482,276,242,5,2,2,5,6,3,0,0,0,0,15,51,5,1,1,0,1,0,0,0,0,0,10,540261,2279,34,3,-3,3,0,0,-36,4,1
KR_7733964283,16213,15815,265,289,8,6,6,8,7,5,0,1,0,0,15,12,1,4,0,0,0,1,0,1,0,0,10,540209,398,-24,2,-2,2,-1,0,3,-3,0
KR_7733981536,14166,15208,285,269,3,5,5,3,1,8,0,1,0,0,22,34,3,4,0,0,0,1,0,1,0,0,10,540210,-1042,16,-2,2,-7,-1,0,-12,-1,0
KR_7733995170,16598,15100,269,264,8,5,5,8,10,3,0,0,0,0,16,16,3,2,1,0,1,0,0,0,0,0,10,540192,1498,5,3,-3,7,0,0,0,1,1
KR_7734029431,15921,16271,291,283,5,7,8,5,8,7,0,1,0,0,20,15,2,2,1,1,0,1,0,1,0,0,10,540187,-350,8,-2,3,1,-1,0,5,0,0
KR_7734039759,16106,13739,307,268,4,2,2,4,2,1,0,0,0,0,34,31,6,3,2,0,1,0,0,0,0,0,10,540299,2367,39,2,-2,1,0,0,3,3,2
KR_7734053254,14910,15403,239,234,5,8,8,5,6,10,0,1,0,0,16,22,2,5,1,0,0,1,0,1,0,0,10,540097,-493,5,-3,3,-4,-1,0,-6,-3,1
KR_7734055913,16884,12984,288,277,8,0,0,8,9,0,1,0,0,0,15,36,4,2,1,0,1,0,1,0,0,0,10,540227,3900,11,8,-8,9,1,0,-21,2,1
KR_7734082336,17275,15180,292,287,9,4,5,9,16,3,0,0,0,0,15,68,4,1,0,2,1,0,0,0,0,0,10,540260,2095,5,5,-4,13,0,0,-53,3,-2
KR_7734099608,15724,15787,300,289,4,5,6,4,8,6,0,0,0,0,13,20,5,2,2,1,1,0,0,0,0,0,10,540129,-63,11,-1,2,2,0,0,-7,3,1
KR_7734124228,14610,14037,254,241,3,4,4,3,3,5,0,0,0,0,21,17,2,4,0,0,1,0,0,0,0,0,10,540213,573,13,-1,1,-2,0,0,4,-2,0
KR_7734146377,13880,15245,286,286,1,5,5,1,1,4,0,1,0,0,13,17,2,2,0,1,0,1,0,1,0,0,10,540247,-1365,0,-4,4,-3,-1,0,-4,0,-1
KR_7734153323,18432,13874,286,259,11,2,3,11,12,2,0,0,0,0,17,13,3,2,2,0,1,0,0,0,0,0,10,540216,4558,27,9,-8,10,0,0,4,1,2
KR_7734166781,16017,15286,282,260,7,6,6,7,7,7,0,1,0,0,18,118,4,2,1,1,1,0,0,1,0,0,10,540232,731,22,1,-1,0,-1,0,-100,2,0
KR_7734182535,14350,14407,280,303,2,2,2,2,1,1,1,0,0,0,14,16,0,6,2,0,1,0,1,0,0,0,10,540214,-57,-23,0,0,0,1,0,-2,-6,2
KR_7734185358,13353,15589,259,301,1,5,5,1,1,3,0,1,0,0,36,17,2,2,1,0,1,0,0,1,0,0,10,540103,-2236,-42,-4,4,-2,-1,0,19,0,1
KR_7734203202,15761,13697,278,282,6,1,1,6,5,0,0,0,0,0,18,13,0,3,1,0,1,0,0,0,0,0,10,540218,2064,-4,5,-5,5,0,0,5,-3,1
KR_7734205313,15611,13868,308,276,5,1,1,5,3,1,1,0,0,0,20,14,3,4,0,0,1,0,1,0,0,0,10,540227,1743,32,4,-4,2,1,0,6,-1,0
KR_7734209531,15772,12954,287,235,4,3,3,4,4,0,0,0,0,0,13,17,4,1,2,0,1,0,0,0,0,0,10,540210,2818,52,1,-1,4,0,0,-4,3,2
KR_7734223133,14725,15941,267,257,4,7,7,4,7,8,1,0,0,0,11,15,3,4,0,1,0,1,1,0,0,0,10,540199,-1216,10,-3,3,-1,1,0,-4,-1,-1
KR_7734246670,14012,16786,267,281,2,8,8,2,0,8,0,0,0,0,31,121,2,3,2,0,0,1,0,0,0,0,10,540231,-2774,-14,-6,6,-8,0,0,-90,-1,2
KR_7734250257,13782,14710,271,276,2,3,3,2,2,2,0,0,0,0,14,11,1,5,1,1,0,1,0,0,0,0,10,540199,-928,-5,-1,1,0,0,0,3,-4,0
KR_7734253635,13715,17444,261,291,3,9,9,3,2,6,0,0,0,0,37,25,3,9,0,1,0,1,0,0,0,0,10,540265,-3729,-30,-6,6,-4,0,0,12,-6,-1
KR_7734270269,14828,16616,252,244,4,9,9,4,4,12,0,0,0,0,12,20,6,1,1,0,0,1,0,0,0,0,10,540229,-1788,8,-5,5,-8,0,0,-8,5,1
KR_7734276107,15095,15630,249,215,7,10,11,7,4,8,0,0,0,0,13,38,1,1,1,1,0,1,0,0,0,0,10,540234,-535,34,-3,4,-4,0,0,-25,0,0
KR_7734276671,14111,14959,261,286,3,4,4,3,3,6,1,0,0,0,21,23,4,5,1,0,1,0,1,0,0,0,10,540272,-848,-25,-1,1,-3,1,0,-2,-1,1
KR_7734290520,15247,15591,251,252,7,7,7,7,6,12,0,0,0,0,12,25,3,3,0,1,0,1,0,0,0,0,10,540224,-344,-1,0,0,-6,0,0,-13,0,-1
KR_7734296597,15736,15148,221,257,9,5,5,9,5,4,0,1,0,0,17,16,1,3,0,2,0,1,0,1,0,0,10,540212,588,-36,4,-4,1,-1,0,1,-2,-2
KR_7734319118,16585,14786,273,264,8,4,4,8,8,8,0,1,0,0,12,14,2,1,2,0,1,0,0,1,0,0,10,540147,1799,9,4,-4,0,-1,0,-2,1,2
KR_7734322432,16645,17888,209,249,10,12,12,10,17,14,0,0,0,0,23,18,3,5,0,1,1,0,0,0,0,0,10,540249,-1243,-40,-2,2,3,0,0,5,-2,-1
KR_7734332248,14515,14869,284,251,3,5,5,3,2,8,0,1,0,0,106,20,4,1,0,0,1,0,0,1,0,0,10,540200,-354,33,-2,2,-6,-1,0,86,3,0
KR_7734354669,14105,14122,267,269,3,3,3,3,5,1,0,0,0,0,36,43,1,4,0,0,1,0,0,0,0,0,10,540217,-17,-2,0,0,4,0,0,-7,-3,0
KR_7734360487,16105,12704,262,215,7,1,1,7,9,1,0,0,0,0,21,36,3,4,1,1,0,1,0,0,0,0,10,540179,3401,47,6,-6,8,0,0,-15,-1,0
KR_7734365044,16762,15916,237,240,10,6,6,10,11,11,0,1,0,0,18,22,7,4,1,1,0,1,0,1,0,0,10,540244,846,-3,4,-4,0,-1,0,-4,3,0
KR_7734378031,15997,15735,278,252,7,7,7,7,5,10,0,0,0,0,14,22,4,2,0,1,1,0,0,0,0,0,10,540284,262,26,0,0,-5,0,0,-8,2,-1
KR_7734381236,15337,15210,238,256,6,6,6,6,9,8,1,0,0,0,14,18,4,0,1,0,0,1,1,0,0,0,10,540232,127,-18,0,0,1,1,0,-4,4,1
KR_7734389831,16193,15358,285,277,7,5,5,7,8,7,0,0,0,0,119,30,5,3,0,0,1,0,0,0,0,0,10,540205,835,8,2,-2,1,0,0,89,2,0
KR_7734399710,15319,14896,256,273,6,4,4,6,10,6,1,0,0,0,36,220,3,3,0,0,1,0,1,0,0,0,10,540207,423,-17,2,-2,4,1,0,-184,0,0
KR_7734400397,16735,13538,274,259,7,2,2,7,13,1,0,0,0,0,71,24,4,3,0,0,0,1,0,0,0,0,10,540259,3197,15,5,-5,12,0,0,47,1,0
KR_7734407074,15615,15052,247,264,7,4,4,7,14,4,0,0,0,0,15,37,2,7,0,0,1,0,0,0,0,0,10,540265,563,-17,3,-3,10,0,0,-22,-5,0
KR_7734407868,15361,14497,257,280,5,2,2,5,8,2,0,1,0,0,13,17,2,3,1,2,1,0,0,1,0,0,10,540234,864,-23,3,-3,6,-1,0,-4,-1,-1
KR_7734416377,15246,14579,283,257,4,4,4,4,3,5,0,0,0,0,20,15,0,2,1,1,0,1,0,0,0,0,10,540212,667,26,0,0,-2,0,0,5,-2,0
KR_7734430513,15875,16593,308,287,5,7,7,5,3,11,0,1,0,0,14,16,5,2,1,0,0,1,0,1,0,0,10,540215,-718,21,-2,2,-8,-1,0,-2,3,1
KR_7734444710,14452,14542,245,278,4,3,3,4,4,1,0,0,0,0,34,22,5,1,0,0,0,1,0,0,0,0,10,540278,-90,-33,1,-1,3,0,0,12,4,0
KR_7734447344,16920,14996,239,249,11,6,6,11,9,2,0,1,0,0,19,12,1,2,0,0,1,0,0,1,0,0,10,540202,1924,-10,5,-5,7,-1,0,7,-1,0
KR_7734453346,16003,16808,240,278,8,9,9,8,9,11,0,1,0,0,16,15,2,5,0,0,0,1,0,1,0,0,10,540216,-805,-38,-1,1,-2,-1,0,1,-3,0
KR_7734470341,15597,14597,253,265,6,5,5,6,6,3,0,0,0,0,16,17,3,3,1,1,0,1,0,0,0,0,10,540212,1000,-12,1,-1,3,0,0,-1,0,0
KR_7734474632,13497,15839,250,279,2,6,6,2,1,6,0,0,0,0,15,34,3,3,0,1,0,1,0,0,0,0,10,540161,-2342,-29,-4,4,-5,0,0,-19,0,-1
KR_7734480131,13051,14741,222,229,2,6,6,2,3,6,0,0,0,0,22,180,3,3,1,0,0,1,0,0,0,0,10,540220,-1690,-7,-4,4,-3,0,0,-158,0,1
KR_7734480646,13642,14986,236,283,3,3,3,3,5,3,0,1,0,0,13,14,2,2,0,3,1,0,0,1,0,0,10,540218,-1344,-47,0,0,2,-1,0,-1,0,-3
KR_7734490910,14501,14803,270,271,4,4,4,4,2,1,0,1,0,0,30,16,1,3,1,1,0,1,0,1,0,0,10,540255,-302,-1,0,0,1,-1,0,14,-2,0
KR_7734496529,15022,14046,291,291,4,1,1,4,3,1,0,0,0,0,17,14,6,5,0,2,0,1,0,0,0,0,10,540238,976,0,3,-3,2,0,0,3,1,-2
KR_7734510053,15769,14786,265,268,7,4,4,7,8,5,0,1,0,0,23,15,0,4,1,0,1,0,0,1,0,0,10,540222,983,-3,3,-3,3,-1,0,8,-4,1
KR_7734514281,15499,14291,285,286,5,3,3,5,4,3,0,1,0,0,15,19,2,1,0,0,0,1,0,1,0,0,10,540255,1208,-1,2,-2,1,-1,0,-4,1,0
KR_7734516457,15222,16446,248,264,5,8,8,5,11,12,0,1,0,0,12,15,2,2,0,0,0,1,0,1,0,0,10,540212,-1224,-16,-3,3,-1,-1,0,-3,0,0
KR_7734522503,14067,14809,269,281,2,4,4,2,3,4,0,1,0,0,18,12,5,1,1,0,0,1,0,1,0,0,10,540262,-742,-12,-2,2,-1,-1,0,6,4,1
KR_7734533156,16876,13836,275,231,10,4,4,10,5,2,0,0,0,0,14,11,2,1,2,0,1,0,0,0,0,0,10,540208,3040,44,6,-6,3,0,0,3,1,2
KR_7734538496,15274,16046,279,278,4,6,6,4,4,11,0,0,0,0,13,61,2,3,0,1,0,1,0,0,0,0,10,540217,-772,1,-2,2,-7,0,0,-48,-1,-1
KR_7734549660,13941,15873,257,262,3,7,7,3,4,13,0,0,0,0,15,16,1,0,0,0,1,0,0,0,0,0,10,540244,-1932,-5,-4,4,-9,0,0,-1,1,0
KR_7734561245,15487,13711,288,266,4,2,2,4,5,3,0,1,0,0,12,17,2,1,1,0,0,1,0,1,0,0,10,540267,1776,22,2,-2,2,-1,0,-5,1,1
KR_7734828854,15162,14709,263,257,5,5,6,5,6,2,0,0,0,0,15,16,2,1,0,1,0,1,0,0,0,0,10,540236,453,6,0,1,4,0,0,-1,1,-1
KR_7734841681,14836,15625,231,263,6,7,7,6,5,4,0,0,0,0,106,20,3,2,0,2,0,1,0,0,0,0,10,540244,-789,-32,-1,1,1,0,0,86,1,-2
KR_7734854447,17293,14670,272,253,10,5,5,10,9,6,1,0,0,0,17,14,1,3,2,0,1,0,1,0,0,0,10,540243,2623,19,5,-5,3,1,0,3,-2,2
KR_7734882283,14585,13716,296,291,2,1,1,2,3,0,1,0,0,0,17,13,1,4,1,0,1,0,1,0,0,0,10,540121,869,5,1,-1,3,1,0,4,-3,1
KR_7734889278,14471,16600,239,287,4,7,7,4,7,11,0,0,0,0,33,15,2,4,0,2,0,1,0,0,0,0,10,540239,-2129,-48,-3,3,-4,0,0,18,-2,-2
KR_7734894013,16199,13432,246,226,9,3,3,9,11,2,1,0,0,0,16,16,2,4,1,0,1,0,1,0,0,0,10,540155,2767,20,6,-6,9,1,0,0,-2,1
KR_7734915666,16725,13502,281,244,10,1,1,10,10,1,1,0,0,0,15,17,1,4,1,1,1,0,1,0,0,0,10,540221,3223,37,9,-9,9,1,0,-2,-3,0
KR_7734939016,16862,14177,261,253,10,3,3,10,17,5,0,0,0,0,18,11,4,3,0,1,1,0,0,0,0,0,10,540276,2685,8,7,-7,12,0,0,7,1,-1
KR_7734948198,13701,15152,256,256,1,6,6,1,2,6,0,1,0,0,30,17,4,3,0,1,0,1,0,1,0,0,10,540087,-1451,0,-5,5,-4,-1,0,13,1,-1
KR_7734967665,14332,15934,279,277,2,6,6,2,2,7,1,0,0,0,17,15,4,5,0,1,1,0,1,0,0,0,10,540259,-1602,2,-4,4,-5,1,0,2,-1,-1
KR_7734991778,14671,14120,245,232,4,5,5,4,6,5,0,0,0,0,14,12,3,2,0,0,0,1,0,0,0,0,10,540108,551,13,-1,1,1,0,0,2,1,0
KR_7735009397,15542,15875,291,272,5,6,6,5,6,8,1,0,0,0,15,22,2,2,0,0,1,0,1,0,0,0,10,540214,-333,19,-1,1,-2,1,0,-7,0,0
KR_7735016653,15271,14940,271,272,5,3,3,5,6,4,0,0,0,0,18,13,4,9,1,0,1,0,0,0,0,0,10,540228,331,-1,2,-2,2,0,0,5,-5,1
KR_7735039125,14315,17068,257,258,4,10,10,5,1,12,0,0,0,0,18,23,0,6,0,0,1,0,0,0,0,0,10,540238,-2753,-1,-6,5,-11,0,0,-5,-6,0
KR_7735044542,15105,16905,208,269,7,9,9,7,8,11,0,0,0,0,15,17,1,4,0,0,1,0,0,0,0,0,10,540229,-1800,-61,-2,2,-3,0,0,-2,-3,0
KR_7735064421,14930,14929,286,294,3,3,3,3,5,4,0,1,0,0,21,16,7,5,0,0,0,1,0,1,0,0,10,540231,1,-8,0,0,1,-1,0,5,2,0
KR_7735070858,15087,15494,263,303,5,4,4,5,4,8,0,1,0,0,13,15,5,4,0,0,1,0,0,1,0,0,10,540275,-407,-40,1,-1,-4,-1,0,-2,1,0
KR_7735141905,15245,14027,242,258,6,3,3,6,8,2,0,1,0,0,44,69,4,6,0,0,1,0,0,1,0,0,10,540183,1218,-16,3,-3,6,-1,0,-25,-2,0
KR_7735156432,16343,15869,272,233,8,7,7,8,7,12,0,0,0,0,20,104,5,2,0,0,0,1,0,0,0,0,10,540232,474,39,1,-1,-5,0,0,-84,3,0
KR_7735190539,12929,17525,268,289,0,10,10,0,0,14,1,0,0,0,49,19,3,0,1,1,0,1,1,0,0,0,10,540207,-4596,-21,-10,10,-14,1,0,30,3,0
KR_7735201919,17545,13603,310,262,9,2,2,9,10,4,0,1,0,0,44,16,6,5,1,0,1,0,0,1,0,0,10,540127,3942,48,7,-7,6,-1,0,28,1,1
KR_7735217042,15415,14182,274,276,5,2,2,5,5,2,0,0,0,0,13,15,2,4,1,1,0,1,0,0,0,0,10,540264,1233,-2,3,-3,3,0,0,-2,-2,0
KR_7735239646,16317,15390,277,283,7,4,4,7,9,5,0,1,0,0,17,20,5,4,1,0,1,0,0,1,0,0,10,540284,927,-6,3,-3,4,-1,0,-3,1,1
KR_7735254204,15719,15003,270,255,6,4,4,6,9,3,0,0,0,0,14,19,5,2,1,2,1,0,0,0,0,0,10,540219,716,15,2,-2,6,0,0,-5,3,-1
KR_7735260577,13589,16165,282,265,0,8,8,0,0,10,0,1,0,0,16,18,2,3,1,3,0,1,0,1,0,0,10,540217,-2576,17,-8,8,-10,-1,0,-2,-1,-2
KR_7735275723,15235,15383,273,279,4,5,5,4,6,6,0,1,0,0,51,18,3,4,2,2,0,1,0,1,0,0,10,540099,-148,-6,-1,1,0,-1,0,33,-1,0
KR_7735315864,15189,15102,272,268,6,6,6,6,3,5,0,0,0,0,18,16,5,3,0,0,1,0,0,0,0,0,10,540205,87,4,0,0,-2,0,0,2,2,0
KR_7735331290,16417,15323,291,262,5,5,5,5,5,5,0,0,0,0,16,18,4,0,1,2,1,0,0,0,0,0,10,540209,1094,29,0,0,0,0,0,-2,4,-1
KR_7735353677,13631,14164,277,309,1,1,1,1,1,1,1,0,0,0,16,35,3,3,0,0,1,0,1,0,0,0,10,540251,-533,-32,0,0,0,1,0,-19,0,0
KR_7735376541,15344,15751,273,258,6,6,6,6,3,6,0,1,0,0,18,18,5,3,1,1,0,1,0,1,0,0,10,540216,-407,15,0,0,-3,-1,0,0,2,0
KR_7735390219,14498,14140,255,258,4,3,3,4,9,3,0,0,0,0,106,14,1,3,0,1,1,0,0,0,0,0,10,540120,358,-3,1,-1,6,0,0,92,-2,-1
KR_7735397225,17272,15263,272,271,9,5,6,9,8,4,0,1,0,0,13,16,3,1,1,0,1,0,0,1,0,0,10,540250,2009,1,4,-3,4,-1,0,-3,2,1
KR_7735398703,14830,16053,264,301,4,6,6,4,4,4,0,1,0,0,12,15,3,0,1,0,0,1,0,1,0,0,10,540279,-1223,-37,-2,2,0,-1,0,-3,3,1
KR_7735418993,15444,14567,227,244,8,4,4,8,10,6,0,1,0,0,52,13,2,4,0,0,1,0,0,1,0,0,10,540218,877,-17,4,-4,4,-1,0,39,-2,0
KR_7735420683,16614,15390,248,242,9,6,6,9,13,4,0,0,0,0,21,19,6,3,0,1,1,0,0,0,0,0,10,540251,1224,6,3,-3,9,0,0,2,3,-1
KR_7735460196,15109,16312,257,275,5,7,7,5,8,12,0,1,0,0,14,16,1,4,0,1,0,1,0,1,0,0,10,540221,-1203,-18,-2,2,-4,-1,0,-2,-3,-1
KR_7735464545,16966,14959,277,257,8,5,6,8,10,6,0,0,0,0,17,27,2,1,2,0,1,0,0,0,0,0,10,540215,2007,20,3,-2,4,0,0,-10,1,2
KR_7735478787,16197,15828,260,245,7,6,6,7,6,9,0,0,0,0,16,19,5,3,2,1,1,0,0,0,0,0,10,540239,369,15,1,-1,-3,0,0,-3,2,1
KR_7735512399,12581,18461,229,256,1,15,15,1,1,10,0,1,0,0,12,40,3,3,1,1,0,1,0,1,0,0,10,540218,-5880,-27,-14,14,-9,-1,0,-28,0,0
KR_7735521674,15111,15522,261,290,6,5,5,6,3,5,1,0,0,0,37,16,1,2,0,1,0,1,1,0,0,0,10,540206,-411,-29,1,-1,-2,1,0,21,-1,-1
KR_7735528891,14942,14737,305,311,3,2,3,3,2,3,0,1,0,0,18,14,1,5,0,0,1,0,0,1,0,0,10,540186,205,-6,1,0,-1,-1,0,4,-4,0
KR_7735553605,17615,19503,237,258,12,14,14,12,13,18,0,1,0,0,17,16,4,5,0,0,0,1,0,1,0,0,10,540211,-1888,-21,-2,2,-5,-1,0,1,-1,0
KR_7735556387,14522,16595,269,288,3,8,8,3,1,8,0,1,0,0,17,26,2,2,1,1,1,0,0,1,0,0,10,540263,-2073,-19,-5,5,-7,-1,0,-9,0,0
KR_7735566715,13423,14666,257,271,2,3,3,2,2,4,0,1,0,0,50,17,3,1,0,1,0,1,0,1,0,0,10,540219,-1243,-14,-1,1,-2,-1,0,33,2,-1
KR_7735590588,13193,15713,266,283,2,6,6,2,0,4,0,1,0,0,16,24,0,4,0,1,0,1,0,1,0,0,10,540185,-2520,-17,-4,4,-4,-1,0,-8,-4,-1
KR_7735599188,16542,13264,268,239,9,2,2,9,8,2,0,0,0,0,17,15,1,1,2,0,1,0,0,0,0,0,10,540214,3278,29,7,-7,6,0,0,2,0,2
KR_7735602209,13335,14610,197,274,4,3,3,5,4,2,1,0,0,0,12,18,3,1,0,3,0,1,1,0,0,0,10,540130,-1275,-77,1,-2,2,1,0,-6,2,-3
KR_7735626413,16280,15456,273,280,6,6,6,6,11,6,0,0,0,0,21,96,4,5,1,0,1,0,0,0,0,0,10,540215,824,-7,0,0,5,0,0,-75,-1,1
KR_7735645567,17627,16008,266,269,11,7,7,12,12,9,0,0,0,0,13,15,3,1,0,1,0,1,0,0,0,0,10,540220,1619,-3,4,-5,3,0,0,-2,2,-1
KR_7735654660,14494,16945,269,290,3,9,9,5,4,14,0,1,0,0,14,32,4,3,0,0,0,1,0,1,0,0,10,540210,-2451,-21,-6,4,-10,-1,0,-18,1,0
KR_7735664185,15603,12696,278,231,5,1,1,5,10,1,0,1,0,0,17,17,3,3,0,0,0,1,0,1,0,0,10,540224,2907,47,4,-4,9,-1,0,0,0,0
KR_7735673802,15925,15003,273,265,7,5,5,7,8,3,1,0,0,0,18,16,3,6,1,0,1,0,1,0,0,0,10,540268,922,8,2,-2,5,1,0,2,-3,1
KR_7735706857,14409,15711,231,269,5,6,6,5,4,4,0,0,0,0,22,17,2,4,0,1,0,1,0,0,0,0,10,540181,-1302,-38,-1,1,0,0,0,5,-2,-1
KR_7735723094,15217,14332,316,295,4,1,1,4,2,2,0,1,0,0,35,13,3,2,0,1,1,0,0,1,0,0,10,540243,885,21,3,-3,0,-1,0,22,1,-1
KR_7735733621,14043,16768,250,263,3,10,10,3,4,12,0,1,0,0,15,89,3,7,0,2,0,1,0,1,0,0,10,540276,-2725,-13,-7,7,-8,-1,0,-74,-4,-2
KR_7735739942,14986,17652,215,271,6,10,10,6,10,11,0,0,0,0,16,18,4,3,0,2,0,1,0,0,0,0,10,540188,-2666,-56,-4,4,-1,0,0,-2,1,-2
KR_7735761730,15584,15757,282,276,5,7,7,5,3,4,0,0,0,0,14,14,3,5,2,0,0,1,0,0,0,0,10,540241,-173,6,-2,2,-1,0,0,0,-2,2
KR_7735800491,18294,13420,276,244,11,3,3,11,16,1,1,0,0,0,17,15,2,2,3,0,1,0,1,0,0,0,10,540185,4874,32,8,-8,15,1,0,2,0,3
KR_7735803430,14161,14109,253,269,3,2,2,3,7,4,0,1,0,0,16,96,4,7,0,1,1,0,0,1,0,0,10,540250,52,-16,1,-1,3,-1,0,-80,-3,-1
KR_7735822915,14489,15890,253,280,4,6,6,4,5,5,0,0,0,0,11,20,5,1,0,1,1,0,0,0,0,0,10,540262,-1401,-27,-2,2,0,0,0,-9,4,-1
KR_7735854657,14744,16829,253,257,4,9,9,4,3,11,0,0,0,0,14,20,3,1,1,2,1,0,0,0,0,0,10,540290,-2085,-4,-5,5,-8,0,0,-6,2,-1
KR_7735861959,15478,14942,267,258,5,5,5,5,6,5,0,1,0,0,14,15,2,3,0,0,1,0,0,1,0,0,10,540230,536,9,0,0,1,-1,0,-1,-1,0
KR_7735865130,2884,2515,0,0,1,0,0,1,2,0,0,0,0,0,2,2,0,0,0,0,1,0,0,0,0,0,3,100894,369,0,1,-1,2,0,0,0,0,0
KR_7735867345,16874,15578,273,260,10,6,6,10,13,5,0,1,0,0,13,26,5,2,0,0,1,0,0,1,0,0,10,540234,1296,13,4,-4,8,-1,0,-13,3,0
KR_7735871789,14604,16701,253,264,4,7,7,4,9,6,0,0,0,0,52,18,4,1,0,1,1,0,0,0,0,0,10,540265,-2097,-11,-3,3,3,0,0,34,3,-1
KR_7735897573,14682,14160,189,232,8,4,4,8,6,4,0,0,0,0,15,35,4,3,1,0,0,1,0,0,0,0,10,540223,522,-43,4,-4,2,0,0,-20,1,1
KR_7735898286,15395,15135,264,280,6,4,4,6,9,4,1,0,0,0,14,13,3,4,1,0,1,0,1,0,0,0,10,540214,260,-16,2,-2,5,1,0,1,-1,1
KR_7735940538,15539,14495,272,269,5,4,4,5,6,6,0,1,0,0,16,23,3,3,1,1,1,0,0,1,0,0,10,540268,1044,3,1,-1,0,-1,0,-7,0,0
KR_7735941537,15623,14336,278,264,5,3,3,5,5,4,0,1,0,0,14,16,6,4,0,0,1,0,0,1,0,0,10,540255,1287,14,2,-2,1,-1,0,-2,2,0
KR_7735956334,14857,15609,250,261,4,6,6,4,5,4,0,0,0,0,21,17,2,5,0,1,0,1,0,0,0,0,10,540244,-752,-11,-2,2,1,0,0,4,-3,-1
KR_7735969027,14467,15293,285,252,4,5,5,4,2,8,1,0,0,0,18,21,5,1,0,1,0,1,1,0,0,0,10,540216,-826,33,-1,1,-6,1,0,-3,4,-1
KR_7735970769,15021,14386,283,262,5,3,3,5,3,4,1,0,0,0,14,12,0,2,1,3,0,1,1,0,0,0,10,540174,635,21,2,-2,-1,1,0,2,-2,-2
KR_7736002429,15542,13871,301,273,4,2,2,4,4,3,1,0,0,0,124,16,1,2,1,0,0,1,1,0,0,0,10,540213,1671,28,2,-2,1,1,0,108,-1,1
KR_7736006308,15389,15841,241,223,6,8,8,6,12,14,0,0,0,0,37,19,2,3,1,0,0,1,0,0,0,0,10,540198,-452,18,-2,2,-2,0,0,18,-1,1
KR_7736022860,15486,14256,248,254,7,3,3,7,8,3,0,0,0,0,16,34,4,3,0,0,1,0,0,0,0,0,10,540224,1230,-6,4,-4,5,0,0,-18,1,0
KR_7736025128,16226,14127,273,251,8,4,4,9,6,3,0,0,0,0,14,17,4,5,1,0,0,1,0,0,0,0,10,540193,2099,22,4,-5,3,0,0,-3,-1,1
KR_7736070987,13693,14697,231,207,3,7,7,3,2,6,0,0,0,0,24,16,3,4,0,1,0,1,0,0,0,0,10,540206,-1004,24,-4,4,-4,0,0,8,-1,-1
KR_7736073373,15832,15163,272,268,6,5,5,7,4,8,0,1,0,0,20,16,3,4,2,0,0,1,0,1,0,0,10,540089,669,4,1,-2,-4,-1,0,4,-1,2
KR_7736083736,15385,15826,251,264,6,7,7,6,5,6,0,1,0,0,12,12,2,3,0,0,0,1,0,1,0,0,10,540217,-441,-13,-1,1,-1,-1,0,0,-1,0
KR_7736090438,15017,14276,270,244,5,5,5,5,5,3,0,0,0,0,17,22,3,6,1,0,1,0,0,0,0,0,10,540248,741,26,0,0,2,0,0,-5,-3,1
KR_7736108021,15149,13802,247,293,6,2,2,6,7,0,0,0,0,0,41,16,1,5,0,0,0,1,0,0,0,0,10,540192,1347,-46,4,-4,7,0,0,25,-4,0
KR_7736108119,16144,14469,259,252,6,5,5,6,10,3,0,1,0,0,38,17,3,2,2,2,0,1,0,1,0,0,10,540270,1675,7,1,-1,7,-1,0,21,1,0
KR_7736112037,15676,15450,313,287,4,5,5,5,5,6,1,0,0,0,16,16,1,1,0,0,0,1,1,0,0,0,10,540192,226,26,-1,0,-1,1,0,0,0,0
KR_7736134818,15947,12771,311,259,5,0,0,5,8,0,0,0,0,0,38,47,4,2,1,0,1,0,0,0,0,0,10,540209,3176,52,5,-5,8,0,0,-9,2,1
KR_7736160633,14974,15427,283,258,3,6,6,3,2,7,0,0,0,0,13,20,3,1,2,2,0,1,0,0,0,0,10,540215,-453,25,-3,3,-5,0,0,-7,2,0
KR_7736183691,16009,14332,255,255,9,3,3,9,8,3,0,0,0,0,18,15,3,3,0,0,1,0,0,0,0,0,10,540244,1677,0,6,-6,5,0,0,3,0,0
KR_7736191327,15310,18308,256,251,5,13,13,5,7,15,0,1,0,0,178,17,3,3,1,1,0,1,0,1,0,0,10,540177,-2998,5,-8,8,-8,-1,0,161,0,0
KR_7736196412,16120,13584,272,274,8,1,1,8,14,2,0,0,0,0,17,48,2,1,0,0,1,0,0,0,0,0,10,540240,2536,-2,7,-7,12,0,0,-31,1,0
KR_7736226069,15767,14996,273,273,6,5,5,7,8,5,0,0,0,0,15,17,2,4,0,0,0,1,0,0,0,0,10,540194,771,0,1,-2,3,0,0,-2,-2,0
KR_7736232542,16420,15664,244,254,9,7,7,9,12,6,0,1,0,0,17,109,0,3,0,1,0,1,0,1,0,0,10,540280,756,-10,2,-2,6,-1,0,-92,-3,-1
KR_7736232830,14121,14821,231,257,4,5,5,4,5,7,0,1,0,0,11,17,5,2,0,1,1,0,0,1,0,0,10,540258,-700,-26,-1,1,-2,-1,0,-6,3,-1
KR_7736250801,14143,15294,282,269,2,5,5,2,4,8,1,0,0,0,15,15,3,3,0,2,0,1,1,0,0,0,10,540232,-1151,13,-3,3,-4,1,0,0,0,-2
KR_7736263579,13947,13669,268,303,2,0,0,2,2,0,0,0,0,0,17,16,0,2,0,1,1,0,0,0,0,0,10,540230,278,-35,2,-2,2,0,0,1,-2,-1
KR_7736278805,16678,15292,247,266,11,5,5,11,8,3,0,0,0,0,18,19,2,2,1,0,1,0,0,0,0,0,10,540163,1386,-19,6,-6,5,0,0,-1,0,1
KR_7736288322,15813,15199,221,256,9,6,6,9,7,5,0,0,0,0,17,12,4,0,0,0,1,0,0,0,0,0,10,540290,614,-35,3,-3,2,0,0,5,4,0
KR_7736290024,15940,15895,234,232,9,8,8,9,10,11,0,0,0,0,22,16,0,3,0,1,1,0,0,0,0,0,10,540244,45,2,1,-1,-1,0,0,6,-3,-1
KR_7736300822,17195,15372,259,266,11,4,4,11,11,7,1,0,0,0,24,16,0,2,0,1,0,1,1,0,0,0,10,540203,1823,-7,7,-7,4,1,0,8,-2,-1
KR_7736308937,13542,16014,251,279,2,6,6,2,4,8,0,0,0,0,18,37,2,6,0,1,0,1,0,0,0,0,10,540209,-2472,-28,-4,4,-4,0,0,-19,-4,-1
KR_7736386360,14247,17066,252,291,4,7,7,4,4,11,1,0,0,0,16,19,3,5,0,2,0,1,1,0,0,0,10,540267,-2819,-39,-3,3,-7,1,0,-3,-2,-2
KR_7736399996,13994,16402,276,277,3,7,7,3,1,6,0,0,0,0,17,16,3,3,1,1,0,1,0,0,0,0,10,540250,-2408,-1,-4,4,-5,0,0,1,0,0
KR_7736432371,13473,15538,244,286,3,5,5,3,1,6,0,0,0,0,37,16,5,5,0,0,0,1,0,0,0,0,10,540249,-2065,-42,-2,2,-5,0,0,21,0,0
KR_7736490112,15772,16712,247,262,7,8,8,8,9,9,1,0,0,0,21,16,2,1,0,3,0,1,1,0,0,0,10,540179,-940,-15,-1,0,0,1,0,5,1,-3
KR_7736508816,2773,2756,7,7,0,0,0,0,0,0,0,0,0,0,3,3,0,0,0,0,0,0,0,0,0,0,3,113617,17,0,0,0,0,0,0,0,0,0
KR_7736523837,14420,16705,267,280,4,7,7,4,2,10,0,0,0,0,17,29,6,4,0,2,0,1,0,0,0,0,10,540225,-2285,-13,-3,3,-8,0,0,-12,2,-2
KR_7736529116,14681,16238,268,278,4,7,7,4,4,8,0,0,0,0,17,35,4,5,0,2,0,1,0,0,0,0,10,540230,-1557,-10,-3,3,-4,0,0,-18,-1,-2
KR_7736541578,16111,16685,214,261,10,9,9,10,10,5,0,0,0,0,9,17,2,0,0,1,1,0,0,0,0,0,10,540201,-574,-47,1,-1,5,0,0,-8,2,-1
KR_7736543883,16600,16672,247,248,8,9,10,8,11,17,0,1,0,0,14,17,3,4,1,2,1,0,0,1,0,0,10,540250,-72,-1,-1,2,-6,-1,0,-3,-1,-1
KR_7736549642,14024,16430,230,267,3,8,8,3,3,8,0,1,0,0,12,12,3,1,2,1,0,1,0,1,0,0,10,540254,-2406,-37,-5,5,-5,-1,0,0,2,1
KR_7736567600,15693,15487,241,229,8,7,7,8,5,10,0,0,0,0,13,35,4,1,2,3,0,1,0,0,0,0,10,540243,206,12,1,-1,-5,0,0,-22,3,-1
KR_7736605011,16742,14543,270,242,8,4,4,8,8,4,0,1,0,0,11,28,2,2,1,1,0,1,0,1,0,0,10,540084,2199,28,4,-4,4,-1,0,-17,0,0
KR_7736607447,14201,15103,247,265,4,4,4,4,3,5,1,0,0,0,15,12,1,0,1,0,1,0,1,0,0,0,10,540222,-902,-18,0,0,-2,1,0,3,1,1
KR_7736609763,14169,15497,257,264,4,5,5,5,1,6,0,1,0,0,13,12,0,1,0,3,1,0,0,1,0,0,10,540214,-1328,-7,-1,0,-5,-1,0,1,-1,-3
KR_7736609930,16350,15995,249,255,7,10,10,7,7,14,0,0,0,0,19,17,2,1,0,0,0,1,0,0,0,0,10,540241,355,-6,-3,3,-7,0,0,2,1,0
KR_7736631758,14491,15453,206,246,6,7,7,6,4,8,1,0,0,0,13,20,2,0,1,0,0,1,1,0,0,0,10,540275,-962,-40,-1,1,-4,1,0,-7,2,1
KR_7736642841,14642,14303,256,246,5,4,4,5,1,4,0,0,0,0,20,16,2,5,1,0,0,1,0,0,0,0,10,540253,339,10,1,-1,-3,0,0,4,-3,1
KR_7736656444,16149,14242,283,249,7,4,4,7,5,8,0,0,0,0,13,13,3,2,0,0,1,0,0,0,0,0,10,540174,1907,34,3,-3,-3,0,0,0,1,0
KR_7736662047,13673,18065,263,274,2,12,12,2,1,10,0,1,0,0,13,16,2,3,0,1,0,1,0,1,0,0,10,540239,-4392,-11,-10,10,-9,-1,0,-3,-1,-1
KR_7736694042,14609,17043,241,268,5,8,8,5,4,11,0,0,0,0,11,29,3,4,0,1,1,0,0,0,0,0,10,540221,-2434,-27,-3,3,-7,0,0,-18,-1,-1
KR_7736703455,13993,14697,247,269,3,3,3,3,4,3,0,1,0,0,16,39,2,2,0,1,1,0,0,1,0,0,10,540239,-704,-22,0,0,1,-1,0,-23,0,-1
KR_7736704775,15723,14707,294,287,5,3,3,5,3,6,0,1,0,0,105,21,4,3,1,0,1,0,0,1,0,0,10,540088,1016,7,2,-2,-3,-1,0,84,1,1
KR_7736731624,14464,14937,253,264,5,5,5,5,3,1,0,0,0,0,14,13,4,5,0,2,1,0,0,0,0,0,10,540232,-473,-11,0,0,2,0,0,1,-1,-2
KR_7736735729,14914,15984,271,271,4,6,6,4,4,6,0,0,0,0,15,15,3,1,0,1,0,1,0,0,0,0,10,540214,-1070,0,-2,2,-2,0,0,0,2,-1
KR_7736738717,13574,16000,255,241,2,7,7,2,2,7,0,0,0,0,14,13,0,6,1,0,0,1,0,0,0,0,10,540230,-2426,14,-5,5,-5,0,0,1,-6,1
KR_7736771774,15225,14703,259,246,7,5,5,7,5,5,0,0,0,0,15,12,1,3,0,0,1,0,0,0,0,0,10,540206,522,13,2,-2,0,0,0,3,-2,0
KR_7736783697,16186,16849,261,260,7,9,9,7,7,12,0,0,0,0,16,16,3,4,0,0,0,1,0,0,0,0,10,540197,-663,1,-2,2,-5,0,0,0,-1,0
KR_7736788501,15662,14741,274,253,6,5,5,6,4,4,0,1,0,0,17,39,2,1,0,0,0,1,0,1,0,0,10,540227,921,21,1,-1,0,-1,0,-22,1,0
KR_7736789428,13961,17904,249,268,2,12,12,2,2,17,0,0,0,0,13,39,3,2,1,1,0,1,0,0,0,0,10,540289,-3943,-19,-10,10,-15,0,0,-26,1,0
KR_7736847274,16469,15631,240,264,7,6,6,7,9,6,0,0,0,0,13,16,2,1,1,0,1,0,0,0,0,0,10,540221,838,-24,1,-1,3,0,0,-3,1,1
KR_7736856714,16370,15474,259,250,8,8,8,8,8,4,0,0,0,0,15,15,6,1,0,1,1,0,0,0,0,0,10,540229,896,9,0,0,4,0,0,0,5,-1
KR_7736857426,13698,13632,276,260,3,2,2,3,0,1,0,0,0,0,13,23,1,4,1,0,0,1,0,0,0,0,10,540218,66,16,1,-1,-1,0,0,-10,-3,1
KR_7736862006,13784,15667,263,275,2,5,5,2,2,3,0,1,0,0,38,21,5,4,0,3,0,1,0,1,0,0,10,540234,-1883,-12,-3,3,-1,-1,0,17,1,-3
KR_7736904557,16741,15881,265,243,9,7,7,9,8,7,0,0,0,0,16,16,2,3,2,0,1,0,0,0,0,0,10,540228,860,22,2,-2,1,0,0,0,-1,2
KR_7736931110,16358,15441,241,243,8,8,8,8,8,5,0,1,0,0,16,12,2,2,1,2,0,1,0,1,0,0,10,540297,917,-2,0,0,3,-1,0,4,0,-1
KR_7736942593,15199,14254,264,256,5,3,3,5,2,4,0,1,0,0,16,16,2,4,1,2,1,0,0,1,0,0,10,540233,945,8,2,-2,-2,-1,0,0,-2,-1
KR_7736951288,15520,15024,258,245,6,6,6,6,5,4,0,1,0,0,33,15,1,2,1,0,0,1,0,1,0,0,10,540253,496,13,0,0,1,-1,0,18,-1,1
KR_7736967347,15039,14637,265,276,5,4,4,5,4,2,0,1,0,0,28,14,3,1,0,1,1,0,0,1,0,0,10,540253,402,-11,1,-1,2,-1,0,14,2,-1
KR_7737034432,14974,12762,279,266,5,0,0,5,4,0,0,0,0,0,15,15,4,3,0,0,1,0,0,0,0,0,10,540174,2212,13,5,-5,4,0,0,0,1,0
KR_7737035060,15800,15647,261,290,7,5,5,7,6,3,0,0,0,0,13,13,2,2,1,1,1,0,0,0,0,0,10,540205,153,-29,2,-2,3,0,0,0,0,0
KR_7737092319,14677,16016,259,265,5,7,7,5,4,6,0,0,0,0,18,14,4,1,0,1,1,0,0,0,0,0,10,540250,-1339,-6,-2,2,-2,0,0,4,3,-1
KR_7737169126,15738,14484,263,263,6,4,4,6,7,5,0,0,0,0,32,16,3,3,0,0,1,0,0,0,0,0,10,540221,1254,0,2,-2,2,0,0,16,0,0
KR_7737188087,14580,16574,273,275,3,8,8,3,2,13,1,0,0,0,16,22,6,4,0,0,1,0,1,0,0,0,10,540196,-1994,-2,-5,5,-11,1,0,-6,2,0
KR_7737198245,15077,15749,273,294,5,5,5,5,5,5,0,0,0,0,16,15,1,3,0,0,1,0,0,0,0,0,10,540204,-672,-21,0,0,0,0,0,1,-2,0
KR_7737203555,15136,15102,277,263,4,5,5,4,3,8,0,0,0,0,23,16,4,2,1,0,0,1,0,0,0,0,10,540173,34,14,-1,1,-5,0,0,7,2,1
KR_7737210146,16766,16156,266,269,9,7,7,9,8,8,0,1,0,0,8,13,2,1,1,0,0,1,0,1,0,0,10,540234,610,-3,2,-2,0,-1,0,-5,1,1
KR_7737246885,17100,14348,276,267,9,3,3,9,11,5,1,0,0,0,21,17,5,2,1,0,1,0,1,0,0,0,10,540244,2752,9,6,-6,6,1,0,4,3,1
KR_7737257670,15356,16963,246,225,6,11,11,6,4,14,1,0,0,0,34,42,2,3,1,1,1,0,1,0,0,0,10,540212,-1607,21,-5,5,-10,1,0,-8,-1,0
KR_7737259964,17907,15225,259,234,12,4,4,12,16,10,0,1,0,0,16,16,4,1,2,2,1,0,0,1,0,0,10,540254,2682,25,8,-8,6,-1,0,0,3,0
KR_7737271579,17543,13327,279,241,6,2,2,6,6,2,0,0,0,0,16,18,4,5,6,0,0,1,0,0,1,0,10,540236,4216,38,4,-4,4,0,0,-2,-1,6
KR_7737320469,14549,15450,246,269,4,5,5,4,4,10,0,0,0,0,19,113,4,4,0,0,1,0,0,0,0,0,10,540230,-901,-23,-1,1,-6,0,0,-94,0,0
KR_7737322274,14368,15075,276,241,3,6,6,3,1,9,0,1,0,0,16,14,4,1,0,1,0,1,0,1,0,0,10,540266,-707,35,-3,3,-8,-1,0,2,3,-1
KR_7737346158,13750,15284,284,289,1,4,4,3,1,9,0,0,0,0,18,14,2,6,0,0,0,1,0,0,0,0,10,540114,-1534,-5,-3,1,-8,0,0,4,-4,0
KR_7737357278,14291,17205,261,289,4,9,9,4,1,10,0,0,0,0,16,14,4,4,0,1,0,1,0,0,0,0,10,540216,-2914,-28,-5,5,-9,0,0,2,0,-1
KR_7737365738,14500,13536,276,278,3,1,1,3,5,1,0,0,0,0,18,15,2,4,0,1,1,0,0,0,0,0,10,540209,964,-2,2,-2,4,0,0,3,-2,-1
KR_7737385902,15829,17371,257,234,7,12,12,7,11,21,0,0,0,0,18,20,2,4,1,1,1,0,0,0,0,0,10,540196,-1542,23,-5,5,-10,0,0,-2,-2,0
KR_7737386420,16113,15803,249,267,7,8,8,7,15,8,0,1,0,0,15,14,2,2,1,0,0,1,0,1,0,0,10,540118,310,-18,-1,1,7,-1,0,1,0,1
KR_7737403013,18320,15715,254,231,13,7,7,13,13,8,0,0,0,0,14,31,6,3,0,2,1,0,0,0,0,0,10,540213,2605,23,6,-6,5,0,0,-17,3,-2
KR_7737428219,16602,15677,266,259,8,6,6,8,11,7,0,0,0,0,32,12,2,4,1,2,0,1,0,0,0,0,10,540256,925,7,2,-2,4,0,0,20,-2,-1
KR_7737448071,15085,13304,276,288,5,0,0,5,3,0,0,0,0,0,76,14,5,4,0,1,1,0,0,0,0,0,10,540201,1781,-12,5,-5,3,0,0,62,1,-1
KR_7737468288,16918,15338,291,262,8,5,5,8,15,9,0,0,0,0,32,16,3,2,1,2,1,0,0,0,0,0,10,540190,1580,29,3,-3,6,0,0,16,1,-1
KR_7737474411,15856,14659,291,295,5,3,3,5,6,5,0,0,0,0,13,16,6,3,0,0,0,1,0,0,0,0,10,540242,1197,-4,2,-2,1,0,0,-3,3,0
KR_7737497678,13482,14028,263,225,2,5,5,2,2,4,1,0,0,0,13,127,3,2,0,0,0,1,1,0,0,0,10,540215,-546,38,-3,3,-2,1,0,-114,1,0
KR_7737509823,14323,16283,240,257,3,8,8,3,4,13,0,0,0,0,26,184,0,2,0,0,0,1,0,0,0,0,10,540230,-1960,-17,-5,5,-9,0,0,-158,-2,0
KR_7737511432,15245,14125,269,283,5,2,3,5,5,2,1,0,0,0,20,16,3,4,2,0,1,0,1,0,0,0,10,540227,1120,-14,3,-2,3,1,0,4,-1,2
KR_7737528084,13971,15271,254,290,3,5,5,3,3,10,0,0,0,0,21,15,2,3,0,0,1,0,0,0,0,0,10,540225,-1300,-36,-2,2,-7,0,0,6,-1,0
KR_7737528537,14297,19183,202,260,6,15,15,6,6,17,0,0,0,0,20,35,2,3,0,0,0,1,0,0,0,0,10,540229,-4886,-58,-9,9,-11,0,0,-15,-1,0
KR_7737555531,15736,14438,298,312,5,2,2,6,8,1,1,0,0,0,21,17,6,5,1,0,1,0,1,0,0,0,10,540220,1298,-14,3,-4,7,1,0,4,1,1
KR_7737573478,16550,14459,295,276,7,3,3,7,3,3,0,0,0,0,15,17,6,1,2,0,1,0,0,0,0,0,10,540115,2091,19,4,-4,0,0,0,-2,5,2
KR_7737587608,13368,14907,235,291,2,4,4,2,3,3,0,0,0,0,39,23,2,2,0,0,0,1,0,0,0,0,10,540256,-1539,-56,-2,2,0,0,0,16,0,0
KR_7737596719,3789,4414,28,44,0,1,1,0,0,1,0,0,0,0,6,2,0,0,0,0,0,1,0,0,0,0,4,159592,-625,-16,-1,1,-1,0,0,4,0,0
KR_7737625068,15951,14052,255,243,8,3,3,8,4,5,0,0,0,0,15,15,1,0,0,1,1,0,0,0,0,0,10,540228,1899,12,5,-5,-1,0,0,0,1,-1
KR_7737625745,17701,14488,252,263,12,3,3,12,16,6,0,1,0,0,19,17,4,5,1,0,1,0,0,1,0,0,10,540275,3213,-11,9,-9,10,-1,0,2,-1,1
KR_7737636390,17325,13347,277,270,9,1,1,9,12,2,0,0,0,0,14,104,4,5,0,0,1,0,0,0,0,0,10,540315,3978,7,8,-8,10,0,0,-90,-1,0
KR_7737642647,16300,14808,259,248,7,5,5,7,7,5,0,0,0,0,19,23,2,6,0,0,0,1,0,0,0,0,10,540267,1492,11,2,-2,2,0,0,-4,-4,0
KR_7737646040,14866,16192,244,272,5,9,9,5,5,11,0,0,0,0,16,13,4,8,1,0,0,1,0,0,0,0,10,540212,-1326,-28,-4,4,-6,0,0,3,-4,1
KR_7737662226,14870,13068,298,270,2,0,0,2,2,0,0,0,0,0,11,15,3,1,2,1,1,0,0,0,0,0,10,540244,1802,28,2,-2,2,0,0,-4,2,1
KR_7737680723,15538,14663,265,228,6,6,6,6,8,8,0,0,0,0,25,18,4,1,0,0,0,1,0,0,0,0,10,540246,875,37,0,0,0,0,0,7,3,0
KR_7737693803,13746,18166,206,268,3,12,12,3,5,18,1,0,0,0,18,42,1,8,1,5,0,1,1,0,0,0,10,540236,-4420,-62,-9,9,-13,1,0,-24,-7,-4
KR_7737701419,14598,15497,256,291,4,5,5,4,3,2,1,0,0,0,14,19,2,2,1,1,0,1,1,0,0,0,10,540235,-899,-35,-1,1,1,1,0,-5,0,0
KR_7737702038,15858,13393,268,255,6,1,2,6,8,2,1,0,0,0,17,57,4,2,1,1,1,0,1,0,0,0,10,540247,2465,13,5,-4,6,1,0,-40,2,0
KR_7737727424,14619,15542,286,300,3,3,3,3,4,6,0,0,0,0,15,15,2,3,1,1,1,0,0,0,0,0,10,540180,-923,-14,0,0,-2,0,0,0,-1,0
KR_7737728129,14388,16992,241,309,5,7,7,6,8,8,0,1,0,0,16,15,2,6,0,3,0,1,0,1,0,0,10,540220,-2604,-68,-2,1,0,-1,0,1,-4,-3
KR_7737737771,15409,13694,294,298,4,1,1,4,8,0,0,0,0,0,18,16,2,4,0,0,1,0,0,0,0,0,10,540222,1715,-4,3,-3,8,0,0,2,-2,0
KR_7737747266,13613,13673,235,292,3,1,2,3,6,0,0,1,0,0,41,23,3,3,0,0,0,1,0,1,0,0,10,540111,-60,-57,2,-1,6,-1,0,18,0,0
KR_7737748271,15853,14375,249,228,8,5,5,8,18,7,1,0,0,0,18,16,6,3,0,1,0,1,1,0,0,0,10,540263,1478,21,3,-3,11,1,0,2,3,-1
KR_7737760816,18991,16372,272,243,15,8,8,15,17,7,0,1,0,0,15,21,1,1,1,0,1,0,0,1,0,0,10,540234,2619,29,7,-7,10,-1,0,-6,0,1
KR_7737762238,14837,15748,236,269,6,6,6,6,5,6,0,1,0,0,14,20,8,1,0,1,0,1,0,1,0,0,10,540175,-911,-33,0,0,-1,-1,0,-6,7,-1
KR_7737762753,17140,14469,258,230,10,4,4,10,15,2,0,0,0,0,18,12,0,0,1,1,1,0,0,0,0,0,10,540264,2671,28,6,-6,13,0,0,6,0,0
KR_7737771396,13618,15072,264,287,2,5,5,2,2,7,0,1,0,0,32,25,3,5,0,0,0,1,0,1,0,0,10,540196,-1454,-23,-3,3,-5,-1,0,7,-2,0
KR_7737793856,13484,13492,292,286,0,1,1,0,0,0,0,1,0,0,16,17,5,3,0,0,0,1,0,1,0,0,10,540235,-8,6,-1,1,0,-1,0,-1,2,0
KR_7737809863,15095,16097,223,288,6,4,4,6,9,5,0,0,0,0,16,29,2,6,1,2,1,0,0,0,0,0,10,540267,-1002,-65,2,-2,4,0,0,-13,-4,-1
KR_7737813168,16249,13769,258,246,9,3,3,9,7,2,1,0,0,0,14,13,3,1,1,0,1,0,1,0,0,0,10,540225,2480,12,6,-6,5,1,0,1,2,1
KR_7737827071,16211,15200,278,262,7,5,5,7,9,6,0,0,0,0,15,18,4,5,0,1,0,1,0,0,0,0,10,540240,1011,16,2,-2,3,0,0,-3,-1,-1
KR_7737844193,14423,14852,276,273,4,4,4,4,5,8,1,0,0,0,20,12,5,1,0,0,1,0,1,0,0,0,10,540241,-429,3,0,0,-3,1,0,8,4,0
KR_7737866929,15258,15114,269,211,5,7,7,5,6,7,0,1,0,0,17,21,2,2,0,0,1,0,0,1,0,0,10,540219,144,58,-2,2,-1,-1,0,-4,0,0
KR_7737877653,16285,14621,260,216,7,6,6,7,12,5,0,0,0,0,18,14,4,6,0,1,1,0,0,0,0,0,10,540220,1664,44,1,-1,7,0,0,4,-2,-1
KR_7737880792,12901,14457,248,268,1,4,4,1,0,1,0,0,0,0,17,18,2,3,0,0,0,1,0,0,0,0,10,540194,-1556,-20,-3,3,-1,0,0,-1,-1,0
KR_7737899808,16052,16690,260,267,8,9,9,8,8,13,0,0,0,0,16,28,4,1,1,1,1,0,0,0,0,0,10,540245,-638,-7,-1,1,-5,0,0,-12,3,0
KR_7737907126,14676,14389,284,249,3,5,5,3,4,4,0,1,0,0,14,114,4,1,0,0,1,0,0,1,0,0,10,540224,287,35,-2,2,0,-1,0,-100,3,0
KR_7737918020,15594,17202,249,246,5,11,11,5,7,19,0,1,0,0,17,18,3,4,1,0,1,0,0,1,0,0,10,540245,-1608,3,-6,6,-12,-1,0,-1,-1,1
KR_7737934614,15304,15735,301,291,3,5,5,3,3,6,0,0,0,0,118,19,6,2,0,0,0,1,0,0,0,0,10,540264,-431,10,-2,2,-3,0,0,99,4,0
KR_7737950655,15099,14168,289,272,4,3,3,4,4,1,0,0,0,0,15,15,3,5,0,0,1,0,0,0,0,0,10,540188,931,17,1,-1,3,0,0,0,-2,0
KR_7737963125,14306,15224,235,283,4,4,4,4,8,6,0,1,0,0,16,14,1,3,1,2,0,1,0,1,0,0,10,540277,-918,-48,0,0,2,-1,0,2,-2,-1
KR_7737970931,16095,14122,296,251,6,3,3,6,6,2,1,0,0,0,14,15,5,2,0,1,1,0,1,0,0,0,10,540219,1973,45,3,-3,4,1,0,-1,3,-1
KR_7737977236,15044,17696,229,257,6,11,11,6,8,19,0,0,0,0,12,17,3,2,0,1,0,1,0,0,0,0,10,540215,-2652,-28,-5,5,-11,0,0,-5,1,-1
KR_7737993146,15121,14171,241,259,8,3,3,8,8,4,0,0,0,0,37,25,3,4,1,0,1,0,0,0,0,0,10,540243,950,-18,5,-5,4,0,0,12,-1,1
KR_7738008402,12688,13938,242,278,0,2,2,0,0,3,0,0,0,0,34,14,3,2,0,0,0,1,0,0,0,0,10,540191,-1250,-36,-2,2,-3,0,0,20,1,0
KR_7738013821,16354,13005,278,260,7,1,2,7,9,0,0,0,0,0,25,11,5,0,2,0,1,0,0,0,0,0,10,540216,3349,18,6,-5,9,0,0,14,5,2
KR_7738014656,16189,13144,261,240,6,1,1,6,6,2,0,1,0,0,15,35,1,4,2,2,1,0,0,1,0,0,10,540188,3045,21,5,-5,4,-1,0,-20,-3,0
KR_7738018498,17060,14850,301,298,7,2,2,7,9,5,0,0,0,0,23,15,6,4,2,0,1,0,0,0,0,0,10,540225,2210,3,5,-5,4,0,0,8,2,2
KR_7738025282,15243,14007,273,249,5,3,3,5,3,5,0,0,0,0,38,45,7,6,1,0,1,0,0,0,0,0,10,540251,1236,24,2,-2,-2,0,0,-7,1,1
KR_7738032762,14693,15208,278,259,3,5,5,3,1,6,0,1,0,0,16,18,2,2,0,1,0,1,0,1,0,0,10,540218,-515,19,-2,2,-5,-1,0,-2,0,-1
KR_7738036821,15709,15092,255,259,6,4,4,6,7,4,0,1,0,0,15,16,5,2,2,2,0,1,0,1,0,0,10,540173,617,-4,2,-2,3,-1,0,-1,3,0
KR_7738048026,15755,13657,259,234,7,3,3,7,8,3,0,0,0,0,15,15,4,1,0,0,0,1,0,0,0,0,10,540238,2098,25,4,-4,5,0,0,0,3,0
KR_7738066563,16400,15311,248,250,9,6,6,9,15,6,0,0,0,0,17,9,2,5,1,0,1,0,0,0,0,0,10,540228,1089,-2,3,-3,9,0,0,8,-3,1
KR_7738084218,15232,15214,240,270,7,5,5,7,7,4,0,0,0,0,16,13,2,3,0,0,0,1,0,0,0,0,10,540234,18,-30,2,-2,3,0,0,3,-1,0
KR_7738087050,14132,13655,277,292,2,1,1,2,2,1,1,0,0,0,13,19,4,4,2,0,1,0,1,0,0,0,10,540279,477,-15,1,-1,1,1,0,-6,0,2
KR_7738093815,14645,13972,270,234,3,4,4,3,3,3,0,0,0,0,16,13,3,3,1,0,0,1,0,0,0,0,10,540184,673,36,-1,1,0,0,0,3,0,1
KR_7738097226,12516,17043,179,254,3,11,11,3,4,5,1,0,0,0,14,15,0,1,0,3,0,1,1,0,0,0,10,540239,-4527,-75,-8,8,-1,1,0,-1,-1,-3
KR_7738105145,14581,14980,272,252,3,5,5,3,3,6,0,0,0,0,13,14,3,5,0,1,0,1,0,0,0,0,10,540208,-399,20,-2,2,-3,0,0,-1,-2,-1
KR_7738107639,18278,13154,261,230,12,2,3,12,11,3,0,1,0,0,70,33,2,4,1,0,1,0,0,1,0,0,10,540262,5124,31,10,-9,8,-1,0,37,-2,1
KR_7738117764,17106,14990,274,267,8,4,4,8,12,5,0,0,0,0,20,16,5,4,1,0,1,0,0,0,0,0,10,540266,2116,7,4,-4,7,0,0,4,1,1
KR_7738128409,14814,15329,241,259,5,6,6,5,5,4,0,0,0,0,14,12,2,2,0,2,0,1,0,0,0,0,10,540267,-515,-18,-1,1,1,0,0,2,0,-2
KR_7738145052,16074,17147,245,294,8,9,9,8,12,9,0,0,0,0,121,12,4,2,0,0,0,1,0,0,0,0,10,540270,-1073,-49,-1,1,3,0,0,109,2,0
KR_7738148836,16822,15551,249,263,10,7,7,10,12,2,0,1,0,0,19,15,4,4,0,1,1,0,0,1,0,0,10,540240,1271,-14,3,-3,10,-1,0,4,0,-1
KR_7738149864,15457,14466,284,246,4,4,4,4,5,8,0,0,0,0,115,24,2,3,1,1,1,0,0,0,0,0,10,540181,991,38,0,0,-3,0,0,91,-1,0
KR_7738162394,18187,15170,270,220,12,7,8,12,10,7,0,1,0,0,29,15,4,2,0,1,0,1,0,1,0,0,10,540281,3017,50,5,-4,3,-1,0,14,2,-1
KR_7738170034,15377,15288,242,251,7,6,6,8,5,7,0,1,0,0,39,37,2,4,1,0,1,0,0,1,0,0,10,540222,89,-9,1,-2,-2,-1,0,2,-2,1
KR_7738175317,13723,14491,229,237,4,6,6,4,2,1,0,0,0,0,13,21,2,1,1,1,1,0,0,0,0,0,10,540262,-768,-8,-2,2,1,0,0,-8,1,0
KR_7738177248,14607,16110,271,278,5,6,6,5,4,12,1,0,0,0,19,18,4,6,0,1,1,0,1,0,0,0,10,540239,-1503,-7,-1,1,-8,1,0,1,-2,-1
KR_7738193226,16252,15105,284,258,7,5,5,7,4,5,0,0,0,0,15,14,0,1,2,0,1,0,0,0,0,0,10,540215,1147,26,2,-2,-1,0,0,1,-1,2
KR_7738199181,14294,17385,246,241,4,11,11,4,6,13,1,0,0,0,13,15,4,1,2,5,0,1,1,0,0,0,10,540220,-3091,5,-7,7,-7,1,0,-2,3,-3
KR_7738200493,15084,15329,275,287,4,4,4,4,3,7,1,0,0,0,16,111,1,3,2,0,1,0,1,0,0,0,10,540186,-245,-12,0,0,-4,1,0,-95,-2,2
KR_7738208428,14411,16018,279,276,3,7,7,3,3,8,0,0,0,0,22,20,3,2,0,1,0,1,0,0,0,0,10,540184,-1607,3,-4,4,-5,0,0,2,1,-1
KR_7738232031,16731,14250,247,243,10,3,3,10,11,2,1,0,0,0,160,14,2,0,0,0,1,0,1,0,0,0,10,540231,2481,4,7,-7,9,1,0,146,2,0
KR_7738250894,14754,14464,242,262,5,4,4,5,3,2,0,1,0,0,19,17,3,5,0,1,0,1,0,1,0,0,10,540209,290,-20,1,-1,1,-1,0,2,-2,-1
KR_7738253160,15665,16073,299,294,5,6,6,5,6,9,0,1,0,0,14,16,3,2,0,1,0,1,0,1,0,0,10,540235,-408,5,-1,1,-3,-1,0,-2,1,-1
KR_7738269430,16961,13375,236,246,13,2,2,13,9,1,0,0,0,0,15,14,3,2,1,0,1,0,0,0,0,0,10,540115,3586,-10,11,-11,8,0,0,1,1,1
KR_7738284387,15892,15195,274,268,5,6,6,5,6,6,0,0,0,0,19,53,3,6,2,0,1,0,0,0,0,0,10,540243,697,6,-1,1,0,0,0,-34,-3,2
KR_7738287632,15688,14990,254,260,7,5,6,7,9,6,0,1,0,0,14,13,0,1,0,0,1,0,0,1,0,0,10,540254,698,-6,2,-1,3,-1,0,1,-1,0
KR_7738298190,15619,16382,283,270,6,8,8,6,3,5,0,0,0,0,14,14,1,2,0,0,0,1,0,0,0,0,10,540180,-763,13,-2,2,-2,0,0,0,-1,0
KR_7738299614,15507,17273,220,233,7,12,12,7,10,19,0,1,0,0,15,15,1,1,1,0,0,1,0,1,0,0,10,540219,-1766,-13,-5,5,-9,-1,0,0,0,1
KR_7738307933,17206,16544,232,259,10,8,8,10,12,8,0,0,0,0,12,24,5,2,4,1,1,0,0,0,0,0,10,540216,662,-27,2,-2,4,0,0,-12,3,3
KR_7738312265,15512,15245,284,229,5,6,6,5,4,14,1,0,0,0,12,147,2,1,1,0,1,0,1,0,0,0,10,540216,267,55,-1,1,-10,1,0,-135,1,1
KR_7738326284,15223,15013,266,254,6,5,5,6,3,8,0,1,0,0,15,43,2,1,0,0,1,0,0,1,0,0,10,540217,210,12,1,-1,-5,-1,0,-28,1,0
KR_7738329260,14545,14748,247,260,4,5,6,4,5,2,0,0,0,0,17,87,2,1,0,0,1,0,0,0,0,0,10,540278,-203,-13,-1,2,3,0,0,-70,1,0
KR_7738361519,15049,14955,246,244,6,6,6,6,4,8,0,0,0,0,16,30,1,3,1,0,0,1,0,0,0,0,10,540229,94,2,0,0,-4,0,0,-14,-2,1
KR_7738386303,16711,14067,248,279,9,2,2,9,19,2,1,0,0,0,15,15,1,2,1,0,0,1,1,0,0,0,10,540182,2644,-31,7,-7,17,1,0,0,-1,1
KR_7738388449,15804,15228,245,249,7,5,5,7,10,8,1,0,0,0,14,188,5,3,0,0,1,0,1,0,0,0,10,540202,576,-4,2,-2,2,1,0,-174,2,0
KR_7738401034,17626,16189,240,245,10,8,8,10,15,10,1,0,0,0,65,29,0,3,1,1,1,0,1,0,0,0,10,540209,1437,-5,2,-2,5,1,0,36,-3,0
KR_7738401793,16817,13604,270,243,9,2,2,9,12,2,0,0,0,0,17,13,3,3,1,1,1,0,0,0,0,0,10,540271,3213,27,7,-7,10,0,0,4,0,0
KR_7738412902,16216,15566,289,237,6,7,7,6,8,11,0,0,0,0,15,37,4,2,2,0,0,1,0,0,0,0,10,540256,650,52,-1,1,-3,0,0,-22,2,2
KR_7738423571,15730,16468,268,249,7,8,8,7,6,14,0,0,0,0,16,15,4,2,1,2,0,1,0,0,0,0,10,540208,-738,19,-1,1,-8,0,0,1,2,-1
KR_7738452832,17997,15684,257,268,12,5,5,12,15,4,0,0,0,0,33,20,5,2,2,1,0,1,0,0,0,0,10,540236,2313,-11,7,-7,11,0,0,13,3,1
KR_7738456063,15363,14559,247,253,6,5,5,6,7,7,0,1,0,0,97,34,4,1,1,0,0,1,0,1,0,0,10,540277,804,-6,1,-1,0,-1,0,63,3,1
KR_7738489810,17390,12518,255,186,10,3,3,10,14,4,0,0,0,0,37,16,1,0,3,0,1,0,0,0,0,0,10,540231,4872,69,7,-7,10,0,0,21,1,3
KR_7738498203,14844,15801,268,282,3,6,6,3,4,5,0,1,0,0,19,11,2,3,1,0,0,1,0,1,0,0,10,540210,-957,-14,-3,3,-1,-1,0,8,-1,1
KR_7738507325,14170,14373,265,258,3,3,3,3,6,3,0,0,0,0,14,38,3,2,0,0,1,0,0,0,0,0,10,540261,-203,7,0,0,3,0,0,-24,1,0
KR_7738546676,16592,15059,278,265,8,4,4,8,6,4,0,0,0,0,19,13,4,9,1,1,0,1,0,0,0,0,10,540205,1533,13,4,-4,2,0,0,6,-5,0
KR_7738551467,15585,15994,280,265,4,6,6,4,7,9,0,1,0,0,13,16,3,0,1,0,1,0,0,1,0,0,10,540153,-409,15,-2,2,-2,-1,0,-3,3,1
KR_7738562655,14919,14078,277,243,4,3,3,4,3,3,0,0,0,0,19,37,3,2,1,1,1,0,0,0,0,0,10,540197,841,34,1,-1,0,0,0,-18,1,0
KR_7738573951,14621,15481,249,264,5,7,7,5,4,4,0,0,0,0,15,11,0,2,0,2,0,1,0,0,0,0,10,540222,-860,-15,-2,2,0,0,0,4,-2,-2
KR_7738579687,15299,15908,265,264,4,7,7,4,6,7,0,0,0,0,14,13,2,1,0,3,0,1,0,0,0,0,10,540174,-609,1,-3,3,-1,0,0,1,1,-3
KR_7738586952,16529,13218,285,237,7,2,2,7,13,4,1,0,0,0,27,11,3,1,2,0,0,1,1,0,0,0,10,540211,3311,48,5,-5,9,1,0,16,2,2
KR_7738610130,15493,17098,262,267,6,10,10,6,5,11,0,1,0,0,15,20,4,3,0,1,1,0,0,1,0,0,10,540279,-1605,-5,-4,4,-6,-1,0,-5,1,-1
KR_7738618888,17803,13694,256,225,11,3,3,11,20,4,1,0,0,0,40,16,3,4,4,0,1,0,1,0,0,0,10,540230,4109,31,8,-8,16,1,0,24,-1,4
KR_7738621626,17050,14015,260,269,10,3,3,10,12,2,0,0,0,0,17,13,1,1,2,0,1,0,0,0,0,0,10,540254,3035,-9,7,-7,10,0,0,4,0,2
KR_7738621948,12983,14706,253,272,0,4,4,0,0,6,0,1,0,0,24,222,4,4,0,0,0,1,0,1,0,0,10,540276,-1723,-19,-4,4,-6,-1,0,-198,0,0
KR_7738626332,16489,13728,287,231,8,3,3,8,6,4,0,0,0,0,18,14,2,3,0,0,1,0,0,0,0,0,10,540183,2761,56,5,-5,2,0,0,4,-1,0
KR_7738641214,14396,15710,264,264,3,7,7,3,2,7,0,1,0,0,17,14,5,4,0,2,0,1,0,1,0,0,10,540235,-1314,0,-4,4,-5,-1,0,3,1,-2
KR_7738654834,15384,16289,228,262,8,9,9,8,6,9,0,0,0,0,15,15,3,3,1,0,1,0,0,0,0,0,10,540181,-905,-34,-1,1,-3,0,0,0,0,1
KR_7738661116,13942,17995,215,244,4,13,13,4,4,13,0,0,0,0,11,37,4,0,1,0,0,1,0,0,0,0,10,540212,-4053,-29,-9,9,-9,0,0,-26,4,1
KR_7738670583,17993,14901,221,253,13,4,4,13,13,5,0,0,0,0,16,35,4,2,1,0,1,0,0,0,0,0,10,540220,3092,-32,9,-9,8,0,0,-19,2,1
KR_7738679415,16243,14111,325,277,4,2,2,4,5,3,1,0,0,0,15,14,3,5,4,0,1,0,1,0,0,0,10,540277,2132,48,2,-2,2,1,0,1,-2,4
KR_7738679821,15362,14266,264,216,5,5,5,5,10,5,0,1,0,0,32,21,5,1,1,0,0,1,0,1,0,0,10,540245,1096,48,0,0,5,-1,0,11,4,1
KR_7738688621,14366,14373,250,271,3,3,3,3,4,6,0,0,0,0,244,11,1,3,1,0,0,1,0,0,0,0,10,540226,-7,-21,0,0,-2,0,0,233,-2,1
KR_7738691390,14824,14932,260,266,4,4,4,5,5,6,0,0,0,0,12,17,4,2,2,1,1,0,0,0,0,0,10,540239,-108,-6,0,-1,-1,0,0,-5,2,1
KR_7738697088,15462,18494,288,282,3,12,12,3,3,17,0,1,0,0,14,32,4,2,0,0,0,1,0,1,0,0,10,540215,-3032,6,-9,9,-14,-1,0,-18,2,0
KR_7738705780,14829,15542,246,220,5,8,9,5,8,16,0,0,0,0,17,115,5,2,0,0,1,0,0,0,0,0,10,540261,-713,26,-3,4,-8,0,0,-98,3,0
KR_7738718632,16554,14162,264,265,8,3,3,8,6,3,0,0,0,0,17,38,7,2,2,0,1,0,0,0,0,0,10,540246,2392,-1,5,-5,3,0,0,-21,5,2
KR_7738743756,12384,15743,207,276,1,6,6,1,1,6,0,0,0,0,12,223,3,2,0,2,0,1,0,0,0,0,10,540278,-3359,-69,-5,5,-5,0,0,-211,1,-2
KR_7738800286,15665,15748,283,290,5,5,5,5,8,4,0,1,0,0,13,13,2,1,1,2,1,0,0,1,0,0,10,540135,-83,-7,0,0,4,-1,0,0,1,-1
KR_7738814209,15557,15818,292,290,4,5,5,4,6,4,0,0,0,0,106,16,5,9,0,1,1,0,0,0,0,0,10,540256,-261,2,-1,1,2,0,0,90,-4,-1
KR_7738872158,17589,15119,261,248,13,7,7,13,21,7,1,0,0,0,15,16,7,2,0,0,1,0,1,0,0,0,10,540205,2470,13,6,-6,14,1,0,-1,5,0
KR_7738885026,15022,14935,272,280,4,5,5,4,7,3,0,1,0,0,44,19,2,5,0,0,0,1,0,1,0,0,10,540218,87,-8,-1,1,4,-1,0,25,-3,0
KR_7738950628,15234,14381,301,286,3,2,2,3,6,3,0,0,0,0,33,10,2,6,1,0,1,0,0,0,0,0,10,540177,853,15,1,-1,3,0,0,23,-4,1
KR_7738995450,17122,13319,292,257,8,1,1,8,11,1,0,0,0,0,17,34,3,3,0,0,0,1,0,0,0,0,10,540235,3803,35,7,-7,10,0,0,-17,0,0
KR_7738999941,15664,18066,217,224,6,14,14,6,8,16,0,0,0,0,11,19,1,2,1,1,0,1,0,0,0,0,10,540246,-2402,-7,-8,8,-8,0,0,-8,-1,0
KR_7739001359,14861,14033,275,254,4,3,3,4,3,2,0,0,0,0,27,11,3,4,0,1,0,1,0,0,0,0,10,540209,828,21,1,-1,1,0,0,16,-1,-1
KR_7739063991,16207,14807,260,264,8,5,5,8,9,3,0,0,0,0,18,15,2,5,0,0,0,1,0,0,0,0,10,540244,1400,-4,3,-3,6,0,0,3,-3,0
KR_7739065284,14087,15802,248,248,4,11,11,4,4,7,0,1,0,0,33,13,1,6,0,0,0,1,0,1,0,0,10,540192,-1715,0,-7,7,-3,-1,0,20,-5,0
KR_7739081795,15087,16183,212,259,7,7,7,7,10,8,0,1,0,0,26,108,6,6,0,1,0,1,0,1,0,0,10,540229,-1096,-47,0,0,2,-1,0,-82,0,-1
KR_7739141475,16614,13070,256,223,9,2,2,9,11,2,0,0,0,0,28,17,3,3,1,0,0,1,0,0,0,0,10,540183,3544,33,7,-7,9,0,0,11,0,1
KR_7739153747,16022,15790,260,248,6,8,8,7,9,11,0,0,0,0,14,15,3,4,1,1,0,1,0,0,0,0,10,540224,232,12,-2,1,-2,0,0,-1,-1,0
KR_7739207413,18005,15344,265,240,13,6,7,13,14,6,0,0,0,0,17,13,2,1,3,0,1,0,0,0,0,0,10,540267,2661,25,7,-6,8,0,0,4,1,3
KR_7739259663,13603,16348,249,280,3,6,6,3,3,7,0,1,0,0,12,108,3,5,0,1,1,0,0,1,0,0,10,540195,-2745,-31,-3,3,-4,-1,0,-96,-2,-1
KR_7739268740,16802,14744,259,245,9,5,5,9,8,6,1,0,0,0,16,15,4,1,2,0,1,0,1,0,0,0,10,540210,2058,14,4,-4,2,1,0,1,3,2
KR_7739290345,16142,13345,285,263,7,1,1,7,3,2,0,1,0,0,25,16,8,3,2,0,1,0,0,1,0,0,10,540245,2797,22,6,-6,1,-1,0,9,5,2
KR_7739307999,15717,15646,229,199,9,9,9,9,10,10,0,0,0,0,17,18,6,4,0,0,0,1,0,0,0,0,10,540278,71,30,0,0,0,0,0,-1,2,0
KR_7739312209,14969,13871,260,261,5,3,3,5,9,1,0,0,0,0,14,32,6,3,1,0,0,1,0,0,0,0,10,540222,1098,-1,2,-2,8,0,0,-18,3,1
KR_7739350633,13912,16597,259,285,2,7,7,2,1,14,0,1,0,0,13,108,6,3,1,1,0,1,0,1,0,0,10,540091,-2685,-26,-5,5,-13,-1,0,-95,3,0
KR_7739381733,16556,15406,247,260,10,7,7,10,14,7,0,0,0,0,16,17,2,2,0,0,1,0,0,0,0,0,10,540247,1150,-13,3,-3,7,0,0,-1,0,0
KR_7739387783,16500,16522,254,267,10,8,8,10,9,6,0,0,0,0,20,33,3,2,2,1,1,0,0,0,0,0,10,540222,-22,-13,2,-2,3,0,0,-13,1,1
KR_7739425520,15097,13479,252,256,7,2,2,7,5,0,1,0,0,0,34,23,2,2,1,0,1,0,1,0,0,0,10,540197,1618,-4,5,-5,5,1,0,11,0,1
KR_7739428067,18039,14771,232,231,14,6,6,14,17,7,0,0,0,0,34,20,6,5,2,0,0,1,0,0,0,0,10,540276,3268,1,8,-8,10,0,0,14,1,2
KR_7739467116,17591,15258,260,207,11,7,7,11,11,11,0,0,0,0,36,16,3,3,2,0,1,0,0,0,0,0,10,540154,2333,53,4,-4,0,0,0,20,0,2
KR_7739483930,15541,16899,243,246,7,10,10,8,6,13,0,0,0,0,15,19,1,0,1,1,1,0,0,0,0,0,10,540256,-1358,-3,-3,2,-7,0,0,-4,1,0
KR_7739515093,15099,17498,255,254,5,10,10,5,7,19,0,1,0,0,18,20,1,6,0,1,1,0,0,1,0,0,10,540234,-2399,1,-5,5,-12,-1,0,-2,-5,-1
KR_7739543683,15117,16129,261,247,4,8,8,5,4,10,0,0,0,0,16,16,4,5,0,0,0,1,0,0,0,0,10,540207,-1012,14,-4,3,-6,0,0,0,-1,0
KR_7739548245,17711,16137,247,235,12,7,7,12,15,16,0,0,0,0,26,15,2,2,1,1,1,0,0,0,0,0,10,540209,1574,12,5,-5,-1,0,0,11,0,0
KR_7739601684,15496,14972,260,268,4,4,4,4,8,4,0,0,0,0,17,19,4,1,3,2,1,0,0,0,0,0,10,540227,524,-8,0,0,4,0,0,-2,3,1
KR_7739610845,15335,15150,277,280,5,4,4,5,3,6,0,0,0,0,20,16,6,1,0,0,1,0,0,0,0,0,10,540153,185,-3,1,-1,-3,0,0,4,5,0
KR_7739638655,15865,15875,274,283,8,5,5,8,7,8,1,0,0,0,13,16,2,2,0,3,1,0,1,0,0,0,10,540248,-10,-9,3,-3,-1,1,0,-3,0,-3
KR_7739642613,14228,14688,279,301,3,3,4,3,3,1,0,1,0,0,17,19,4,3,0,2,0,1,0,1,0,0,10,540078,-460,-22,0,1,2,-1,0,-2,1,-2
KR_7739671283,16412,12937,262,266,9,0,0,9,13,0,0,0,0,0,22,15,2,4,0,0,1,0,0,0,0,0,10,540259,3475,-4,9,-9,13,0,0,7,-2,0
KR_7739721860,13088,14504,226,285,3,2,2,3,1,3,0,1,0,0,15,18,0,3,0,2,1,0,0,1,0,0,10,540190,-1416,-59,1,-1,-2,-1,0,-3,-3,-2
KR_7739745104,14665,14659,238,233,6,6,6,6,5,5,0,1,0,0,16,12,3,3,0,2,0,1,0,1,0,0,10,540207,6,5,0,0,0,-1,0,4,0,-2
KR_7739755377,14643,15112,276,285,4,5,5,4,4,6,0,1,0,0,23,17,1,5,0,0,0,1,0,1,0,0,10,540254,-469,-9,-1,1,-2,-1,0,6,-4,0
KR_7739766817,16767,13636,279,238,8,3,3,8,4,4,1,0,0,0,17,35,3,4,2,0,1,0,1,0,0,0,10,540218,3131,41,5,-5,0,1,0,-18,-1,2
KR_7739780398,15579,13879,263,244,7,3,3,7,6,4,0,0,0,0,15,22,4,2,1,1,1,0,0,0,0,0,10,540227,1700,19,4,-4,2,0,0,-7,2,0
KR_7739792393,16208,14152,276,276,7,2,2,7,12,1,0,0,0,0,31,17,3,3,0,1,1,0,0,0,0,0,10,540253,2056,0,5,-5,11,0,0,14,0,-1
KR_7739795087,14574,14112,278,285,3,2,2,3,5,4,0,0,0,0,20,18,1,7,1,0,1,0,0,0,0,0,10,540230,462,-7,1,-1,1,0,0,2,-6,1
KR_7739795622,15075,15047,234,261,5,5,5,5,3,7,0,1,0,0,36,16,2,2,2,1,1,0,0,1,0,0,10,540223,28,-27,0,0,-4,-1,0,20,0,1
KR_7739803760,14339,14658,251,250,3,4,4,3,5,9,0,1,0,0,24,35,5,7,1,1,1,0,0,1,0,0,10,540213,-319,1,-1,1,-4,-1,0,-11,-2,0
KR_7739819605,14463,16931,268,275,4,9,9,4,3,10,1,0,0,0,22,14,2,6,0,0,0,1,1,0,0,0,10,540220,-2468,-7,-5,5,-7,1,0,8,-4,0
KR_7739828205,16660,14861,234,228,9,7,8,9,11,5,0,1,0,0,115,34,3,3,1,1,1,0,0,1,0,0,10,540215,1799,6,2,-1,6,-1,0,81,0,0
KR_7739855920,17456,13763,298,255,9,3,4,9,6,0,1,0,0,0,16,16,3,3,1,0,1,0,1,0,0,0,10,540247,3693,43,6,-5,6,1,0,0,0,1
KR_7739873623,17563,14335,260,259,11,3,3,11,14,3,1,0,0,0,16,27,5,1,3,1,1,0,1,0,0,0,10,540221,3228,1,8,-8,11,1,0,-11,4,2
KR_7739881986,15091,15922,258,261,6,7,7,6,3,7,1,0,0,0,20,17,3,7,1,0,1,0,1,0,0,0,10,540217,-831,-3,-1,1,-4,1,0,3,-4,1
KR_7739882083,13311,15745,249,270,2,7,7,2,3,11,0,1,0,0,15,18,3,0,0,1,0,1,0,1,0,0,10,540183,-2434,-21,-5,5,-8,-1,0,-3,3,-1
KR_7739882252,13006,13947,288,289,0,1,1,0,0,0,1,0,0,0,12,20,8,2,0,0,0,1,1,0,0,0,10,540210,-941,-1,-1,1,0,1,0,-8,6,0
KR_7739888066,13952,15763,252,285,2,6,6,2,2,5,0,0,0,0,32,16,3,3,0,1,0,1,0,0,0,0,10,540245,-1811,-33,-4,4,-3,0,0,16,0,-1
KR_7739891384,16214,15482,266,221,6,8,8,6,7,7,0,1,0,0,14,17,2,1,2,0,1,0,0,1,0,0,10,540294,732,45,-2,2,0,-1,0,-3,1,2
KR_7739900602,12961,16646,236,278,1,8,8,1,1,12,0,0,0,0,31,20,2,8,1,1,0,1,0,0,0,0,10,540196,-3685,-42,-7,7,-11,0,0,11,-6,0
KR_7739908743,16381,15814,222,258,9,8,8,9,12,4,0,1,0,0,36,19,3,6,0,2,0,1,0,1,0,0,10,540231,567,-36,1,-1,8,-1,0,17,-3,-2
KR_7739921820,15628,13804,290,255,5,2,2,5,6,1,0,0,0,0,24,15,3,3,1,0,0,1,0,0,0,0,10,540199,1824,35,3,-3,5,0,0,9,0,1
KR_7739928195,15731,15073,247,262,7,5,5,7,8,6,0,1,0,0,18,18,3,4,0,1,0,1,0,1,0,0,10,540251,658,-15,2,-2,2,-1,0,0,-1,-1
KR_7739928512,15163,15661,272,280,5,5,5,5,5,5,1,0,0,0,14,15,5,2,0,0,1,0,1,0,0,0,10,540259,-498,-8,0,0,0,1,0,-1,3,0
KR_7739936287,15489,15183,243,253,8,6,6,8,4,9,0,0,0,0,15,18,5,1,2,0,0,1,0,0,0,0,10,540231,306,-10,2,-2,-5,0,0,-3,4,2
KR_7739937789,16263,15561,279,272,7,5,5,7,7,8,1,0,0,0,20,19,8,6,2,0,1,0,1,0,0,0,10,540262,702,7,2,-2,-1,1,0,1,2,2
KR_7739943647,14370,17172,247,288,4,9,10,5,3,11,0,0,0,0,13,16,2,2,0,0,0,1,0,0,0,0,10,540199,-2802,-41,-5,5,-8,0,0,-3,0,0
KR_7739948888,15473,14526,279,265,5,4,4,5,7,2,0,1,0,0,15,9,2,2,1,1,1,0,0,1,0,0,10,540266,947,14,1,-1,5,-1,0,6,0,0
KR_7739960322,16025,13887,296,271,5,2,2,5,6,1,0,1,0,0,16,17,6,4,0,1,1,0,0,1,0,0,10,540195,2138,25,3,-3,5,-1,0,-1,2,-1
KR_7739964945,16383,13952,270,276,8,1,1,8,6,1,0,0,0,0,14,30,2,3,1,1,1,0,0,0,0,0,10,540230,2431,-6,7,-7,5,0,0,-16,-1,0
KR_7739981402,14802,14393,284,257,3,3,3,3,5,2,0,1,0,0,16,15,2,3,0,0,1,0,0,1,0,0,10,540182,409,27,0,0,3,-1,0,1,-1,0
KR_7739990965,14863,16452,283,241,3,9,9,3,2,14,0,1,0,0,17,17,2,2,0,0,1,0,0,1,0,0,10,540190,-1589,42,-6,6,-12,-1,0,0,0,0
KR_7739993227,15804,17627,209,263,8,11,11,8,8,17,0,1,0,0,21,16,3,8,1,1,1,0,0,1,0,0,10,540233,-1823,-54,-3,3,-9,-1,0,5,-5,0
KR_7739999874,14363,14287,229,268,6,4,4,6,6,6,0,0,0,0,12,18,3,2,0,0,1,0,0,0,0,0,10,540068,76,-39,2,-2,0,0,0,-6,1,0
KR_7740007852,14928,14116,276,278,5,3,3,5,2,1,0,1,0,0,39,17,2,5,0,0,1,0,0,1,0,0,10,540222,812,-2,2,-2,1,-1,0,22,-3,0
KR_7740019190,14477,17669,252,296,4,9,9,4,3,14,0,0,0,0,17,18,3,4,0,2,0,1,0,0,0,0,10,540236,-3192,-44,-5,5,-11,0,0,-1,-1,-2
KR_7740019917,15671,16819,248,285,6,8,8,6,10,8,0,1,0,0,44,13,2,3,0,1,0,1,0,1,0,0,10,540214,-1148,-37,-2,2,2,-1,0,31,-1,-1
KR_7740020658,14233,16770,259,282,3,7,7,3,4,8,0,0,0,0,27,18,2,4,1,0,1,0,0,0,0,0,10,540192,-2537,-23,-4,4,-4,0,0,9,-2,1
KR_7740034468,16235,14962,288,282,6,4,5,6,5,5,0,0,0,0,35,15,3,4,0,0,0,1,0,0,0,0,10,540197,1273,6,2,-1,0,0,0,20,-1,0
KR_7740046380,14767,14862,265,280,5,3,3,5,4,5,0,0,0,0,43,112,2,2,0,2,0,1,0,0,0,0,10,540200,-95,-15,2,-2,-1,0,0,-69,0,-2
KR_7740053730,18940,15638,243,190,15,10,10,15,22,14,0,0,0,0,20,11,2,2,1,1,0,1,0,0,0,0,10,540081,3302,53,5,-5,8,0,0,9,0,0
KR_7740060920,13870,15507,259,287,2,5,5,2,4,7,0,0,0,0,15,17,4,6,0,0,0,1,0,0,0,0,10,540267,-1637,-28,-3,3,-3,0,0,-2,-2,0
KR_7740086424,15013,16601,275,276,5,8,8,5,4,13,1,0,0,0,18,16,2,5,0,0,1,0,1,0,0,0,10,540178,-1588,-1,-3,3,-9,1,0,2,-3,0
KR_7740092984,15325,16583,256,251,4,9,9,4,5,12,0,0,0,0,11,17,5,2,2,0,1,0,0,0,0,0,10,540234,-1258,5,-5,5,-7,0,0,-6,3,2
KR_7740117683,13751,16543,271,253,2,8,8,2,4,13,0,1,0,0,18,36,4,6,0,0,0,1,0,1,0,0,10,540250,-2792,18,-6,6,-9,-1,0,-18,-2,0
KR_7740126329,15543,14059,266,279,7,2,2,7,5,1,0,0,0,0,16,15,3,3,0,0,1,0,0,0,0,0,10,540206,1484,-13,5,-5,4,0,0,1,0,0
KR_7740132474,14282,16804,249,265,3,8,8,3,4,11,0,1,0,0,14,18,2,2,0,3,0,1,0,1,0,0,10,540237,-2522,-16,-5,5,-7,-1,0,-4,0,-3
KR_7740152780,15605,14399,279,235,6,4,4,6,9,6,0,0,0,0,46,17,4,2,0,1,1,0,0,0,0,0,10,540207,1206,44,2,-2,3,0,0,29,2,-1
KR_7740157288,15154,17882,238,250,5,13,13,6,6,18,0,0,0,0,16,28,3,3,1,0,0,1,0,0,0,0,10,540212,-2728,-12,-8,7,-12,0,0,-12,0,1
KR_7740157851,16097,15921,249,255,9,7,7,10,9,7,0,0,0,0,16,18,2,4,0,0,0,1,0,0,0,0,10,540094,176,-6,2,-3,2,0,0,-2,-2,0
KR_7740176182,15832,17076,283,245,6,10,10,6,9,13,1,0,0,0,14,20,3,2,0,0,0,1,1,0,0,0,10,540188,-1244,38,-4,4,-4,1,0,-6,1,0
KR_7740177491,16745,15610,278,269,8,5,5,8,9,7,0,0,0,0,19,19,2,4,0,1,0,1,0,0,0,0,10,540219,1135,9,3,-3,2,0,0,0,-2,-1
KR_7740193090,15281,14215,262,243,6,4,4,7,6,4,0,0,0,0,35,29,6,2,0,0,0,1,0,0,0,0,10,540148,1066,19,2,-3,2,0,0,6,4,0
KR_7740200782,15546,13727,279,263,4,2,2,4,4,3,0,0,0,0,20,16,5,7,0,0,1,0,0,0,0,0,10,540222,1819,16,2,-2,1,0,0,4,-2,0
KR_7740212585,15549,15313,282,272,4,6,6,4,5,8,0,1,0,0,78,42,3,5,0,2,0,1,0,1,0,0,10,540188,236,10,-2,2,-3,-1,0,36,-2,-2
KR_7740222722,13326,16064,259,289,1,7,7,1,0,7,0,1,0,0,16,13,2,3,0,0,0,1,0,1,0,0,10,540296,-2738,-30,-6,6,-7,-1,0,3,-1,0
KR_7740228852,14107,15762,268,233,2,8,8,2,2,16,0,0,0,0,56,36,3,5,1,0,0,1,0,0,0,0,10,540285,-1655,35,-6,6,-14,0,0,20,-2,1
KR_7740240267,15378,16075,269,265,6,6,6,6,10,6,0,0,0,0,13,11,2,2,0,1,1,0,0,0,0,0,10,540198,-697,4,0,0,4,0,0,2,0,-1
KR_7740240585,16808,15532,238,268,10,5,5,10,11,4,0,0,0,0,18,18,4,4,1,1,1,0,0,0,0,0,10,540289,1276,-30,5,-5,7,0,0,0,0,0
KR_7740253495,14748,14162,199,235,6,3,3,6,12,8,1,0,0,0,14,16,3,4,2,0,1,0,1,0,0,0,10,540223,586,-36,3,-3,4,1,0,-2,-1,2
KR_7740290005,15952,17181,219,273,9,9,9,9,9,6,1,0,0,0,15,199,1,5,0,3,0,1,1,0,0,0,10,540235,-1229,-54,0,0,3,1,0,-184,-4,-3
KR_7740292469,14348,14395,279,269,2,3,3,2,1,5,0,0,0,0,16,16,1,3,1,1,1,0,0,0,0,0,10,540224,-47,10,-1,1,-4,0,0,0,-2,0
KR_7740295688,15895,15143,260,260,7,5,6,7,9,6,0,0,0,0,32,35,2,3,0,0,1,0,0,0,0,0,10,540229,752,0,2,-1,3,0,0,-3,-1,0
KR_7740326513,14699,15151,274,297,4,3,3,4,3,4,0,0,0,0,15,17,2,5,0,0,1,0,0,0,0,0,10,540226,-452,-23,1,-1,-1,0,0,-2,-3,0
KR_7740327296,15940,15810,286,280,6,8,8,6,3,7,1,0,0,0,14,19,2,5,0,0,0,1,1,0,0,0,10,540243,130,6,-2,2,-4,1,0,-5,-3,0
KR_7740340209,15845,15382,290,257,6,6,6,6,6,5,1,0,0,0,23,27,2,1,0,0,1,0,1,0,0,0,10,540245,463,33,0,0,1,1,0,-4,1,0
KR_7740342178,16331,12850,237,230,9,1,1,9,9,1,0,0,0,0,37,12,7,4,1,0,1,0,0,0,0,0,10,540271,3481,7,8,-8,8,0,0,25,3,1
KR_7740352697,15107,16170,286,274,4,7,7,4,7,8,0,0,0,0,52,34,4,5,0,2,1,0,0,0,0,0,10,540097,-1063,12,-3,3,-1,0,0,18,-1,-2
KR_7740360464,14209,14458,269,270,3,4,4,3,5,1,0,0,0,0,21,15,3,1,0,0,1,0,0,0,0,0,10,540217,-249,-1,-1,1,4,0,0,6,2,0
KR_7740371630,15949,17519,245,258,6,10,10,6,11,17,0,0,0,0,30,24,8,1,0,2,0,1,0,0,0,0,10,540237,-1570,-13,-4,4,-6,0,0,6,7,-2
KR_7740387957,14141,15921,258,281,4,5,5,4,2,8,1,0,0,0,15,13,3,4,0,2,0,1,1,0,0,0,10,540242,-1780,-23,-1,1,-6,1,0,2,-1,-2
KR_7740417800,15961,17028,241,221,7,11,11,7,10,9,1,0,0,0,12,14,2,0,0,1,0,1,1,0,0,0,10,540203,-1067,20,-4,4,1,1,0,-2,2,-1
KR_7740472557,15893,14104,293,296,6,2,2,6,8,3,0,1,0,0,17,14,0,1,0,0,0,1,0,1,0,0,10,540234,1789,-3,4,-4,5,-1,0,3,-1,0
KR_7740485681,14697,17908,250,260,3,12,12,3,4,16,0,0,0,0,17,116,4,4,1,2,0,1,0,0,0,0,10,540305,-3211,-10,-9,9,-12,0,0,-99,0,-1
KR_7740510531,12929,16255,263,279,0,7,7,0,0,12,0,1,0,0,107,15,0,4,1,1,0,1,0,1,0,0,10,540246,-3326,-16,-7,7,-12,-1,0,92,-4,0
KR_7740520461,13304,15151,244,263,2,6,6,2,2,5,0,1,0,0,13,15,3,4,0,0,1,0,0,1,0,0,10,540259,-1847,-19,-4,4,-3,-1,0,-2,-1,0
KR_7740539635,14723,16048,242,252,4,8,9,4,5,7,1,0,0,0,17,26,7,2,0,1,0,1,1,0,0,0,10,540237,-1325,-10,-4,5,-2,1,0,-9,5,-1
KR_7740552517,16554,15343,254,249,10,6,6,10,6,15,0,0,0,0,18,16,6,2,1,0,1,0,0,0,0,0,10,540238,1211,5,4,-4,-9,0,0,2,4,1
KR_7740564352,16119,15324,255,235,9,8,8,9,5,7,1,0,0,0,113,16,3,2,0,1,0,1,1,0,0,0,10,540196,795,20,1,-1,-2,1,0,97,1,-1
KR_7740582721,13595,15790,185,278,5,4,4,5,7,6,0,0,0,0,13,13,1,2,0,1,1,0,0,0,0,0,10,540246,-2195,-93,1,-1,1,0,0,0,-1,-1
KR_7740596531,14183,17154,244,250,5,11,11,5,2,6,0,0,0,0,22,16,2,3,0,2,0,1,0,0,0,0,10,540194,-2971,-6,-6,6,-4,0,0,6,-1,-2
KR_7740609118,14024,17788,238,253,3,13,13,3,3,12,0,0,0,0,15,15,0,3,0,1,1,0,0,0,0,0,10,540224,-3764,-15,-10,10,-9,0,0,0,-3,-1
KR_7740613409,14518,15212,258,253,3,6,6,3,8,9,0,1,0,0,17,27,1,2,2,1,0,1,0,1,0,0,10,540252,-694,5,-3,3,-1,-1,0,-10,-1,1
KR_7740651470,14524,13550,286,260,3,2,2,3,4,3,0,1,0,0,25,17,0,4,1,0,0,1,0,1,0,0,10,540231,974,26,1,-1,1,-1,0,8,-4,1
KR_7740667855,12724,16816,220,293,1,7,7,1,1,5,0,0,0,0,15,16,0,6,0,4,0,1,0,0,0,0,10,540173,-4092,-73,-6,6,-4,0,0,-1,-6,-4
KR_7740711730,15460,13422,275,282,5,1,1,5,6,0,0,0,0,0,17,18,1,1,0,0,0,1,0,0,0,0,10,540233,2038,-7,4,-4,6,0,0,-1,0,0
KR_7740719881,17842,15828,270,259,11,7,7,11,22,11,0,1,0,0,14,14,2,3,1,2,0,1,0,1,0,0,10,540235,2014,11,4,-4,11,-1,0,0,-1,-1
KR_7740737943,15376,14106,237,212,8,6,6,8,5,4,0,0,0,0,13,16,2,2,1,0,1,0,0,0,0,0,10,540224,1270,25,2,-2,1,0,0,-3,0,1
KR_7740770205,14364,13900,265,274,4,2,2,4,4,2,1,0,0,0,13,13,0,4,0,0,1,0,1,0,0,0,10,540110,464,-9,2,-2,2,1,0,0,-4,0
KR_7740773196,14363,13842,248,239,4,3,3,4,3,3,1,0,0,0,15,17,6,2,1,1,1,0,1,0,0,0,10,540166,521,9,1,-1,0,1,0,-2,4,0
KR_7740792881,14268,14437,247,255,4,4,4,4,6,0,0,0,0,0,10,17,2,1,0,1,1,0,0,0,0,0,10,540212,-169,-8,0,0,6,0,0,-7,1,-1
KR_7740794469,15644,15075,204,236,9,7,7,9,8,4,0,0,0,0,14,11,0,2,2,1,1,0,0,0,0,0,10,540262,569,-32,2,-2,4,0,0,3,-2,1
KR_7740812245,15464,15921,266,264,6,6,6,6,7,7,0,0,0,0,14,14,1,2,0,0,1,0,0,0,0,0,10,540252,-457,2,0,0,0,0,0,0,-1,0
KR_7740819311,15816,18294,246,256,7,13,13,8,5,9,0,0,0,0,44,15,3,1,1,1,0,1,0,0,0,0,10,540259,-2478,-10,-6,5,-4,0,0,29,2,0
KR_7740827888,15635,14831,268,276,6,4,4,6,5,2,0,0,0,0,19,26,2,4,0,0,0,1,0,0,0,0,10,540263,804,-8,2,-2,3,0,0,-7,-2,0
KR_7740828952,14780,17476,212,276,6,11,11,6,8,10,0,1,0,0,34,19,1,3,0,2,0,1,0,1,0,0,10,540208,-2696,-64,-5,5,-2,-1,0,15,-2,-2
KR_7740835988,14766,15529,257,274,4,5,5,4,4,9,0,0,0,0,19,15,4,3,0,0,1,0,0,0,0,0,10,540244,-763,-17,-1,1,-5,0,0,4,1,0
KR_7740836276,13218,16817,204,259,4,8,8,4,3,7,0,0,0,0,14,16,0,2,0,3,0,1,0,0,0,0,10,540255,-3599,-55,-4,4,-4,0,0,-2,-2,-3
KR_7740847098,15917,15580,262,258,7,6,6,7,7,9,0,0,0,0,33,13,4,3,1,0,0,1,0,0,0,0,10,540259,337,4,1,-1,-2,0,0,20,1,1
KR_7740857482,13488,16815,254,302,2,8,8,2,1,6,0,0,0,0,13,17,4,1,0,0,1,0,0,0,0,0,10,540231,-3327,-48,-6,6,-5,0,0,-4,3,0
KR_7740885079,15144,16031,250,259,6,7,7,6,7,10,0,0,0,0,19,19,0,4,0,0,0,1,0,0,0,0,10,540220,-887,-9,-1,1,-3,0,0,0,-4,0
KR_7740885215,17172,14755,253,253,10,5,5,10,7,5,0,0,0,0,13,20,0,3,1,0,1,0,0,0,0,0,10,540270,2417,0,5,-5,2,0,0,-7,-3,1
KR_7740905235,14270,15889,244,246,3,8,8,3,5,11,0,0,0,0,16,14,2,6,0,0,0,1,0,0,0,0,10,540244,-1619,-2,-5,5,-6,0,0,2,-4,0
KR_7740914893,5611,6850,72,96,0,2,2,0,0,1,0,0,0,0,12,5,0,0,0,1,0,1,0,0,0,0,5,238403,-1239,-24,-2,2,-1,0,0,7,0,-1
KR_7740946195,15280,15626,269,258,5,6,6,5,5,10,1,0,0,0,20,14,1,5,0,1,0,1,1,0,0,0,10,540260,-346,11,-1,1,-5,1,0,6,-4,-1
KR_7740956687,13456,15933,278,295,1,6,6,1,1,5,0,1,0,0,36,22,4,4,0,1,0,1,0,1,0,0,10,540269,-2477,-17,-5,5,-4,-1,0,14,0,-1
KR_7740958456,13926,15072,269,256,3,4,4,4,2,9,0,0,0,0,17,22,1,1,0,0,0,1,0,0,0,0,10,540217,-1146,13,-1,0,-7,0,0,-5,0,0
KR_7740970311,17117,13914,287,260,9,2,2,9,12,3,0,1,0,0,20,17,3,3,0,0,0,1,0,1,0,0,10,540264,3203,27,7,-7,9,-1,0,3,0,0
KR_7740971744,16292,14213,274,240,7,5,5,7,7,7,0,1,0,0,17,15,4,2,2,0,1,0,0,1,0,0,10,540208,2079,34,2,-2,0,-1,0,2,2,2
KR_7741021175,15391,15457,279,218,5,8,8,5,2,10,0,1,0,0,16,15,5,3,0,0,1,0,0,1,0,0,10,540284,-66,61,-3,3,-8,-1,0,1,2,0
KR_7741022938,14460,16212,229,250,5,9,9,5,6,11,1,0,0,0,23,26,3,4,1,1,0,1,1,0,0,0,10,540239,-1752,-21,-4,4,-5,1,0,-3,-1,0
KR_7741048801,17132,13080,286,222,8,2,2,8,9,1,0,0,0,0,15,11,2,1,2,0,0,1,0,0,0,0,10,540199,4052,64,6,-6,8,0,0,4,1,2
KR_7741095434,14463,16814,207,242,6,11,11,6,8,5,0,1,0,0,12,18,5,2,1,2,0,1,0,1,0,0,10,540173,-2351,-35,-5,5,3,-1,0,-6,3,-1
KR_7741097446,14201,15828,304,299,1,7,7,1,3,14,0,1,0,0,14,17,3,1,2,0,0,1,0,1,0,0,10,540240,-1627,5,-6,6,-11,-1,0,-3,2,2
KR_7741104329,16109,16228,253,257,7,7,7,7,6,7,0,0,0,0,28,15,1,3,0,2,0,1,0,0,0,0,10,540234,-119,-4,0,0,-1,0,0,13,-2,-2
KR_7741159704,13319,16609,216,263,4,10,10,4,1,8,0,0,0,0,27,19,5,3,0,1,0,1,0,0,0,0,10,540181,-3290,-47,-6,6,-7,0,0,8,2,-1
KR_7741164643,14280,15918,274,263,2,7,7,2,3,8,0,0,0,0,34,11,3,1,1,2,0,1,0,0,0,0,10,540201,-1638,11,-5,5,-5,0,0,23,2,-1
KR_7741180899,17748,15614,237,240,12,6,6,12,19,10,0,0,0,0,23,19,4,2,1,0,0,1,0,0,0,0,10,540219,2134,-3,6,-6,9,0,0,4,2,1
KR_7741193476,14002,17708,261,262,2,11,11,2,1,15,0,0,0,0,14,125,1,1,2,1,1,0,0,0,0,0,10,540083,-3706,-1,-9,9,-14,0,0,-111,0,1
KR_7741226688,16167,14133,270,250,8,3,3,8,11,2,1,0,0,0,13,46,2,0,1,0,1,0,1,0,0,0,10,540227,2034,20,5,-5,9,1,0,-33,2,1
KR_7741238773,15198,16316,230,275,8,8,8,8,9,4,0,0,0,0,14,41,1,2,2,3,1,0,0,0,0,0,10,540249,-1118,-45,0,0,5,0,0,-27,-1,-1
KR_7741240631,17599,16639,230,260,11,9,9,11,15,7,0,0,0,0,16,12,1,1,0,0,0,1,0,0,0,0,10,540266,960,-30,2,-2,8,0,0,4,0,0
KR_7741257379,15424,13634,244,233,7,3,3,7,13,3,0,0,0,0,16,14,4,2,0,0,1,0,0,0,0,0,10,540249,1790,11,4,-4,10,0,0,2,2,0
KR_7741273558,15406,15195,269,247,5,6,6,5,7,8,0,0,0,0,16,18,3,1,1,0,0,1,0,0,0,0,10,540106,211,22,-1,1,-1,0,0,-2,2,1
KR_7741289596,16224,14598,249,192,8,7,7,8,8,5,0,0,0,0,10,15,2,2,1,1,0,1,0,0,0,0,10,540255,1626,57,1,-1,3,0,0,-5,0,0
KR_7741308826,14706,15867,263,248,5,7,7,5,2,8,0,0,0,0,14,12,2,3,0,1,0,1,0,0,0,0,10,540225,-1161,15,-2,2,-6,0,0,2,-1,-1
KR_7741316162,16382,16485,271,236,8,9,9,8,6,9,0,0,0,0,9,15,2,3,1,1,1,0,0,0,0,0,10,540200,-103,35,-1,1,-3,0,0,-6,-1,0
KR_7741332960,14548,14715,274,255,4,4,4,5,4,5,0,0,0,0,14,38,1,2,0,0,1,0,0,0,0,0,10,540187,-167,19,0,-1,-1,0,0,-24,-1,0
KR_7741369038,18113,14503,270,219,13,4,4,13,17,8,1,0,0,0,29,11,3,2,4,1,1,0,1,0,0,0,10,540203,3610,51,9,-9,9,1,0,18,1,3
KR_7741378596,17062,15735,246,247,10,6,6,11,14,4,0,0,0,0,16,273,3,2,2,0,0,1,0,0,0,0,10,540204,1327,-1,4,-5,10,0,0,-257,1,2
KR_7741385114,14248,16141,244,261,4,9,9,4,5,6,0,0,0,0,14,15,3,2,0,1,0,1,0,0,0,0,10,540206,-1893,-17,-5,5,-1,0,0,-1,1,-1
KR_7741402689,15690,16668,229,224,7,10,10,7,7,8,1,0,0,0,18,17,1,2,1,1,1,0,1,0,0,0,10,540089,-978,5,-3,3,-1,1,0,1,-1,0
KR_7741430585,13888,15338,239,255,4,6,6,4,3,11,0,1,0,0,18,16,1,4,1,1,0,1,0,1,0,0,10,540159,-1450,-16,-2,2,-8,-1,0,2,-3,0
KR_7741434833,14647,14853,257,277,4,4,4,4,2,3,0,1,0,0,17,54,3,2,2,1,1,0,0,1,0,0,10,540173,-206,-20,0,0,-1,-1,0,-37,1,1
KR_7741438668,14832,14538,270,269,4,3,3,4,4,6,1,0,0,0,14,16,2,2,0,0,0,1,1,0,0,0,10,540226,294,1,1,-1,-2,1,0,-2,0,0
KR_7741468823,14237,13941,248,242,4,3,3,4,5,1,1,0,0,0,15,23,1,1,2,2,0,1,1,0,0,0,10,540264,296,6,1,-1,4,1,0,-8,0,0
KR_7741492689,16176,14543,277,263,6,4,4,6,6,3,0,0,0,0,14,18,4,4,1,0,1,0,0,0,0,0,10,540218,1633,14,2,-2,3,0,0,-4,0,1
KR_7741493847,15825,16917,251,279,8,8,8,8,3,13,0,0,0,0,22,30,1,5,0,1,0,1,0,0,0,0,10,540249,-1092,-28,0,0,-10,0,0,-8,-4,-1
KR_7741526608,13839,14133,248,265,3,4,4,3,3,1,0,0,0,0,90,22,1,2,0,0,0,1,0,0,0,0,10,540221,-294,-17,-1,1,2,0,0,68,-1,0
KR_7741552337,18767,14408,293,223,11,5,5,11,16,5,0,0,0,0,16,18,3,1,2,1,0,1,0,0,0,0,10,540252,4359,70,6,-6,11,0,0,-2,2,1
KR_7741580915,13435,16905,234,273,3,9,9,3,5,7,0,1,0,0,17,17,1,2,0,3,1,0,0,1,0,0,10,540257,-3470,-39,-6,6,-2,-1,0,0,-1,-3
KR_7741586320,14324,16255,265,248,3,8,8,3,3,12,0,1,0,0,17,18,4,4,1,1,0,1,0,1,0,0,10,540222,-1931,17,-5,5,-9,-1,0,-1,0,0
KR_7741588817,12569,16010,203,262,3,7,7,3,1,7,0,1,0,0,15,23,1,3,0,1,1,0,0,1,0,0,10,540271,-3441,-59,-4,4,-6,-1,0,-8,-2,-1
KR_7741630543,16512,16817,260,207,9,12,12,9,7,15,0,0,0,0,34,18,4,6,3,1,1,0,0,0,0,0,10,540190,-305,53,-3,3,-8,0,0,16,-2,2
KR_7741648006,17545,14216,266,249,11,4,4,11,9,4,0,0,0,0,117,14,1,3,2,1,1,0,0,0,0,0,10,540175,3329,17,7,-7,5,0,0,103,-2,1
KR_7741657421,14132,15664,253,290,3,5,5,3,3,4,0,1,0,0,18,17,1,2,0,0,0,1,0,1,0,0,10,540218,-1532,-37,-2,2,-1,-1,0,1,-1,0
KR_7741701419,15549,16531,252,262,5,9,9,6,8,7,0,0,0,0,16,18,2,2,0,1,0,1,0,0,0,0,10,540236,-982,-10,-4,3,1,0,0,-2,0,-1
KR_7741721658,14584,16840,274,244,3,10,10,3,3,24,0,0,0,0,12,20,5,2,0,1,0,1,0,0,0,0,10,540190,-2256,30,-7,7,-21,0,0,-8,3,-1
KR_7741748517,2586,2546,2,0,0,0,0,0,0,0,0,0,0,0,1,4,0,0,0,0,0,0,0,0,0,0,3,104618,40,2,0,0,0,0,0,-3,0,0
KR_7741770742,16724,13561,272,260,7,3,3,7,5,1,0,0,0,0,55,18,6,4,3,0,1,0,0,0,0,0,10,540219,3163,12,4,-4,4,0,0,37,2,3
KR_7741773702,15548,15239,250,235,8,6,6,8,6,6,0,0,0,0,10,20,4,1,0,0,1,0,0,0,0,0,10,540180,309,15,2,-2,0,0,0,-10,3,0
KR_7741797676,14101,17312,253,249,3,11,11,3,2,22,0,0,0,0,16,21,3,3,0,0,1,0,0,0,0,0,10,540235,-3211,4,-8,8,-20,0,0,-5,0,0
KR_7741804370,16086,14446,262,237,8,5,5,8,6,7,0,0,0,0,16,20,4,0,1,0,1,0,0,0,0,0,10,540248,1640,25,3,-3,-1,0,0,-4,4,1
KR_7741811878,16626,14969,259,226,10,6,6,10,5,8,0,0,0,0,17,17,5,1,0,1,1,0,0,0,0,0,10,540193,1657,33,4,-4,-3,0,0,0,4,-1
KR_7741853108,18207,15145,257,268,12,5,5,12,19,5,0,0,0,0,29,11,1,3,2,0,1,0,0,0,0,0,10,540232,3062,-11,7,-7,14,0,0,18,-2,2
KR_7741863572,15770,15561,282,228,5,7,7,5,7,7,0,0,0,0,16,15,2,2,1,0,0,1,0,0,0,0,10,540262,209,54,-2,2,0,0,0,1,0,1
KR_7741864014,15324,15152,275,262,5,5,5,5,12,10,0,0,0,0,17,22,0,2,0,1,0,1,0,0,0,0,10,540220,172,13,0,0,2,0,0,-5,-2,-1
KR_7741882294,16429,16087,301,256,5,8,8,5,5,12,0,1,0,0,19,103,5,6,1,0,0,1,0,1,0,0,10,540239,342,45,-3,3,-7,-1,0,-84,-1,1
KR_7741886904,16501,15512,249,260,8,6,6,8,12,7,0,0,0,0,10,17,5,2,0,0,1,0,0,0,0,0,10,540239,989,-11,2,-2,5,0,0,-7,3,0
KR_7741927170,17202,15752,244,254,11,7,7,11,15,9,0,0,0,0,17,20,4,2,0,1,1,0,0,0,0,0,10,540226,1450,-10,4,-4,6,0,0,-3,2,-1
KR_7741946457,17302,15673,267,282,9,5,5,9,13,4,0,1,0,0,17,14,2,5,0,2,1,0,0,1,0,0,10,540242,1629,-15,4,-4,9,-1,0,3,-3,-2
KR_7741961085,16892,14196,269,246,8,4,4,8,9,2,0,0,0,0,38,19,3,1,0,1,0,1,0,0,0,0,10,540181,2696,23,4,-4,7,0,0,19,2,-1
KR_7741993017,17210,16058,254,218,11,8,8,11,11,12,0,0,0,0,20,38,5,2,0,0,1,0,0,0,0,0,10,540211,1152,36,3,-3,-1,0,0,-18,3,0
KR_7742036278,16003,15312,275,257,6,7,7,6,6,3,0,0,0,0,17,15,6,3,1,1,1,0,0,0,0,0,10,540131,691,18,-1,1,3,0,0,2,3,0
KR_7742060750,14655,15118,247,267,4,5,5,4,5,3,0,0,0,0,10,15,0,2,1,1,0,1,0,0,0,0,10,540210,-463,-20,-1,1,2,0,0,-5,-2,0
KR_7742068522,13588,14941,250,296,2,3,3,2,3,3,0,0,0,0,27,18,4,5,0,0,1,0,0,0,0,0,10,540191,-1353,-46,-1,1,0,0,0,9,-1,0
KR_7742089420,14661,14625,290,273,4,4,4,4,1,3,0,0,0,0,15,27,5,3,0,0,0,1,0,0,0,0,10,540201,36,17,0,0,-2,0,0,-12,2,0
KR_7742104916,18148,13530,275,227,11,3,3,11,16,3,1,0,0,0,13,16,4,3,3,0,1,0,1,0,0,0,10,540234,4618,48,8,-8,13,1,0,-3,1,3
KR_7742110540,15318,14523,253,281,7,3,3,7,5,1,0,1,0,0,26,17,4,5,1,0,1,0,0,1,0,0,10,540170,795,-28,4,-4,4,-1,0,9,-1,1
KR_7742123241,13920,14948,264,262,3,5,5,3,1,7,0,1,0,0,17,106,1,4,1,0,0,1,0,1,0,0,10,540244,-1028,2,-2,2,-6,-1,0,-89,-3,1
KR_7742124821,14926,16536,239,254,5,9,9,5,4,7,0,0,0,0,19,12,1,8,2,0,1,0,0,0,0,0,10,540207,-1610,-15,-4,4,-3,0,0,7,-7,2
KR_7742143249,15025,14144,303,251,4,3,3,4,2,4,0,0,0,0,29,20,2,0,0,0,1,0,0,0,0,0,10,540164,881,52,1,-1,-2,0,0,9,2,0
KR_7742145834,17177,14654,286,246,8,4,4,8,10,7,0,0,0,0,113,16,5,3,0,0,1,0,0,0,0,0,10,540232,2523,40,4,-4,3,0,0,97,2,0
KR_7742157545,13015,14703,278,285,0,3,3,0,0,8,0,1,0,0,104,23,4,2,0,1,0,1,0,1,0,0,10,540220,-1688,-7,-3,3,-8,-1,0,81,2,-1
KR_7742180702,14854,16106,257,286,4,5,5,4,5,5,0,0,0,0,20,24,6,5,2,4,0,1,0,0,0,0,10,540220,-1252,-29,-1,1,0,0,0,-4,1,-2
KR_7742189396,16100,15601,267,215,7,9,9,7,12,19,0,1,0,0,14,12,3,3,1,0,0,1,0,1,0,0,10,540214,499,52,-2,2,-7,-1,0,2,0,1
KR_7742208518,13851,14997,276,268,2,4,4,2,1,6,0,0,0,0,16,19,6,6,0,1,1,0,0,0,0,0,10,540155,-1146,8,-2,2,-5,0,0,-3,0,-1
KR_7742214449,16215,17300,257,264,7,11,11,7,12,12,0,0,0,0,20,16,2,10,1,0,1,0,0,0,0,0,10,540203,-1085,-7,-4,4,0,0,0,4,-8,1
KR_7742215451,15855,12766,277,264,4,0,0,4,4,0,0,1,0,0,19,14,2,4,1,0,1,0,0,1,0,0,10,540183,3089,13,4,-4,4,-1,0,5,-2,1
KR_7742216165,16701,12699,278,241,10,0,0,10,7,0,0,0,0,0,22,13,2,4,0,1,1,0,0,0,0,0,10,540209,4002,37,10,-10,7,0,0,9,-2,-1
KR_7742229667,14815,13255,257,270,5,1,1,5,4,0,0,0,0,0,23,19,9,8,0,0,1,0,0,0,0,0,10,540206,1560,-13,4,-4,4,0,0,4,1,0
KR_7742244401,15470,16069,233,233,9,8,8,9,10,9,0,0,0,0,21,17,4,0,0,0,1,0,0,0,0,0,10,540243,-599,0,1,-1,1,0,0,4,4,0
KR_7742253655,14778,14403,307,314,2,1,1,2,2,0,0,0,0,0,16,13,3,5,0,1,1,0,0,0,0,0,10,540199,375,-7,1,-1,2,0,0,3,-2,-1
KR_7742270072,15787,16079,268,277,5,6,6,5,9,7,0,1,0,0,16,14,3,3,1,1,0,1,0,1,0,0,10,540248,-292,-9,-1,1,2,-1,0,2,0,0
KR_7742272613,14762,13717,269,256,5,2,2,5,3,2,0,0,0,0,24,18,2,4,0,0,0,1,0,0,0,0,10,540225,1045,13,3,-3,1,0,0,6,-2,0
KR_7742288205,14884,15133,240,255,4,6,6,4,7,6,0,1,0,0,17,14,1,1,0,0,1,0,0,1,0,0,10,540092,-249,-15,-2,2,1,-1,0,3,0,0
KR_7742288696,14221,17439,241,294,4,10,10,4,3,6,0,1,0,0,15,22,4,4,0,1,0,1,0,1,0,0,10,540222,-3218,-53,-6,6,-3,-1,0,-7,0,-1
KR_7742298089,13786,15961,276,281,1,6,6,1,2,9,1,0,0,0,21,38,3,7,0,1,0,1,1,0,0,0,10,540250,-2175,-5,-5,5,-7,1,0,-17,-4,-1
KR_7742304573,14346,15512,241,265,4,6,6,4,8,11,1,0,0,0,19,21,3,5,0,0,0,1,1,0,0,0,10,540206,-1166,-24,-2,2,-3,1,0,-2,-2,0
KR_7742307750,15547,14659,265,264,7,4,4,7,4,6,0,0,0,0,37,13,1,2,0,0,1,0,0,0,0,0,10,540230,888,1,3,-3,-2,0,0,24,-1,0
KR_7742311733,16834,14206,267,245,9,3,3,9,12,2,0,0,0,0,14,16,2,1,1,0,1,0,0,0,0,0,10,540235,2628,22,6,-6,10,0,0,-2,1,1
KR_7742321776,15445,15203,262,260,5,6,6,5,6,3,0,0,0,0,17,38,3,4,1,0,0,1,0,0,0,0,10,540245,242,2,-1,1,3,0,0,-21,-1,1
KR_7742327844,14934,18445,247,248,5,12,12,5,4,14,0,0,0,0,19,19,1,7,0,2,0,1,0,0,0,0,10,540239,-3511,-1,-7,7,-10,0,0,0,-6,-2
KR_7742332502,15102,14827,260,283,5,4,4,5,5,2,0,0,0,0,18,17,4,0,0,1,1,0,0,0,0,0,10,540075,275,-23,1,-1,3,0,0,1,4,-1
KR_7742340684,14856,13513,286,272,4,1,1,4,4,0,0,0,0,0,19,19,2,4,0,0,1,0,0,0,0,0,10,540273,1343,14,3,-3,4,0,0,0,-2,0
KR_7742350511,15767,14391,254,266,7,4,4,7,8,1,0,0,0,0,13,39,2,2,1,0,1,0,0,0,0,0,10,540196,1376,-12,3,-3,7,0,0,-26,0,1
KR_7742362014,15663,15259,259,264,7,6,6,7,8,7,0,0,0,0,13,33,3,2,0,1,1,0,0,0,0,0,10,540227,404,-5,1,-1,1,0,0,-20,1,-1
KR_7742364212,13828,17215,258,277,2,9,9,2,2,8,0,1,0,0,17,21,7,2,0,4,0,1,0,1,0,0,10,540240,-3387,-19,-7,7,-6,-1,0,-4,5,-4
KR_7742376093,15638,14568,249,231,7,5,5,7,7,6,0,1,0,0,44,33,0,3,1,1,1,0,0,1,0,0,10,540247,1070,18,2,-2,1,-1,0,11,-3,0
KR_7742394322,15122,15062,261,292,6,3,3,6,3,3,0,0,0,0,38,17,4,5,0,0,1,0,0,0,0,0,10,540235,60,-31,3,-3,0,0,0,21,-1,0
KR_7742400527,17575,15123,272,254,11,5,5,11,19,5,0,0,0,0,25,21,6,3,0,0,1,0,0,0,0,0,10,540231,2452,18,6,-6,14,0,0,4,3,0
KR_7742412099,17474,15398,299,247,9,6,7,9,9,6,0,0,0,0,15,19,5,2,1,0,1,0,0,0,0,0,10,540261,2076,52,3,-2,3,0,0,-4,3,1
KR_7742412297,15252,15093,278,280,4,4,4,4,4,3,0,0,0,0,13,16,4,2,0,1,0,1,0,0,0,0,10,540245,159,-2,0,0,1,0,0,-3,2,-1
KR_7742415138,16952,14073,258,252,10,3,3,10,8,5,0,1,0,0,15,16,5,4,1,2,0,1,0,1,0,0,10,540254,2879,6,7,-7,3,-1,0,-1,1,-1
KR_7742418038,14743,16984,227,244,6,9,9,6,6,12,0,1,0,0,17,27,3,1,0,1,0,1,0,1,0,0,10,540211,-2241,-17,-3,3,-6,-1,0,-10,2,-1
KR_7742421070,16117,13160,278,238,8,2,2,8,9,1,0,0,0,0,17,14,3,4,0,0,1,0,0,0,0,0,10,540187,2957,40,6,-6,8,0,0,3,-1,0
KR_7742423904,16500,13047,262,209,8,2,2,8,12,3,1,0,0,0,17,15,3,3,2,1,0,1,1,0,0,0,10,540239,3453,53,6,-6,9,1,0,2,0,1
KR_7742448107,15751,13852,244,274,8,2,2,8,6,1,0,0,0,0,16,22,2,3,0,0,0,1,0,0,0,0,10,540217,1899,-30,6,-6,5,0,0,-6,-1,0
KR_7742448852,15731,15141,296,267,5,5,5,5,6,3,0,1,0,0,16,19,3,4,0,0,0,1,0,1,0,0,10,540237,590,29,0,0,3,-1,0,-3,-1,0
KR_7742451566,16145,12108,283,237,6,0,0,6,12,0,0,0,0,0,36,13,3,2,2,0,1,0,0,0,0,0,10,540197,4037,46,6,-6,12,0,0,23,1,2
KR_7742460741,15551,15673,272,280,5,6,6,5,8,5,0,1,0,0,15,15,3,5,1,0,1,0,0,1,0,0,10,540261,-122,-8,-1,1,3,-1,0,0,-2,1
KR_7742473509,15942,13945,275,269,7,2,2,7,8,1,0,1,0,0,18,17,1,4,1,1,1,0,0,1,0,0,10,540237,1997,6,5,-5,7,-1,0,1,-3,0
KR_7742485764,14934,15738,272,291,4,6,6,4,6,3,0,1,0,0,15,15,2,4,1,0,0,1,0,1,0,0,10,540240,-804,-19,-2,2,3,-1,0,0,-2,1
KR_7742498996,16175,16287,231,248,9,7,7,9,10,7,0,0,0,0,36,18,5,3,1,1,1,0,0,0,0,0,10,540182,-112,-17,2,-2,3,0,0,18,2,0
KR_7742506773,13726,16366,266,288,2,7,7,2,1,9,0,1,0,0,17,34,1,5,0,0,0,1,0,1,0,0,10,540220,-2640,-22,-5,5,-8,-1,0,-17,-4,0
KR_7742523604,14397,14172,260,251,4,4,4,4,2,4,0,1,0,0,13,18,5,2,0,2,1,0,0,1,0,0,10,540195,225,9,0,0,-2,-1,0,-5,3,-2
KR_7742532699,16924,14179,273,273,9,3,3,9,11,8,0,0,0,0,14,16,1,2,3,0,1,0,0,0,0,0,10,540264,2745,0,6,-6,3,0,0,-2,-1,3
KR_7742543294,16764,16176,253,267,9,8,8,9,8,9,0,1,0,0,16,150,1,2,1,0,1,0,0,1,0,0,10,540244,588,-14,1,-1,-1,-1,0,-134,-1,1
KR_7742549899,13476,16913,231,273,3,9,9,3,3,9,0,1,0,0,15,17,1,0,0,0,0,1,0,1,0,0,10,540118,-3437,-42,-6,6,-6,-1,0,-2,1,0
KR_7742564507,17939,15221,230,231,14,6,6,14,14,5,0,0,0,0,16,14,4,2,0,0,1,0,0,0,0,0,10,540270,2718,-1,8,-8,9,0,0,2,2,0
KR_7742567561,13913,16378,232,248,3,8,8,3,5,9,0,1,0,0,15,15,1,7,1,0,0,1,0,1,0,0,10,540241,-2465,-16,-5,5,-4,-1,0,0,-6,1
KR_7742568417,15321,14044,249,271,5,2,2,5,7,2,0,0,0,0,35,18,1,1,3,1,1,0,0,0,0,0,10,540236,1277,-22,3,-3,5,0,0,17,0,2
KR_7742569967,15587,16041,269,258,5,7,7,5,5,10,0,0,0,0,33,19,2,5,1,0,0,1,0,0,0,0,10,540225,-454,11,-2,2,-5,0,0,14,-3,1
KR_7742736811,2754,2951,2,12,0,0,0,0,0,0,0,0,0,0,3,2,0,0,0,0,0,0,0,0,0,0,3,117659,-197,-10,0,0,0,0,0,1,0,0
KR_7742798959,14662,14103,287,297,3,2,2,3,3,1,0,1,0,0,11,36,3,0,1,0,0,1,0,1,0,0,10,540232,559,-10,1,-1,2,-1,0,-25,3,1
KR_7742809740,15545,12978,268,252,6,0,0,6,12,0,0,0,0,0,22,39,4,4,0,1,1,0,0,0,0,0,10,540193,2567,16,6,-6,12,0,0,-17,0,-1
KR_7742831926,14536,15630,244,280,5,6,6,5,2,12,1,0,0,0,15,15,3,2,1,0,1,0,1,0,0,0,10,540204,-1094,-36,-1,1,-10,1,0,0,1,1
KR_7742852460,15195,14584,290,303,5,2,2,5,6,3,0,1,0,0,17,11,2,4,0,0,1,0,0,1,0,0,10,540243,611,-13,3,-3,3,-1,0,6,-2,0
KR_7742857679,15019,14924,248,252,5,5,5,5,6,6,0,0,0,0,15,19,4,1,0,1,0,1,0,0,0,0,10,540212,95,-4,0,0,0,0,0,-4,3,-1
KR_7742859038,17518,15959,259,239,9,9,9,9,12,12,1,0,0,0,14,15,3,1,2,0,1,0,1,0,0,0,10,540260,1559,20,0,0,0,1,0,-1,2,2
KR_7742867453,14757,15091,289,279,3,3,3,3,4,6,0,1,0,0,19,14,2,6,0,1,0,1,0,1,0,0,10,540267,-334,10,0,0,-2,-1,0,5,-4,-1
KR_7742878813,14878,13379,278,259,3,1,1,3,5,1,0,0,0,0,32,20,8,4,0,0,1,0,0,0,0,0,10,540272,1499,19,2,-2,4,0,0,12,4,0
KR_7742885637,15050,17089,255,262,5,9,9,5,4,12,0,1,0,0,33,19,4,2,1,2,0,1,0,1,0,0,10,540298,-2039,-7,-4,4,-8,-1,0,14,2,-1
KR_7742906265,15558,15729,240,267,8,5,5,8,9,9,0,0,0,0,19,20,5,4,1,0,1,0,0,0,0,0,10,540231,-171,-27,3,-3,0,0,0,-1,1,1
KR_7742906668,15941,15510,259,274,6,5,5,6,11,4,0,1,0,0,16,16,4,3,0,2,0,1,0,1,0,0,10,540245,431,-15,1,-1,7,-1,0,0,1,-2
KR_7742912336,14409,15759,234,259,5,7,7,5,7,9,0,0,0,0,20,14,4,6,0,0,1,0,0,0,0,0,10,540224,-1350,-25,-2,2,-2,0,0,6,-2,0
KR_7742924850,15004,15096,259,282,5,5,6,5,4,5,0,0,0,0,37,18,4,4,0,1,0,1,0,0,0,0,10,540225,-92,-23,0,1,-1,0,0,19,0,-1
KR_7742928173,16064,17017,227,230,10,12,12,10,7,11,0,1,0,0,15,33,2,3,1,2,0,1,0,1,0,0,10,540220,-953,-3,-2,2,-4,-1,0,-18,-1,-1
KR_7742956066,16193,15377,269,275,7,5,5,7,8,8,0,0,0,0,21,15,2,4,0,1,1,0,0,0,0,0,10,540291,816,-6,2,-2,0,0,0,6,-2,-1
KR_7742962431,14569,15720,248,260,4,5,6,6,6,9,0,1,0,0,90,14,2,2,1,2,0,1,0,1,0,0,10,540238,-1151,-12,-1,0,-3,-1,0,76,0,-1
KR_7742966721,16184,15688,270,270,6,6,6,6,9,8,0,1,0,0,16,36,2,1,1,1,0,1,0,1,0,0,10,540249,496,0,0,0,1,-1,0,-20,1,0
KR_7742981264,13573,13583,277,277,1,1,1,1,1,1,0,1,0,0,14,18,5,1,0,1,1,0,0,1,0,0,10,540243,-10,0,0,0,0,-1,0,-4,4,-1
KR_7743013820,15624,15228,265,244,6,5,5,6,4,8,0,0,0,0,28,18,5,1,1,0,1,0,0,0,0,0,10,540303,396,21,1,-1,-4,0,0,10,4,1
KR_7743013950,14843,12997,299,251,4,1,1,4,4,1,0,1,0,0,15,13,5,2,0,0,1,0,0,1,0,0,10,540221,1846,48,3,-3,3,-1,0,2,3,0
KR_7743014577,16630,17231,223,212,11,11,11,11,12,15,0,1,0,0,17,14,4,5,0,1,1,0,0,1,0,0,10,540122,-601,11,0,0,-3,-1,0,3,-1,-1
KR_7743017684,13963,14217,259,262,3,3,3,3,4,4,0,0,0,0,36,19,6,2,0,1,1,0,0,0,0,0,10,540251,-254,-3,0,0,0,0,0,17,4,-1
KR_7743026353,15814,14305,291,283,5,2,2,6,6,1,0,0,0,0,30,18,3,0,2,1,1,0,0,0,0,0,10,540278,1509,8,3,-4,5,0,0,12,3,1
KR_7743058201,14640,15182,278,269,3,5,5,3,3,6,0,1,0,0,13,17,0,2,0,0,0,1,0,1,0,0,10,540222,-542,9,-2,2,-3,-1,0,-4,-2,0
KR_7743070289,14630,13842,269,254,4,3,3,4,4,2,0,1,0,0,16,18,9,2,1,0,1,0,0,1,0,0,10,540290,788,15,1,-1,2,-1,0,-2,7,1
KR_7743102224,14933,15973,245,283,5,6,6,5,7,6,0,0,0,0,16,52,5,1,0,1,0,1,0,0,0,0,10,540276,-1040,-38,-1,1,1,0,0,-36,4,-1
KR_7743115889,15198,15860,267,262,5,6,6,5,3,9,0,0,0,0,17,33,1,2,0,1,1,0,0,0,0,0,10,540190,-662,5,-1,1,-6,0,0,-16,-1,-1
KR_7743119533,14638,14539,261,292,4,3,3,4,6,3,0,0,0,0,16,12,2,4,0,0,1,0,0,0,0,0,10,540284,99,-31,1,-1,3,0,0,4,-2,0
KR_7743119534,14332,14730,208,272,5,3,3,5,5,4,0,0,0,0,15,14,1,1,1,2,1,0,0,0,0,0,10,540192,-398,-64,2,-2,1,0,0,1,0,-1
KR_7743139464,13081,16024,255,293,1,6,6,1,2,12,0,1,0,0,36,31,4,3,0,0,0,1,0,1,0,0,10,540218,-2943,-38,-5,5,-10,-1,0,5,1,0
KR_7743154942,15036,13923,281,269,4,1,1,4,6,1,0,0,0,0,13,17,3,5,0,1,1,0,0,0,0,0,10,540232,1113,12,3,-3,5,0,0,-4,-2,-1
KR_7743177890,14713,16887,217,246,5,12,13,5,12,11,0,1,0,0,18,12,0,5,0,2,0,1,0,1,0,0,10,540231,-2174,-29,-7,8,1,-1,0,6,-5,-2
KR_7743180091,16779,15703,265,251,9,7,7,9,9,5,1,0,0,0,16,18,2,2,0,0,1,0,1,0,0,0,10,540239,1076,14,2,-2,4,1,0,-2,0,0
KR_7743182845,14782,13431,290,280,3,1,2,3,6,2,0,1,0,0,22,16,1,6,0,0,1,0,0,1,0,0,10,540223,1351,10,2,-1,4,-1,0,6,-5,0
KR_7743206068,15489,15324,259,274,5,4,4,5,9,5,0,1,0,0,39,95,3,4,0,1,0,1,0,1,0,0,10,540220,165,-15,1,-1,4,-1,0,-56,-1,-1
KR_7743206168,15294,14330,228,243,9,4,4,9,2,4,0,0,0,0,16,14,1,2,2,1,1,0,0,0,0,0,10,540220,964,-15,5,-5,-2,0,0,2,-1,1
KR_7743226605,15131,15830,274,248,5,8,8,5,4,10,0,0,0,0,20,15,6,6,0,0,1,0,0,0,0,0,10,540206,-699,26,-3,3,-6,0,0,5,0,0
KR_7743247268,13116,14965,281,297,0,4,4,0,0,7,1,0,0,0,16,15,0,4,0,0,0,1,1,0,0,0,10,540210,-1849,-16,-4,4,-7,1,0,1,-4,0
KR_7743256061,16019,15161,242,280,8,4,4,8,11,5,0,0,0,0,15,18,2,2,0,1,1,0,0,0,0,0,10,540208,858,-38,4,-4,6,0,0,-3,0,-1
KR_7743287060,16503,13376,285,241,7,2,2,7,5,1,0,0,0,0,17,15,2,3,2,0,1,0,0,0,0,0,10,540077,3127,44,5,-5,4,0,0,2,-1,2
KR_7743291078,14237,14468,242,241,5,5,5,5,4,6,0,0,0,0,13,16,5,2,0,1,0,1,0,0,0,0,10,540251,-231,1,0,0,-2,0,0,-3,3,-1
KR_7743316126,16620,13988,276,273,8,2,2,8,8,2,0,0,0,0,20,18,4,1,1,0,1,0,0,0,0,0,10,540222,2632,3,6,-6,6,0,0,2,3,1
KR_7743337387,15234,16504,271,285,4,8,8,4,8,7,0,0,0,0,14,22,4,4,0,0,0,1,0,0,0,0,10,540257,-1270,-14,-4,4,1,0,0,-8,0,0
KR_7743342916,15472,16524,257,210,5,11,11,5,6,12,0,0,0,0,13,13,1,2,0,0,0,1,0,0,0,0,10,540270,-1052,47,-6,6,-6,0,0,0,-1,0
KR_7743356300,15413,17616,249,270,6,10,10,6,6,14,1,0,0,0,12,112,2,3,2,0,0,1,1,0,0,0,10,540231,-2203,-21,-4,4,-8,1,0,-100,-1,2
KR_7743363589,16847,16246,242,230,11,9,9,11,8,12,0,0,0,0,23,25,2,5,1,0,1,0,0,0,0,0,10,540244,601,12,2,-2,-4,0,0,-2,-3,1
KR_7743384196,16709,16755,231,227,10,10,10,10,11,15,0,0,0,0,20,37,3,2,2,1,1,0,0,0,0,0,10,540256,-46,4,0,0,-4,0,0,-17,1,1
KR_7743412949,14852,14909,302,294,3,4,4,3,4,5,0,1,0,0,18,20,7,2,0,1,0,1,0,1,0,0,10,540232,-57,8,-1,1,-1,-1,0,-2,5,-1
KR_7743425587,17266,13603,283,237,9,3,3,9,16,2,1,0,0,0,16,108,7,1,2,0,1,0,1,0,0,0,10,540277,3663,46,6,-6,14,1,0,-92,6,2
KR_7743442291,13822,16076,248,244,2,8,8,2,3,10,0,0,0,0,17,22,4,2,1,1,0,1,0,0,0,0,10,540219,-2254,4,-6,6,-7,0,0,-5,2,0
KR_7743460884,16211,17589,246,237,7,12,12,7,8,14,0,0,0,0,27,34,5,6,1,2,0,1,0,0,0,0,10,540255,-1378,9,-5,5,-6,0,0,-7,-1,-1
KR_7743500377,17997,15403,268,250,12,6,6,12,11,5,1,0,0,0,20,20,4,3,0,0,1,0,1,0,0,0,10,540225,2594,18,6,-6,6,1,0,0,1,0
KR_7743506540,14828,13608,284,268,3,1,1,3,5,0,0,1,0,0,19,107,4,4,0,0,1,0,0,1,0,0,10,540100,1220,16,2,-2,5,-1,0,-88,0,0
KR_7743509413,14143,15552,252,260,3,5,5,3,3,5,0,0,0,0,15,18,0,6,3,1,0,1,0,0,0,0,10,540195,-1409,-8,-2,2,-2,0,0,-3,-6,2
KR_7743514791,15278,14861,262,267,6,3,4,6,3,3,0,0,0,0,17,14,0,5,0,0,0,1,0,0,0,0,10,540242,417,-5,3,-2,0,0,0,3,-5,0
KR_7743517521,13610,19024,218,274,4,17,17,4,3,16,0,1,0,0,13,15,3,0,0,2,0,1,0,1,0,0,10,540171,-5414,-56,-13,13,-13,-1,0,-2,3,-2
KR_7743537311,16536,16523,256,260,11,8,8,11,6,8,0,1,0,0,11,10,4,2,1,0,1,0,0,1,0,0,10,540270,13,-4,3,-3,-2,-1,0,1,2,1
KR_7743537590,15262,15782,260,281,6,6,7,6,5,7,0,0,0,0,34,17,5,1,0,1,0,1,0,0,0,0,10,540174,-520,-21,0,1,-2,0,0,17,4,-1
KR_7743582356,14057,14974,256,291,3,4,4,3,5,6,0,0,0,0,16,362,4,2,0,0,0,1,0,0,0,0,10,540269,-917,-35,-1,1,-1,0,0,-346,2,0
KR_7743591436,15142,15454,254,276,6,5,5,6,5,7,0,0,0,0,18,42,1,2,0,1,0,1,0,0,0,0,10,540268,-312,-22,1,-1,-2,0,0,-24,-1,-1
KR_7743594189,13960,15123,229,272,4,5,5,4,4,8,0,0,0,0,16,15,2,4,0,1,0,1,0,0,0,0,10,540212,-1163,-43,-1,1,-4,0,0,1,-2,-1
KR_7743599650,14758,14943,265,251,5,5,5,6,4,7,0,0,0,0,15,15,2,0,1,1,0,1,0,0,0,0,10,540212,-185,14,0,-1,-3,0,0,0,2,0
KR_7743609651,15050,13524,266,280,5,1,1,5,5,1,0,0,0,0,51,17,4,3,0,0,1,0,0,0,0,0,10,540224,1526,-14,4,-4,4,0,0,34,1,0
KR_7743617614,14301,15480,250,260,4,5,5,4,3,11,0,1,0,0,14,14,2,4,0,0,0,1,0,1,0,0,10,540206,-1179,-10,-1,1,-8,-1,0,0,-2,0
KR_7743648003,14200,15069,261,256,3,4,4,3,2,5,0,0,0,0,17,15,5,3,1,0,0,1,0,0,0,0,10,540219,-869,5,-1,1,-3,0,0,2,2,1
KR_7743665709,14598,14710,291,276,4,3,3,4,2,4,0,0,0,0,15,18,2,2,1,1,1,0,0,0,0,0,10,540223,-112,15,1,-1,-2,0,0,-3,0,0
KR_7743679953,15570,16228,261,264,5,9,9,5,5,5,0,0,0,0,16,36,3,5,2,1,1,0,0,0,0,0,10,540206,-658,-3,-4,4,0,0,0,-20,-2,1
KR_7743689599,16776,13869,272,241,9,4,4,9,9,1,1,0,0,0,14,22,3,1,0,0,0,1,1,0,0,0,10,540238,2907,31,5,-5,8,1,0,-8,2,0
KR_7743697864,15419,14598,277,280,4,3,3,4,3,1,0,0,0,0,103,17,5,2,2,1,1,0,0,0,0,0,10,540209,821,-3,1,-1,2,0,0,86,3,1
KR_7743699106,14545,15734,260,265,4,6,7,4,3,5,0,0,0,0,18,14,1,3,0,1,1,0,0,0,0,0,10,540233,-1189,-5,-2,3,-2,0,0,4,-2,-1
KR_7743713114,14967,12327,306,212,3,2,2,3,2,2,0,1,0,0,13,35,3,2,1,0,1,0,0,1,0,0,10,540290,2640,94,1,-1,0,-1,0,-22,1,1
KR_7743723618,15289,16374,240,267,7,7,7,7,5,9,0,0,0,0,16,16,2,1,0,0,1,0,0,0,0,0,10,540302,-1085,-27,0,0,-4,0,0,0,1,0
KR_7743745860,16347,16417,206,224,10,11,11,10,16,16,0,0,0,0,17,16,1,5,0,0,1,0,0,0,0,0,10,540253,-70,-18,-1,1,0,0,0,1,-4,0
KR_7743752621,14573,17541,216,259,5,9,9,5,8,13,1,0,0,0,15,19,1,4,0,2,1,0,1,0,0,0,10,540085,-2968,-43,-4,4,-5,1,0,-4,-3,-2
KR_7743766349,15371,15813,265,287,6,5,5,6,5,5,0,1,0,0,17,14,2,2,0,2,1,0,0,1,0,0,10,540216,-442,-22,1,-1,0,-1,0,3,0,-2
KR_7743778206,13913,14785,279,260,1,4,4,1,1,8,0,0,0,0,31,16,3,5,1,1,0,1,0,0,0,0,10,540219,-872,19,-3,3,-7,0,0,15,-2,0
KR_7743789926,14532,16651,249,252,4,9,9,4,4,7,0,0,0,0,15,18,3,0,0,2,1,0,0,0,0,0,10,540182,-2119,-3,-5,5,-3,0,0,-3,3,-2
KR_7743823105,13579,15237,260,285,2,4,4,2,5,8,0,0,0,0,31,18,3,5,0,1,0,1,0,0,0,0,10,540266,-1658,-25,-2,2,-3,0,0,13,-2,-1
KR_7743824793,13067,16477,255,294,0,7,7,0,0,17,0,1,0,0,10,46,6,1,1,0,0,1,0,1,0,0,10,540267,-3410,-39,-7,7,-17,-1,0,-36,5,1
KR_7743864291,15339,13400,258,267,7,2,3,7,3,0,0,1,0,0,13,14,1,2,0,0,0,1,0,1,0,0,10,540228,1939,-9,5,-4,3,-1,0,-1,-1,0
KR_7743865327,15611,20421,220,267,6,18,18,6,4,30,0,1,0,0,11,38,2,2,0,3,0,1,0,1,0,0,10,540188,-4810,-47,-12,12,-26,-1,0,-27,0,-3
KR_7743872084,14256,13600,272,251,3,2,2,3,4,3,0,0,0,0,18,38,1,5,0,0,1,0,0,0,0,0,10,540229,656,21,1,-1,1,0,0,-20,-4,0
KR_7743891799,15351,16683,260,249,6,10,10,6,11,14,0,0,0,0,14,14,4,2,0,0,1,0,0,0,0,0,10,540256,-1332,11,-4,4,-3,0,0,0,2,0
KR_7743898074,14458,13707,270,280,3,1,1,3,4,2,0,0,0,0,16,19,5,7,0,0,1,0,0,0,0,0,10,540251,751,-10,2,-2,2,0,0,-3,-2,0
KR_7743898673,15433,16730,237,276,8,9,9,8,4,4,0,0,0,0,19,18,2,5,1,0,0,1,0,0,0,0,10,540218,-1297,-39,-1,1,0,0,0,1,-3,1
KR_7743922429,14243,14515,273,273,2,4,4,2,3,1,0,1,0,0,22,24,3,5,1,1,0,1,0,1,0,0,10,540254,-272,0,-2,2,2,-1,0,-2,-2,0
KR_7743930821,15901,15794,256,236,7,7,7,7,7,15,0,0,0,0,39,34,6,7,2,1,0,1,0,0,0,0,10,540257,107,20,0,0,-8,0,0,5,-1,1
KR_7743936790,16846,13465,263,283,10,1,2,10,10,2,0,1,0,0,12,208,4,2,1,0,1,0,0,1,0,0,10,540220,3381,-20,9,-8,8,-1,0,-196,2,1
KR_7743947441,13815,14925,268,274,2,3,3,2,1,3,0,1,0,0,19,17,4,5,2,3,0,1,0,1,0,0,10,540181,-1110,-6,-1,1,-2,-1,0,2,-1,-1
KR_7743950368,14409,15400,230,250,5,6,6,5,10,10,0,0,0,0,17,17,1,3,0,0,1,0,0,0,0,0,10,540214,-991,-20,-1,1,0,0,0,0,-2,0
KR_7743951772,15884,14662,251,295,7,1,1,7,10,1,0,0,0,0,28,14,5,3,0,2,1,0,0,0,0,0,10,540192,1222,-44,6,-6,9,0,0,14,2,-2
KR_7743953261,15072,16117,252,275,5,6,6,5,5,10,0,1,0,0,38,44,5,3,0,1,0,1,0,1,0,0,10,540236,-1045,-23,-1,1,-5,-1,0,-6,2,-1
KR_7743962915,15780,15258,264,293,6,5,5,6,9,2,0,1,0,0,18,11,2,4,1,1,0,1,0,1,0,0,10,540191,522,-29,1,-1,7,-1,0,7,-2,0
KR_7743969420,15592,15405,262,280,6,5,5,6,7,4,0,0,0,0,111,16,3,2,0,0,1,0,0,0,0,0,10,540272,187,-18,1,-1,3,0,0,95,1,0
KR_7743975140,13843,16305,288,265,2,10,10,2,1,6,0,1,0,0,12,58,0,2,0,0,1,0,0,1,0,0,10,540189,-2462,23,-8,8,-5,-1,0,-46,-2,0
KR_7743980209,14989,13165,304,264,3,1,1,3,3,1,0,0,0,0,11,12,3,1,1,0,1,0,0,0,0,0,10,540261,1824,40,2,-2,2,0,0,-1,2,1
KR_7743982333,14205,19936,206,269,6,16,16,7,4,20,0,0,0,0,22,16,7,6,0,0,1,0,0,0,0,0,10,540212,-5731,-63,-10,9,-16,0,0,6,1,0
KR_7743991835,18472,15337,268,214,14,7,7,14,14,8,0,0,0,0,12,8,2,2,1,1,1,0,0,0,0,0,10,540259,3135,54,7,-7,6,0,0,4,0,0
KR_7743992237,16396,14721,285,261,8,4,4,8,10,5,0,0,0,0,16,17,4,3,0,0,0,1,0,0,0,0,10,540180,1675,24,4,-4,5,0,0,-1,1,0
KR_7743997790,15597,14496,299,292,4,2,2,4,6,2,1,0,0,0,19,14,4,3,2,2,0,1,1,0,0,0,10,540215,1101,7,2,-2,4,1,0,5,1,0
KR_7744001007,16426,15385,216,241,10,5,5,10,16,7,1,0,0,0,18,15,4,2,3,0,1,0,1,0,0,0,10,540227,1041,-25,5,-5,9,1,0,3,2,3
KR_7744002896,15662,15503,261,254,7,6,6,7,7,8,0,0,0,0,17,16,6,3,1,0,1,0,0,0,0,0,10,540261,159,7,1,-1,-1,0,0,1,3,1
KR_7744022927,15122,16178,267,263,4,8,8,4,5,5,0,0,0,0,11,16,3,2,1,0,0,1,0,0,0,0,10,540249,-1056,4,-4,4,0,0,0,-5,1,1
KR_7744023821,15332,15463,276,243,5,6,6,5,4,10,0,1,0,0,10,15,2,0,2,0,1,0,0,1,0,0,10,540244,-131,33,-1,1,-6,-1,0,-5,2,2
KR_7744025530,15750,12755,281,237,5,1,1,5,4,0,1,0,0,0,39,19,4,1,1,0,0,1,1,0,0,0,10,540231,2995,44,4,-4,4,1,0,20,3,1
KR_7744041964,14979,13463,235,237,6,2,2,6,9,3,1,0,0,0,20,17,3,2,0,0,1,0,1,0,0,0,10,540107,1516,-2,4,-4,6,1,0,3,1,0
KR_7744046004,14893,13238,272,264,3,1,1,3,6,2,0,1,0,0,14,24,6,0,1,0,1,0,0,1,0,0,10,540196,1655,8,2,-2,4,-1,0,-10,6,1
KR_7744049763,14590,13850,237,258,5,2,2,6,5,2,0,1,0,0,13,18,2,2,1,1,1,0,0,1,0,0,10,540200,740,-21,3,-4,3,-1,0,-5,0,0
KR_7744053703,14253,15916,271,229,2,8,8,2,2,15,1,0,0,0,13,38,6,1,2,0,0,1,1,0,0,0,10,540235,-1663,42,-6,6,-13,1,0,-25,5,2
KR_7744056542,17141,13518,283,252,9,2,2,9,11,2,0,0,0,0,15,19,3,5,0,0,1,0,0,0,0,0,10,540209,3623,31,7,-7,9,0,0,-4,-2,0
KR_7744062470,13676,16012,243,284,3,6,6,4,3,7,0,0,0,0,14,16,3,5,0,0,0,1,0,0,0,0,10,540247,-2336,-41,-3,2,-4,0,0,-2,-2,0
KR_7744067749,14262,15458,256,286,3,4,4,3,6,3,0,0,0,0,38,30,2,5,1,2,0,1,0,0,0,0,10,540249,-1196,-30,-1,1,3,0,0,8,-3,-1
KR_7744072472,17504,13417,313,272,8,1,1,8,13,2,0,0,0,0,16,17,3,0,1,0,1,0,0,0,0,0,10,540281,4087,41,7,-7,11,0,0,-1,3,1
KR_7744078621,16945,14988,309,248,7,7,7,7,8,6,0,0,0,0,18,18,7,1,0,0,0,1,0,0,0,0,10,540207,1957,61,0,0,2,0,0,0,6,0
KR_7744081568,11764,19074,215,276,0,15,15,0,0,17,0,0,0,0,14,25,3,3,0,1,0,1,0,0,0,0,10,540208,-7310,-61,-15,15,-17,0,0,-11,0,-1
KR_7744081730,15468,13783,282,248,4,3,3,4,4,6,0,0,0,0,19,18,1,5,0,0,0,1,0,0,0,0,10,540270,1685,34,1,-1,-2,0,0,1,-4,0
KR_7744084736,18129,14854,282,232,12,6,6,12,12,6,0,1,0,0,10,17,4,1,2,0,1,0,0,1,0,0,10,540270,3275,50,6,-6,6,-1,0,-7,3,2
KR_7744096251,15078,15616,243,250,6,8,8,6,9,8,0,0,0,0,15,13,3,4,0,0,0,1,0,0,0,0,10,540222,-538,-7,-2,2,1,0,0,2,-1,0
KR_7744098561,14068,16090,238,267,4,9,9,4,4,7,0,1,0,0,14,16,2,3,0,0,1,0,0,1,0,0,10,540206,-2022,-29,-5,5,-3,-1,0,-2,-1,0
KR_7744112366,16502,15615,265,265,8,6,6,9,9,6,0,0,0,0,17,15,4,4,3,0,0,1,0,0,0,0,10,540104,887,0,2,-3,3,0,0,2,0,3
KR_7744120741,15784,15407,251,259,7,6,6,7,8,5,0,0,0,0,16,21,1,4,0,0,0,1,0,0,0,0,10,540256,377,-8,1,-1,3,0,0,-5,-3,0
KR_7744121279,14464,15886,249,262,5,6,6,5,3,5,0,1,0,0,31,39,4,3,0,3,1,0,0,1,0,0,10,540210,-1422,-13,-1,1,-2,-1,0,-8,1,-3
KR_7744122121,17417,16472,298,246,9,9,9,9,17,18,0,1,0,0,20,16,1,4,0,0,1,0,0,1,0,0,10,540250,945,52,0,0,-1,-1,0,4,-3,0
KR_7744131679,15522,15287,266,250,5,6,6,5,4,6,0,0,0,0,20,12,1,3,1,0,0,1,0,0,0,0,10,540253,235,16,-1,1,-2,0,0,8,-2,1
KR_7744135976,13953,13461,296,261,0,1,1,0,0,1,0,1,0,0,15,40,5,5,1,0,0,1,0,1,0,0,10,540214,492,35,-1,1,-1,-1,0,-25,0,1
KR_7744137478,17936,16576,279,275,9,7,7,9,9,10,0,1,0,0,13,36,0,3,1,1,0,1,0,1,0,0,10,540251,1360,4,2,-2,-1,-1,0,-23,-3,0
KR_7744142805,14616,15937,229,240,6,8,8,6,9,8,0,1,0,0,19,17,4,3,0,0,0,1,0,1,0,0,10,540235,-1321,-11,-2,2,1,-1,0,2,1,0
KR_7744154209,17292,16104,251,252,10,7,7,10,16,13,0,1,0,0,17,45,6,5,0,1,0,1,0,1,0,0,10,540224,1188,-1,3,-3,3,-1,0,-28,1,-1
KR_7744155270,16817,14114,275,246,9,4,4,9,4,5,1,0,0,0,13,12,1,1,3,0,1,0,1,0,0,0,10,540256,2703,29,5,-5,-1,1,0,1,0,3
KR_7744161004,16358,16128,234,274,8,6,6,8,10,6,0,0,0,0,16,26,3,2,1,0,0,1,0,0,0,0,10,540228,230,-40,2,-2,4,0,0,-10,1,1
KR_7744174843,13359,15056,240,239,2,7,7,2,0,4,0,0,0,0,37,21,5,4,0,0,0,1,0,0,0,0,10,540186,-1697,1,-5,5,-4,0,0,16,1,0
KR_7744175506,15095,15452,263,277,5,6,6,5,9,4,0,0,0,0,17,35,2,2,0,1,1,0,0,0,0,0,10,540200,-357,-14,-1,1,5,0,0,-18,0,-1
KR_7744175760,14986,14319,255,250,5,4,4,5,8,5,0,0,0,0,19,36,2,3,1,2,1,0,0,0,0,0,10,540232,667,5,1,-1,3,0,0,-17,-1,-1
KR_7744184894,15638,14860,218,239,8,5,5,8,11,6,0,0,0,0,18,37,5,5,1,0,1,0,0,0,0,0,10,540195,778,-21,3,-3,5,0,0,-19,0,1
KR_7744187861,16317,16504,258,267,8,8,8,8,8,7,0,1,0,0,53,17,1,4,1,2,0,1,0,1,0,0,10,540261,-187,-9,0,0,1,-1,0,36,-3,-1
KR_7744191477,15813,16322,288,287,5,7,7,5,5,7,0,1,0,0,15,39,8,5,1,1,0,1,0,1,0,0,10,540208,-509,1,-2,2,-2,-1,0,-24,3,0
KR_7744193524,16621,16758,244,195,7,13,13,7,11,11,0,1,0,0,32,35,5,4,1,0,0,1,0,1,0,0,10,540287,-137,49,-6,6,0,-1,0,-3,1,1
KR_7744200788,15800,14124,237,279,7,3,3,7,9,1,0,0,0,0,144,186,4,4,0,0,1,0,0,0,0,0,10,540247,1676,-42,4,-4,8,0,0,-42,0,0
KR_7744204540,14703,15748,268,255,4,7,7,4,3,5,0,1,0,0,25,20,4,6,0,1,0,1,0,1,0,0,10,540234,-1045,13,-3,3,-2,-1,0,5,-2,-1
KR_7744207766,17105,14717,264,249,11,3,3,11,17,5,1,0,0,0,113,17,6,1,1,1,1,0,1,0,0,0,10,540207,2388,15,8,-8,12,1,0,96,5,0
KR_7744209104,14145,15454,272,268,2,5,5,2,1,8,0,0,0,0,18,17,6,5,3,2,1,0,0,0,0,0,10,540202,-1309,4,-3,3,-7,0,0,1,1,1
KR_7744213959,14534,16368,263,290,4,8,8,4,1,7,0,1,0,0,36,15,3,7,0,1,0,1,0,1,0,0,10,540121,-1834,-27,-4,4,-6,-1,0,21,-4,-1
KR_7744214414,14718,15385,258,263,4,5,5,4,6,3,0,0,0,0,35,105,4,2,0,3,1,0,0,0,0,0,10,540213,-667,-5,-1,1,3,0,0,-70,2,-3
KR_7744218008,14586,16642,259,285,4,9,9,4,4,6,0,0,0,0,17,27,2,3,0,2,0,1,0,0,0,0,10,540230,-2056,-26,-5,5,-2,0,0,-10,-1,-2
KR_7744219685,15374,15276,244,271,7,6,6,7,7,2,0,0,0,0,31,16,3,3,1,0,0,1,0,0,0,0,10,540220,98,-27,1,-1,5,0,0,15,0,1
KR_7744238490,14511,16063,283,301,3,5,5,4,4,5,0,0,0,0,37,17,5,2,0,1,0,1,0,0,0,0,10,540267,-1552,-18,-2,1,-1,0,0,20,3,-1
KR_7744241898,15344,17883,273,287,5,11,12,5,3,10,0,0,0,0,11,26,3,2,0,0,1,0,0,0,0,0,10,540273,-2539,-14,-6,7,-7,0,0,-15,1,0
KR_7744253220,14967,13907,283,281,4,2,2,4,7,2,0,0,0,0,14,17,4,1,0,0,0,1,0,0,0,0,10,540189,1060,2,2,-2,5,0,0,-3,3,0
KR_7744260283,15792,15127,264,252,6,7,7,6,8,7,0,1,0,0,17,15,2,3,0,0,1,0,0,1,0,0,10,540084,665,12,-1,1,1,-1,0,2,-1,0
KR_7744261907,15839,14238,252,265,7,3,3,7,9,4,0,0,0,0,42,19,7,6,1,0,0,1,0,0,0,0,10,540225,1601,-13,4,-4,5,0,0,23,1,1
KR_7744265583,16548,14532,272,287,7,2,2,7,8,4,0,1,0,0,40,15,6,4,0,0,1,0,0,1,0,0,10,540172,2016,-15,5,-5,4,-1,0,25,2,0
KR_7744274930,15824,14142,216,209,8,4,4,8,13,7,0,0,0,0,15,17,1,3,3,1,0,1,0,0,0,0,10,540202,1682,7,4,-4,6,0,0,-2,-2,2
KR_7744275181,13313,15734,249,254,2,7,7,2,2,6,1,0,0,0,15,17,3,3,1,0,1,0,1,0,0,0,10,540266,-2421,-5,-5,5,-4,1,0,-2,0,1
KR_7744286088,17092,13988,276,215,8,4,4,8,10,6,1,0,0,0,15,13,1,4,2,0,1,0,1,0,0,0,10,540224,3104,61,4,-4,4,1,0,2,-3,2
KR_7744287304,16094,13823,279,273,8,1,1,8,9,2,1,0,0,0,19,36,5,4,1,0,1,0,1,0,0,0,10,540163,2271,6,7,-7,7,1,0,-17,1,1
KR_7744290836,15518,16404,255,265,7,7,7,7,6,7,0,0,0,0,16,16,3,2,0,0,1,0,0,0,0,0,10,540234,-886,-10,0,0,-1,0,0,0,1,0
KR_7744296407,16303,12909,249,266,9,0,0,9,10,0,0,0,0,0,14,20,1,0,2,1,1,0,0,0,0,0,10,540239,3394,-17,9,-9,10,0,0,-6,1,1
KR_7744298513,17472,14411,301,267,8,4,4,8,11,1,1,0,0,0,34,16,6,3,0,1,0,1,1,0,0,0,10,540233,3061,34,4,-4,10,1,0,18,3,-1
KR_7744309821,15715,15894,245,274,7,6,6,7,8,12,0,0,0,0,18,19,4,4,0,0,0,1,0,0,0,0,10,540173,-179,-29,1,-1,-4,0,0,-1,0,0
KR_7744311952,16433,16467,241,224,9,10,10,9,7,5,0,0,0,0,33,15,1,4,1,1,0,1,0,0,0,0,10,540222,-34,17,-1,1,2,0,0,18,-3,0
KR_7744313830,15909,14811,239,240,7,5,5,7,7,7,0,0,0,0,48,16,4,1,1,1,0,1,0,0,0,0,10,540245,1098,-1,2,-2,0,0,0,32,3,0
KR_7744317359,14834,14491,280,276,4,4,4,4,6,6,0,0,0,0,14,15,3,3,1,0,0,1,0,0,0,0,10,540219,343,4,0,0,0,0,0,-1,0,1
KR_7744327703,13552,15301,235,248,3,6,6,3,5,9,1,0,0,0,11,15,3,5,0,1,1,0,1,0,0,0,10,540256,-1749,-13,-3,3,-4,1,0,-4,-2,-1
KR_7744329493,16705,14846,221,207,10,5,5,10,10,6,0,0,0,0,35,12,1,4,0,1,0,1,0,0,0,0,10,540191,1859,14,5,-5,4,0,0,23,-3,-1
KR_7744331873,17214,14360,239,212,12,6,6,12,6,4,0,0,0,0,36,39,10,1,3,1,1,0,0,0,0,0,10,540308,2854,27,6,-6,2,0,0,-3,9,2
KR_7744340506,16266,14687,252,247,8,4,4,8,8,6,0,0,0,0,15,10,2,4,2,0,1,0,0,0,0,0,10,540236,1579,5,4,-4,2,0,0,5,-2,2
KR_7744343418,15057,15765,288,269,4,6,6,4,4,5,1,0,0,0,17,16,2,4,0,0,0,1,1,0,0,0,10,540238,-708,19,-2,2,-1,1,0,1,-2,0
KR_7744354222,15322,17622,249,234,6,13,13,6,7,9,0,0,0,0,12,19,3,2,2,0,1,0,0,0,0,0,10,540204,-2300,15,-7,7,-2,0,0,-7,1,2
KR_7744356655,14303,14561,257,265,3,4,4,3,9,1,0,1,0,0,14,24,1,3,1,1,0,1,0,1,0,0,10,540204,-258,-8,-1,1,8,-1,0,-10,-2,0
KR_7744361923,16357,18130,238,233,9,13,13,9,9,16,0,0,0,0,13,39,4,2,0,3,0,1,0,0,0,0,10,540242,-1773,5,-4,4,-7,0,0,-26,2,-3
KR_7744378783,16047,14175,220,253,9,4,4,9,15,1,0,0,0,0,17,11,4,4,2,1,1,0,0,0,0,0,10,540208,1872,-33,5,-5,14,0,0,6,0,1
KR_7744399569,14006,15302,255,249,3,6,6,3,6,5,0,0,0,0,16,17,3,2,0,1,0,1,0,0,0,0,10,540088,-1296,6,-3,3,1,0,0,-1,1,-1
KR_7744422716,16094,15926,276,228,8,8,9,8,4,13,0,0,0,0,18,15,2,5,1,1,0,1,0,0,0,0,10,540177,168,48,0,1,-9,0,0,3,-3,0
KR_7744453860,15381,15345,266,278,6,6,6,7,5,1,0,1,0,0,16,14,3,2,0,0,0,1,0,1,0,0,10,540219,36,-12,0,-1,4,-1,0,2,1,0
KR_7744466854,15700,15809,212,253,9,7,7,9,6,10,0,0,0,0,18,58,3,3,1,0,1,0,0,0,0,0,10,540233,-109,-41,2,-2,-4,0,0,-40,0,1
KR_7744503651,14697,15536,262,287,4,6,6,4,5,4,0,1,0,0,19,14,4,3,0,0,0,1,0,1,0,0,10,540258,-839,-25,-2,2,1,-1,0,5,1,0
KR_7744517223,14951,15693,255,236,5,7,7,5,7,20,0,1,0,0,19,16,2,0,0,0,1,0,0,1,0,0,10,540200,-742,19,-2,2,-13,-1,0,3,2,0
KR_7744533868,15083,15307,223,252,5,6,6,5,6,9,0,1,0,0,11,15,2,1,0,1,1,0,0,1,0,0,10,540240,-224,-29,-1,1,-3,-1,0,-4,1,-1
KR_7744550716,15850,17169,246,246,8,11,11,8,7,11,0,1,0,0,27,21,5,4,0,1,0,1,0,1,0,0,10,540201,-1319,0,-3,3,-4,-1,0,6,1,-1
KR_7744571283,16489,15186,306,278,7,4,5,7,6,4,0,0,0,0,16,114,4,2,1,0,1,0,0,0,0,0,10,540235,1303,28,3,-2,2,0,0,-98,2,1
KR_7744574688,15891,15974,276,240,5,9,10,5,8,10,1,0,0,0,15,18,3,1,0,0,0,1,1,0,0,0,10,540271,-83,36,-4,5,-2,1,0,-3,2,0
KR_7744574815,15655,15664,241,252,7,7,7,7,10,7,0,0,0,0,48,27,4,5,2,0,1,0,0,0,0,0,10,540251,-9,-11,0,0,3,0,0,21,-1,2
KR_7744577434,13668,15766,275,303,1,4,4,1,1,3,1,0,0,0,17,14,2,4,0,1,1,0,1,0,0,0,10,540214,-2098,-28,-3,3,-2,1,0,3,-2,-1
KR_7744589895,14900,15566,260,254,4,6,6,4,9,5,0,0,0,0,32,14,2,2,1,0,1,0,0,0,0,0,10,540246,-666,6,-2,2,4,0,0,18,0,1
KR_7744597876,15389,16275,274,290,5,8,8,5,4,6,0,0,0,0,15,17,1,3,1,1,0,1,0,0,0,0,10,540206,-886,-16,-3,3,-2,0,0,-2,-2,0
KR_7744598095,16839,14917,253,225,11,5,5,11,9,7,0,0,0,0,18,19,2,1,0,1,1,0,0,0,0,0,10,540257,1922,28,6,-6,2,0,0,-1,1,-1
KR_7744621153,15663,13810,279,243,5,3,3,5,7,6,0,0,0,0,15,22,4,6,1,0,0,1,0,0,0,0,10,540102,1853,36,2,-2,1,0,0,-7,-2,1
KR_7744629697,14533,15983,270,280,3,6,6,3,2,10,0,1,0,0,17,13,1,3,1,0,1,0,0,1,0,0,10,540253,-1450,-10,-3,3,-8,-1,0,4,-2,1
KR_7744637726,15643,14459,270,275,6,3,3,6,4,2,0,0,0,0,19,150,8,5,1,0,1,0,0,0,0,0,10,540208,1184,-5,3,-3,2,0,0,-131,3,1
KR_7744647480,16187,14460,312,267,5,3,3,5,7,3,1,0,0,0,18,48,5,3,1,0,1,0,1,0,0,0,10,540227,1727,45,2,-2,4,1,0,-30,2,1
KR_7744649705,14877,15893,245,272,6,6,6,6,5,6,0,1,0,0,35,16,2,2,0,3,0,1,0,1,0,0,10,540247,-1016,-27,0,0,-1,-1,0,19,0,-3
KR_7744654673,14263,15583,266,249,3,7,7,3,3,7,0,0,0,0,11,14,3,1,0,2,1,0,0,0,0,0,10,540266,-1320,17,-4,4,-4,0,0,-3,2,-2
KR_7744684501,17418,13744,311,244,8,2,2,8,8,3,1,0,0,0,17,27,2,0,3,1,1,0,1,0,0,0,10,540230,3674,67,6,-6,5,1,0,-10,2,2
KR_7744688936,16059,15219,254,278,8,5,5,8,9,3,0,0,0,0,16,12,2,3,0,0,1,0,0,0,0,0,10,540194,840,-24,3,-3,6,0,0,4,-1,0
KR_7744692039,14833,13937,271,262,4,3,3,4,3,3,0,0,0,0,29,13,3,0,1,0,0,1,0,0,0,0,10,540213,896,9,1,-1,0,0,0,16,3,1
KR_7744706208,15498,14397,260,267,7,2,2,7,5,2,0,1,0,0,16,13,3,5,0,1,0,1,0,1,0,0,10,540184,1101,-7,5,-5,3,-1,0,3,-2,-1
KR_7744725102,15678,16127,263,260,5,9,9,5,4,11,0,0,0,0,27,14,2,2,0,0,0,1,0,0,0,0,10,540223,-449,3,-4,4,-7,0,0,13,0,0
KR_7744744207,15324,16168,277,302,5,5,5,5,6,6,0,1,0,0,18,25,2,4,0,0,1,0,0,1,0,0,10,540128,-844,-25,0,0,0,-1,0,-7,-2,0
KR_7744755751,15188,14964,258,261,6,5,5,6,6,4,0,0,0,0,45,17,3,6,0,0,1,0,0,0,0,0,10,540253,224,-3,1,-1,2,0,0,28,-3,0
KR_7744772518,17038,13166,303,268,9,0,0,9,8,0,0,1,0,0,22,17,5,2,0,0,1,0,0,1,0,0,10,540209,3872,35,9,-9,8,-1,0,5,3,0
KR_7744799110,15517,14875,234,238,7,6,6,7,13,7,0,0,0,0,19,19,1,4,0,1,0,1,0,0,0,0,10,540101,642,-4,1,-1,6,0,0,0,-3,-1
KR_7744809155,14981,16346,257,253,4,8,8,4,4,8,1,0,0,0,15,19,0,1,0,2,1,0,1,0,0,0,10,540213,-1365,4,-4,4,-4,1,0,-4,-1,-2
KR_7744813611,15153,16313,255,274,6,8,8,6,5,6,0,0,0,0,15,108,5,2,0,0,0,1,0,0,0,0,10,540247,-1160,-19,-2,2,-1,0,0,-93,3,0
KR_7744814791,15386,17160,266,274,5,9,9,5,5,14,0,1,0,0,18,20,3,2,1,0,1,0,0,1,0,0,10,540269,-1774,-8,-4,4,-9,-1,0,-2,1,1
KR_7744854652,16444,13340,273,247,7,2,2,7,10,2,0,0,0,0,16,118,3,2,1,1,1,0,0,0,0,0,10,540201,3104,26,5,-5,8,0,0,-102,1,0
KR_7744862788,13674,15235,276,265,2,5,5,2,1,8,1,0,0,0,19,16,4,3,0,0,0,1,1,0,0,0,10,540216,-1561,11,-3,3,-7,1,0,3,1,0
KR_7744863435,18299,14984,260,260,12,4,4,12,13,4,0,0,0,0,18,18,4,3,0,0,0,1,0,0,0,0,10,540210,3315,0,8,-8,9,0,0,0,1,0
KR_7744866444,15344,15160,306,258,4,6,6,4,5,5,1,0,0,0,14,51,4,2,0,0,1,0,1,0,0,0,10,540255,184,48,-2,2,0,1,0,-37,2,0
KR_7744879616,14474,15354,243,252,4,6,6,4,7,12,0,1,0,0,18,100,6,3,0,1,0,1,0,1,0,0,10,540238,-880,-9,-2,2,-5,-1,0,-82,3,-1
KR_7744900258,15237,15810,243,263,6,7,7,6,5,9,0,1,0,0,14,19,5,2,0,0,0,1,0,1,0,0,10,540243,-573,-20,-1,1,-4,-1,0,-5,3,0
KR_7744907497,15036,14193,290,252,3,3,3,3,8,2,1,0,0,0,17,18,4,1,1,0,0,1,1,0,0,0,10,540213,843,38,0,0,6,1,0,-1,3,1
KR_7744945826,16014,15347,278,275,6,5,5,6,10,9,0,0,0,0,18,18,3,3,1,0,1,0,0,0,0,0,10,540267,667,3,1,-1,1,0,0,0,0,1
KR_7744955805,14999,17193,233,263,5,10,10,5,7,13,0,0,0,0,16,38,6,3,0,1,0,1,0,0,0,0,10,540087,-2194,-30,-5,5,-6,0,0,-22,3,-1
KR_7744979267,14867,15431,258,255,4,6,6,4,8,5,0,0,0,0,25,19,5,5,0,1,0,1,0,0,0,0,10,540194,-564,3,-2,2,3,0,0,6,0,-1
KR_7745007360,14610,14139,301,283,2,2,2,2,2,4,0,1,0,0,18,18,2,6,0,0,0,1,0,1,0,0,10,540207,471,18,0,0,-2,-1,0,0,-4,0
KR_7745021707,14688,12719,277,264,3,0,0,3,4,0,0,1,0,0,16,16,0,3,1,0,1,0,0,1,0,0,10,540211,1969,13,3,-3,4,-1,0,0,-3,1
KR_7745054163,14579,13288,274,251,3,2,2,3,3,3,0,1,0,0,15,13,3,2,0,0,1,0,0,1,0,0,10,540192,1291,23,1,-1,0,-1,0,2,1,0
KR_7745054666,14408,14360,304,315,1,1,1,1,2,1,0,0,0,0,14,16,2,3,0,1,1,0,0,0,0,0,10,540237,48,-11,0,0,1,0,0,-2,-1,-1
KR_7745056911,17455,18103,281,281,9,11,11,9,10,10,0,0,0,0,107,13,6,3,1,2,0,1,0,0,0,0,10,540299,-648,0,-2,2,0,0,0,94,3,-1
KR_7745081978,16208,15196,280,273,7,5,5,7,6,3,0,1,0,0,13,16,6,4,0,0,1,0,0,1,0,0,10,540198,1012,7,2,-2,3,-1,0,-3,2,0
KR_7745100934,14507,15942,263,267,4,6,6,4,3,9,0,0,0,0,16,28,4,4,0,2,0,1,0,0,0,0,10,540302,-1435,-4,-2,2,-6,0,0,-12,0,-2
KR_7745125209,15182,15284,294,296,3,3,3,3,4,5,0,0,0,0,19,16,0,2,1,0,0,1,0,0,0,0,10,540237,-102,-2,0,0,-1,0,0,3,-2,1
KR_7745135139,16030,13568,256,233,9,3,3,9,8,2,0,0,0,0,42,13,1,3,0,0,1,0,0,0,0,0,10,540204,2462,23,6,-6,6,0,0,29,-2,0
KR_7745152548,16731,16236,266,268,9,7,7,9,13,10,0,0,0,0,17,15,2,3,0,0,1,0,0,0,0,0,10,540221,495,-2,2,-2,3,0,0,2,-1,0
KR_7745165992,14936,15523,286,280,4,5,5,4,5,7,0,0,0,0,15,16,4,2,1,1,1,0,0,0,0,0,10,540204,-587,6,-1,1,-2,0,0,-1,2,0
KR_7745177093,14512,15173,259,277,4,4,4,4,2,4,0,0,0,0,18,70,2,2,0,3,1,0,0,0,0,0,10,540220,-661,-18,0,0,-2,0,0,-52,0,-3
KR_7745183712,16066,13818,286,238,6,3,3,6,11,4,1,0,0,0,19,43,5,1,1,0,0,1,1,0,0,0,10,540229,2248,48,3,-3,7,1,0,-24,4,1
KR_7745205778,14644,14962,250,260,5,6,6,5,5,3,0,0,0,0,17,16,1,2,0,0,0,1,0,0,0,0,10,540190,-318,-10,-1,1,2,0,0,1,-1,0
KR_7745227089,16572,16838,257,252,8,11,11,8,10,15,0,1,0,0,14,16,3,0,0,0,0,1,0,1,0,0,10,540216,-266,5,-3,3,-5,-1,0,-2,3,0
KR_7745231648,15820,14153,298,284,5,2,2,5,5,2,1,0,0,0,16,17,4,2,1,0,0,1,1,0,0,0,10,540172,1667,14,3,-3,3,1,0,-1,2,1
KR_7745250206,15018,16086,275,295,5,6,6,5,4,3,0,0,0,0,14,16,1,2,0,2,1,0,0,0,0,0,10,540225,-1068,-20,-1,1,1,0,0,-2,-1,-2
KR_7745265404,17194,15554,230,249,13,7,7,13,18,6,0,0,0,0,33,18,5,2,0,0,1,0,0,0,0,0,10,540209,1640,-19,6,-6,12,0,0,15,3,0
KR_7745290225,13952,14305,246,265,3,3,4,3,2,2,0,0,0,0,17,16,3,2,0,1,1,0,0,0,0,0,10,540270,-353,-19,0,1,0,0,0,1,1,-1
KR_7745292777,14051,14532,250,248,4,4,4,4,4,4,0,0,0,0,16,28,4,3,0,1,0,1,0,0,0,0,10,540231,-481,2,0,0,0,0,0,-12,1,-1
KR_7745295398,13514,15663,251,260,3,5,5,3,3,11,1,0,0,0,16,17,3,4,0,1,0,1,1,0,0,0,10,540227,-2149,-9,-2,2,-8,1,0,-1,-1,-1
KR_7745340884,17082,13315,270,260,10,1,1,10,17,0,0,0,0,0,14,10,2,3,0,0,1,0,0,0,0,0,10,540191,3767,10,9,-9,17,0,0,4,-1,0
KR_7745358347,15129,13971,258,242,6,3,3,6,6,3,1,0,0,0,36,29,1,3,1,0,0,1,1,0,0,0,10,540259,1158,16,3,-3,3,1,0,7,-2,1
KR_7745364166,15750,17972,246,234,7,13,13,7,7,13,0,0,0,0,17,35,2,4,0,2,0,1,0,0,0,0,10,540204,-2222,12,-6,6,-6,0,0,-18,-2,-2
KR_7745374133,15858,14681,273,265,6,4,4,6,6,4,0,1,0,0,17,15,2,4,0,0,1,0,0,1,0,0,10,540200,1177,8,2,-2,2,-1,0,2,-2,0
KR_7745403649,15377,15769,261,246,6,6,6,6,10,10,0,0,0,0,13,17,0,4,0,2,1,0,0,0,0,0,10,540222,-392,15,0,0,0,0,0,-4,-4,-2
KR_7745405330,16537,12908,268,250,10,1,1,10,9,2,0,1,0,0,15,33,5,2,0,0,1,0,0,1,0,0,10,540225,3629,18,9,-9,7,-1,0,-18,3,0
KR_7745409344,14954,13826,259,282,5,1,1,5,6,0,0,0,0,0,16,24,4,3,0,4,1,0,0,0,0,0,10,540281,1128,-23,4,-4,6,0,0,-8,1,-4
KR_7745455515,14943,15531,299,262,3,6,6,3,3,6,0,0,0,0,14,18,3,2,0,1,0,1,0,0,0,0,10,540191,-588,37,-3,3,-3,0,0,-4,1,-1
KR_7745465420,15052,17328,255,271,5,12,12,5,6,8,0,0,0,0,12,16,6,1,0,1,0,1,0,0,0,0,10,540201,-2276,-16,-7,7,-2,0,0,-4,5,-1
KR_7745482361,14077,15229,242,278,5,5,5,5,5,4,0,0,0,0,14,34,3,0,0,1,1,0,0,0,0,0,10,540194,-1152,-36,0,0,1,0,0,-20,3,-1
KR_7745535273,17078,15649,271,247,10,7,7,10,14,8,0,1,0,0,19,14,6,3,1,0,1,0,0,1,0,0,10,540238,1429,24,3,-3,6,-1,0,5,3,1
KR_7745541729,13915,15583,254,270,2,6,6,2,3,5,1,0,0,0,15,15,4,1,0,1,0,1,1,0,0,0,10,540223,-1668,-16,-4,4,-2,1,0,0,3,-1
KR_7745546000,16046,15129,299,277,5,3,3,5,9,4,0,1,0,0,116,19,2,2,2,2,0,1,0,1,0,0,10,540125,917,22,2,-2,5,-1,0,97,0,0
KR_7745558196,15781,17494,281,292,7,10,10,7,6,9,0,0,0,0,14,16,3,3,2,0,0,1,0,0,0,0,10,540218,-1713,-11,-3,3,-3,0,0,-2,0,2
KR_7745567936,16305,14655,234,239,9,4,4,10,17,5,1,0,0,0,14,16,4,1,0,2,1,0,1,0,0,0,10,540263,1650,-5,5,-6,12,1,0,-2,3,-2
KR_7745573652,14030,16120,264,281,2,6,6,2,3,10,0,0,0,0,16,16,5,0,1,1,1,0,0,0,0,0,10,540213,-2090,-17,-4,4,-7,0,0,0,5,0
KR_7745578417,13392,14469,261,298,1,2,2,1,2,2,0,0,0,0,34,16,5,3,1,2,0,1,0,0,0,0,10,540265,-1077,-37,-1,1,0,0,0,18,2,-1
KR_7745585682,13914,14246,298,291,1,2,2,1,0,3,0,1,0,0,13,17,3,0,1,1,0,1,0,1,0,0,10,540251,-332,7,-1,1,-3,-1,0,-4,3,0
KR_7745603298,14852,13801,218,240,8,2,2,9,7,2,0,0,0,0,19,19,4,5,0,0,1,0,0,0,0,0,10,540214,1051,-22,6,-7,5,0,0,0,-1,0
KR_7745615625,14689,14891,278,284,4,3,3,4,3,3,0,0,0,0,16,15,2,1,0,0,0,1,0,0,0,0,10,540134,-202,-6,1,-1,0,0,0,1,1,0
KR_7745617257,13933,15872,273,274,2,5,5,2,1,8,0,0,0,0,17,11,1,6,1,3,0,1,0,0,0,0,10,540231,-1939,-1,-3,3,-7,0,0,6,-5,-2
KR_7745626004,15189,15256,254,274,6,5,5,6,6,6,0,0,0,0,16,34,2,4,0,0,0,1,0,0,0,0,10,540085,-67,-20,1,-1,0,0,0,-18,-2,0
KR_7745628879,16306,16344,275,262,7,7,7,7,12,13,0,1,0,0,15,23,5,2,0,1,1,0,0,1,0,0,10,540097,-38,13,0,0,-1,-1,0,-8,3,-1
KR_7745630630,16078,14355,282,258,8,3,3,8,5,3,0,0,0,0,16,17,1,2,0,0,1,0,0,0,0,0,10,540206,1723,24,5,-5,2,0,0,-1,-1,0
KR_7745668406,14459,15966,257,242,4,8,8,4,4,8,1,0,0,0,15,14,4,3,0,2,1,0,1,0,0,0,10,540233,-1507,15,-4,4,-4,1,0,1,1,-2
KR_7745668531,13643,17035,232,241,4,12,12,4,2,14,0,1,0,0,10,15,4,2,0,0,1,0,0,1,0,0,10,540240,-3392,-9,-8,8,-12,-1,0,-5,2,0
KR_7745676291,14364,16014,267,289,4,6,6,4,5,6,0,0,0,0,19,17,0,1,0,1,0,1,0,0,0,0,10,540172,-1650,-22,-2,2,-1,0,0,2,-1,-1
KR_7745677205,15237,16065,250,277,5,6,6,5,6,8,0,1,0,0,17,21,2,0,0,2,0,1,0,1,0,0,10,540259,-828,-27,-1,1,-2,-1,0,-4,2,-2
KR_7745715784,16770,15610,268,243,9,6,6,9,6,6,0,0,0,0,18,21,4,2,1,1,1,0,0,0,0,0,10,540236,1160,25,3,-3,0,0,0,-3,2,0
KR_7745728491,14459,15834,259,264,4,7,7,4,7,11,1,0,0,0,26,14,1,5,1,0,0,1,1,0,0,0,10,540244,-1375,-5,-3,3,-4,1,0,12,-4,1
KR_7745729307,16069,15656,287,266,6,6,6,6,5,7,0,1,0,0,45,14,4,6,1,1,1,0,0,1,0,0,10,540321,413,21,0,0,-2,-1,0,31,-2,0
KR_7745731858,13665,14938,275,267,1,4,4,1,1,5,0,1,0,0,18,38,3,4,1,0,0,1,0,1,0,0,10,540216,-1273,8,-3,3,-4,-1,0,-20,-1,1
KR_7745741480,16592,15305,280,257,8,6,6,8,9,8,0,0,0,0,91,29,2,6,0,1,0,1,0,0,0,0,10,540225,1287,23,2,-2,1,0,0,62,-4,-1
KR_7745744898,13653,16245,253,267,2,8,8,2,3,13,0,1,0,0,15,20,3,2,0,1,1,0,0,1,0,0,10,540267,-2592,-14,-6,6,-10,-1,0,-5,1,-1
KR_7745752054,13810,16587,269,284,2,9,9,2,3,11,0,1,0,0,13,15,5,4,0,1,0,1,0,1,0,0,10,540237,-2777,-15,-7,7,-8,-1,0,-2,1,-1
KR_7745762790,15923,15165,278,280,5,4,5,5,8,6,0,0,0,0,16,17,5,6,3,0,1,0,0,0,0,0,10,540247,758,-2,1,0,2,0,0,-1,-1,3
KR_7745764837,14406,16054,265,287,3,7,7,3,3,6,0,0,0,0,14,36,4,5,0,0,1,0,0,0,0,0,10,540202,-1648,-22,-4,4,-3,0,0,-22,-1,0
KR_7745770580,15544,14879,239,261,6,4,4,6,8,6,0,0,0,0,19,22,3,2,1,2,1,0,0,0,0,0,10,540244,665,-22,2,-2,2,0,0,-3,1,-1
KR_7745772393,18052,14802,275,251,12,5,5,12,12,5,0,0,0,0,41,12,2,5,2,1,0,1,0,0,0,0,10,540229,3250,24,7,-7,7,0,0,29,-3,1
KR_7745783931,15675,14896,291,281,5,4,4,5,3,4,0,1,0,0,33,20,8,3,0,1,1,0,0,1,0,0,10,540225,779,10,1,-1,-1,-1,0,13,5,-1
KR_7745797648,16570,14406,292,256,7,5,5,7,7,1,0,0,0,0,19,19,3,1,1,0,0,1,0,0,0,0,10,540228,2164,36,2,-2,6,0,0,0,2,1
KR_7745808240,14524,15860,248,247,3,8,8,3,3,10,0,0,0,0,36,41,7,6,0,0,0,1,0,0,0,0,10,540239,-1336,1,-5,5,-7,0,0,-5,1,0
KR_7745810402,15572,14128,286,266,5,2,2,5,4,2,0,0,0,0,16,73,4,3,1,0,1,0,0,0,0,0,10,540268,1444,20,3,-3,2,0,0,-57,1,1
KR_7745821742,13910,17005,256,309,2,8,8,2,2,6,0,0,0,0,18,16,4,3,0,1,0,1,0,0,0,0,10,540269,-3095,-53,-6,6,-4,0,0,2,1,-1
KR_7745823083,15883,17089,277,265,5,10,10,5,8,13,0,1,0,0,15,21,4,3,0,1,0,1,0,1,0,0,10,540139,-1206,12,-5,5,-5,-1,0,-6,1,-1
KR_7745830810,13234,16159,248,280,1,6,6,2,2,7,0,0,0,0,9,28,1,2,0,2,1,0,0,0,0,0,10,540160,-2925,-32,-5,4,-5,0,0,-19,-1,-2
KR_7745833148,14791,16556,264,285,5,7,7,5,5,7,0,0,0,0,16,70,1,4,0,0,1,0,0,0,0,0,10,540225,-1765,-21,-2,2,-2,0,0,-54,-3,0
KR_7745843906,14362,13473,289,283,2,1,1,2,1,1,0,1,0,0,22,107,3,6,0,0,1,0,0,1,0,0,10,540210,889,6,1,-1,0,-1,0,-85,-3,0
KR_7745851788,17122,14370,261,245,9,4,4,9,15,3,0,0,0,0,57,34,5,4,0,1,1,0,0,0,0,0,10,540220,2752,16,5,-5,12,0,0,23,1,-1
KR_7745865200,13948,15355,272,276,2,5,5,2,1,6,0,1,0,0,19,40,4,5,0,1,1,0,0,1,0,0,10,540131,-1407,-4,-3,3,-5,-1,0,-21,-1,-1
KR_7745870726,18161,14933,250,247,13,5,5,14,18,7,0,1,0,0,20,18,1,5,1,0,1,0,0,1,0,0,10,540245,3228,3,8,-9,11,-1,0,2,-4,1
KR_7745874202,14078,14978,298,300,1,3,3,1,0,6,0,0,0,0,16,14,1,5,0,1,0,1,0,0,0,0,10,540216,-900,-2,-2,2,-6,0,0,2,-4,-1
KR_7745874558,15395,15644,224,252,7,6,6,7,10,10,0,0,0,0,17,34,4,5,0,1,0,1,0,0,0,0,10,540207,-249,-28,1,-1,0,0,0,-17,-1,-1
KR_7745875702,14033,17041,261,263,2,11,11,2,1,10,0,0,0,0,34,32,5,3,0,1,0,1,0,0,0,0,10,540177,-3008,-2,-9,9,-9,0,0,2,2,-1
KR_7745880602,14790,15246,263,260,4,5,5,4,3,6,0,0,0,0,17,20,2,4,1,0,0,1,0,0,0,0,10,540171,-456,3,-1,1,-3,0,0,-3,-2,1
KR_7745883464,15520,15149,279,296,6,4,4,7,3,3,0,0,0,0,23,12,2,3,1,0,0,1,0,0,0,0,10,540228,371,-17,2,-3,0,0,0,11,-1,1
KR_7745898088,17134,14777,273,281,9,3,3,9,10,1,0,1,0,0,16,13,2,2,1,0,1,0,0,1,0,0,10,540254,2357,-8,6,-6,9,-1,0,3,0,1
KR_7745902355,15380,14878,266,267,5,3,3,5,7,4,0,0,0,0,16,113,5,4,0,1,0,1,0,0,0,0,10,540236,502,-1,2,-2,3,0,0,-97,1,-1
KR_7745908474,15006,15782,254,277,6,7,7,6,5,6,0,0,0,0,18,14,2,6,0,1,1,0,0,0,0,0,10,540240,-776,-23,-1,1,-1,0,0,4,-4,-1
KR_7745918483,13879,16128,279,280,1,7,7,1,2,8,0,0,0,0,17,12,4,2,0,1,0,1,0,0,0,0,10,540241,-2249,-1,-6,6,-6,0,0,5,2,-1
KR_7745921769,15315,14802,291,267,4,4,4,4,6,7,0,1,0,0,29,18,0,5,1,0,1,0,0,1,0,0,10,540204,513,24,0,0,-1,-1,0,11,-5,1
KR_7745932505,17188,13930,280,248,9,3,3,9,10,2,0,0,0,0,16,18,4,2,0,0,0,1,0,0,0,0,10,540244,3258,32,6,-6,8,0,0,-2,2,0
KR_7745934691,15227,15367,249,255,6,6,6,6,8,13,0,1,0,0,16,15,5,3,0,1,0,1,0,1,0,0,10,540210,-140,-6,0,0,-5,-1,0,1,2,-1
KR_7745938620,13936,16020,280,295,2,5,5,2,1,7,0,0,0,0,15,18,5,5,0,0,0,1,0,0,0,0,10,540286,-2084,-15,-3,3,-6,0,0,-3,0,0
KR_7745946940,15789,15949,271,269,6,7,7,6,7,8,0,1,0,0,34,20,2,3,0,0,0,1,0,1,0,0,10,540265,-160,2,-1,1,-1,-1,0,14,-1,0
KR_7745948921,16081,13998,274,242,7,4,4,7,10,4,0,0,0,0,34,16,4,2,1,0,1,0,0,0,0,0,10,540253,2083,32,3,-3,6,0,0,18,2,1
KR_7745949737,15413,15922,240,274,8,7,7,8,4,6,0,0,0,0,15,15,2,2,0,0,0,1,0,0,0,0,10,540189,-509,-34,1,-1,-2,0,0,0,0,0
KR_7745955988,15458,14586,270,297,6,3,4,6,8,1,0,1,0,0,87,14,3,4,0,1,0,1,0,1,0,0,10,540261,872,-27,3,-2,7,-1,0,73,-1,-1
KR_7745963671,17727,15499,271,211,10,7,7,10,14,8,0,0,0,0,18,16,3,1,1,0,1,0,0,0,0,0,10,540245,2228,60,3,-3,6,0,0,2,2,1
KR_7745963859,17141,13040,301,264,7,0,0,7,13,0,1,0,0,0,20,40,6,6,2,0,1,0,1,0,0,0,10,540224,4101,37,7,-7,13,1,0,-20,0,2
KR_7745971792,15239,17132,278,244,5,11,11,6,4,17,0,1,0,0,15,18,3,2,0,0,0,1,0,1,0,0,10,540253,-1893,34,-6,5,-13,-1,0,-3,1,0
KR_7745979665,14393,15108,290,317,2,2,2,2,4,2,0,0,0,0,37,121,5,5,0,2,1,0,0,0,0,0,10,540223,-715,-27,0,0,2,0,0,-84,0,-2
KR_7745983430,17358,15389,260,250,9,8,8,9,10,3,0,0,0,0,21,40,3,0,0,1,1,0,0,0,0,0,10,540182,1969,10,1,-1,7,0,0,-19,3,-1
KR_7745985579,16348,15406,284,230,7,6,6,7,6,8,0,1,0,0,15,18,2,3,0,0,0,1,0,1,0,0,10,540197,942,54,1,-1,-2,-1,0,-3,-1,0
KR_7745994924,13517,14266,277,260,1,3,3,1,0,4,0,1,0,0,22,40,4,2,0,1,1,0,0,1,0,0,10,540245,-749,17,-2,2,-4,-1,0,-18,2,-1
KR_7746021478,16202,13656,250,245,8,3,3,9,9,2,0,0,0,0,19,17,4,3,0,0,1,0,0,0,0,0,10,540246,2546,5,5,-6,7,0,0,2,1,0
KR_7746032007,15082,15923,227,267,8,6,7,8,9,8,0,1,0,0,21,16,1,4,0,2,0,1,0,1,0,0,10,540182,-841,-40,2,-1,1,-1,0,5,-3,-2
KR_7746042759,15663,15137,257,279,6,4,4,6,11,7,0,0,0,0,18,17,1,6,0,1,0,1,0,0,0,0,10,540086,526,-22,2,-2,4,0,0,1,-5,-1
KR_7746050187,16766,15178,265,229,9,6,6,9,6,7,0,0,0,0,22,19,6,1,2,0,1,0,0,0,0,0,10,540261,1588,36,3,-3,-1,0,0,3,5,2
KR_7746050681,15723,16874,282,289,5,8,8,5,4,8,0,1,0,0,17,15,3,0,0,1,0,1,0,1,0,0,10,540274,-1151,-7,-3,3,-4,-1,0,2,3,-1
KR_7746063060,16194,17076,270,241,8,11,12,8,8,9,0,0,0,0,17,14,2,3,0,0,0,1,0,0,0,0,10,540193,-882,29,-3,4,-1,0,0,3,-1,0
KR_7746068631,14921,14474,256,265,4,3,3,4,5,4,0,0,0,0,27,12,1,5,3,0,1,0,0,0,0,0,10,540244,447,-9,1,-1,1,0,0,15,-4,3
KR_7746070405,15977,13976,286,284,9,2,2,9,11,1,0,0,0,0,107,10,1,4,0,1,0,1,0,0,0,0,10,540204,2001,2,7,-7,10,0,0,97,-3,-1
KR_7746076808,16334,14876,269,239,7,5,5,7,15,8,0,0,0,0,13,14,2,1,0,1,1,0,0,0,0,0,10,540216,1458,30,2,-2,7,0,0,-1,1,-1
KR_7746077168,16655,14615,253,281,9,3,3,9,14,2,0,1,0,0,16,35,0,1,0,1,1,0,0,1,0,0,10,540233,2040,-28,6,-6,12,-1,0,-19,-1,-1
KR_7746087501,15078,14220,255,246,5,4,4,5,7,3,0,0,0,0,29,17,3,4,1,0,1,0,0,0,0,0,10,540274,858,9,1,-1,4,0,0,12,-1,1
KR_7746093516,18895,14053,294,288,12,1,1,12,17,0,0,0,0,0,13,15,3,2,1,1,1,0,0,0,0,0,10,540211,4842,6,11,-11,17,0,0,-2,1,0
KR_7746103785,14248,15150,274,261,2,5,5,2,3,6,0,1,0,0,59,15,3,6,0,2,0,1,0,1,0,0,10,540211,-902,13,-3,3,-3,-1,0,44,-3,-2
KR_7746148049,17371,13324,305,256,8,2,2,8,10,2,1,0,0,0,14,45,4,2,2,0,1,0,1,0,0,0,10,540211,4047,49,6,-6,8,1,0,-31,2,2
KR_7746196132,12977,16101,248,276,1,7,7,1,1,5,0,0,0,0,31,16,1,5,0,0,0,1,0,0,0,0,10,540190,-3124,-28,-6,6,-4,0,0,15,-4,0
KR_7746214510,17081,14758,259,229,9,5,5,9,17,9,0,0,0,0,18,16,1,1,0,0,1,0,0,0,0,0,10,540241,2323,30,4,-4,8,0,0,2,0,0
KR_7746263718,16098,16614,260,266,7,8,8,7,12,13,0,0,0,0,105,42,5,3,1,1,0,1,0,0,0,0,10,540261,-516,-6,-1,1,-1,0,0,63,2,0
KR_7746275746,15825,17829,243,258,7,13,13,7,9,21,0,0,0,0,10,39,5,2,1,2,0,1,0,0,0,0,10,540122,-2004,-15,-6,6,-12,0,0,-29,3,-1
KR_7746289691,16860,13339,264,269,9,1,1,9,11,0,0,0,0,0,39,17,0,2,1,2,1,0,0,0,0,0,10,540263,3521,-5,8,-8,11,0,0,22,-2,-1
KR_7746299521,17792,13771,261,226,11,5,5,11,10,3,0,0,0,0,18,35,2,2,3,0,0,1,0,0,0,0,10,540202,4021,35,6,-6,7,0,0,-17,0,3
KR_7746313058,16355,17319,230,261,9,10,10,10,10,11,0,0,0,0,17,12,1,3,0,1,0,1,0,0,0,0,10,540239,-964,-31,-1,0,-1,0,0,5,-2,-1
KR_7746321003,15327,14150,256,240,6,5,5,6,5,3,0,1,0,0,25,121,0,2,0,0,1,0,0,1,0,0,10,540279,1177,16,1,-1,2,-1,0,-96,-2,0
KR_7746328519,16101,14726,282,263,6,4,4,6,6,4,0,0,0,0,33,25,3,1,1,0,1,0,0,0,0,0,10,540217,1375,19,2,-2,2,0,0,8,2,1
KR_7746328992,15969,14477,271,263,7,4,4,7,7,4,0,1,0,0,14,31,2,2,0,0,1,0,0,1,0,0,10,540202,1492,8,3,-3,3,-1,0,-17,0,0
KR_7746339985,14374,15943,239,268,4,7,7,4,3,5,0,0,0,0,12,19,2,2,0,1,0,1,0,0,0,0,10,540198,-1569,-29,-3,3,-2,0,0,-7,0,-1
KR_7746345723,14472,17873,232,240,5,13,13,5,3,15,0,1,0,0,17,15,5,6,1,0,1,0,0,1,0,0,10,540241,-3401,-8,-8,8,-12,-1,0,2,-1,1
KR_7746353868,15418,16016,290,293,4,5,5,4,7,4,0,0,0,0,33,16,1,3,0,1,1,0,0,0,0,0,10,540246,-598,-3,-1,1,3,0,0,17,-2,-1
KR_7746363805,16036,14161,263,221,6,4,4,6,10,6,1,0,0,0,20,14,2,2,4,0,0,1,1,0,0,0,10,540215,1875,42,2,-2,4,1,0,6,0,4
KR_7746363962,17545,14127,315,274,8,2,2,8,4,3,0,0,0,0,17,38,5,2,2,0,1,0,0,0,0,0,10,540245,3418,41,6,-6,1,0,0,-21,3,2
KR_7746369895,13910,14688,261,272,2,4,4,2,2,7,0,0,0,0,15,24,2,5,0,0,0,1,0,0,0,0,10,540296,-778,-11,-2,2,-5,0,0,-9,-3,0
KR_7746377146,15787,14980,236,242,8,6,6,8,6,7,0,0,0,0,12,32,3,0,1,0,1,0,0,0,0,0,10,540241,807,-6,2,-2,-1,0,0,-20,3,1
KR_7746377869,15271,15125,231,260,6,4,4,6,8,7,0,0,0,0,14,31,3,0,1,0,1,0,0,0,0,0,10,540290,146,-29,2,-2,1,0,0,-17,3,1
KR_7746386442,16466,13562,263,193,10,4,4,10,10,4,1,0,0,0,12,15,2,1,0,0,1,0,1,0,0,0,10,540246,2904,70,6,-6,6,1,0,-3,1,0
KR_7746391186,14573,14029,273,261,4,3,3,4,3,2,1,0,0,0,17,16,3,1,0,0,1,0,1,0,0,0,10,540246,544,12,1,-1,1,1,0,1,2,0
KR_7746403915,14422,15653,281,273,3,5,5,3,2,6,0,0,0,0,37,41,7,3,0,1,1,0,0,0,0,0,10,540208,-1231,8,-2,2,-4,0,0,-4,4,-1
KR_7746406437,16016,15323,275,286,7,5,5,7,10,4,0,0,0,0,16,14,5,3,0,0,0,1,0,0,0,0,10,540224,693,-11,2,-2,6,0,0,2,2,0
KR_7746407414,14801,17883,265,279,4,10,10,4,5,9,0,0,0,0,33,18,6,4,0,0,1,0,0,0,0,0,10,540242,-3082,-14,-6,6,-4,0,0,15,2,0
KR_7746419762,14605,14122,300,267,2,3,3,2,3,3,0,1,0,0,13,14,2,3,1,0,0,1,0,1,0,0,10,540264,483,33,-1,1,0,-1,0,-1,-1,1
KR_7746425730,15329,14972,254,260,6,4,4,6,11,7,0,0,0,0,20,16,4,3,1,0,1,0,0,0,0,0,10,540223,357,-6,2,-2,4,0,0,4,1,1
KR_7746430331,17516,14038,284,230,11,3,3,11,10,2,0,1,0,0,15,12,2,2,0,0,1,0,0,1,0,0,10,540224,3478,54,8,-8,8,-1,0,3,0,0
KR_7746432613,14889,14427,253,263,6,4,4,6,2,5,0,1,0,0,21,19,2,6,1,0,1,0,0,1,0,0,10,540230,462,-10,2,-2,-3,-1,0,2,-4,1
KR_7746444159,15190,16613,252,251,5,9,9,5,7,8,0,0,0,0,12,16,5,0,1,2,0,1,0,0,0,0,10,540196,-1423,1,-4,4,-1,0,0,-4,5,-1
KR_7746447487,15387,14757,267,283,5,3,3,5,4,3,0,1,0,0,19,44,5,6,0,0,1,0,0,1,0,0,10,540274,630,-16,2,-2,1,-1,0,-25,-1,0
KR_7746453166,15344,16414,272,242,5,10,11,5,5,8,0,0,0,0,18,28,5,3,0,0,1,0,0,0,0,0,10,540212,-1070,30,-5,6,-3,0,0,-10,2,0
KR_7746466259,14038,14809,294,274,1,4,4,1,1,7,0,0,0,0,15,18,6,0,0,0,0,1,0,0,0,0,10,540249,-771,20,-3,3,-6,0,0,-3,6,0
KR_7746468500,14220,13943,255,248,4,3,3,4,5,2,1,0,0,0,17,17,1,3,0,1,0,1,1,0,0,0,10,540246,277,7,1,-1,3,1,0,0,-2,-1
KR_7746472787,14244,15100,255,238,4,6,6,4,5,5,0,0,0,0,15,18,4,5,0,1,0,1,0,0,0,0,10,540230,-856,17,-2,2,0,0,0,-3,-1,-1
KR_7746482446,14601,15199,239,275,4,6,6,4,8,5,0,1,0,0,11,74,5,1,0,0,0,1,0,1,0,0,10,540274,-598,-36,-2,2,3,-1,0,-63,4,0
KR_7746485929,14100,14924,265,266,4,5,5,4,0,2,0,0,0,0,40,148,1,3,1,2,1,0,0,0,0,0,10,540239,-824,-1,-1,1,-2,0,0,-108,-2,-1
KR_7746488889,16936,17259,255,283,10,10,10,10,8,10,1,0,0,0,15,17,2,3,1,0,0,1,1,0,0,0,10,540288,-323,-28,0,0,-2,1,0,-2,-1,1
KR_7746510499,14957,15593,277,277,5,5,5,5,1,5,0,0,0,0,18,15,3,7,0,0,1,0,0,0,0,0,10,540238,-636,0,0,0,-4,0,0,3,-4,0
KR_7746511667,14013,13376,305,296,1,0,0,1,0,0,0,0,0,0,37,19,4,2,0,0,1,0,0,0,0,0,10,540252,637,9,1,-1,0,0,0,18,2,0
KR_7746525555,14457,16044,277,230,3,9,9,3,2,12,1,0,0,0,16,22,2,1,1,1,1,0,1,0,0,0,10,540226,-1587,47,-6,6,-10,1,0,-6,1,0
KR_7746529683,16385,14672,269,290,8,3,3,8,11,2,1,0,0,0,35,17,2,3,0,0,1,0,1,0,0,0,10,540239,1713,-21,5,-5,9,1,0,18,-1,0
KR_7746542175,15558,14228,289,267,6,3,3,7,4,2,1,0,0,0,17,18,2,3,2,0,0,1,1,0,0,0,10,540196,1330,22,3,-4,2,1,0,-1,-1,2
KR_7746554829,14949,15031,256,236,6,6,6,6,3,8,0,0,0,0,18,27,2,0,0,0,1,0,0,0,0,0,10,540222,-82,20,0,0,-5,0,0,-9,2,0
KR_7746564877,14711,14460,288,281,3,2,2,3,3,2,0,0,0,0,15,14,3,3,0,2,0,1,0,0,0,0,10,540198,251,7,1,-1,1,0,0,1,0,-2
KR_7746583726,18240,14338,239,229,14,6,6,14,14,2,0,1,0,0,17,44,4,3,2,0,0,1,0,1,0,0,10,540216,3902,10,8,-8,12,-1,0,-27,1,2
KR_7746597811,14076,14644,240,282,3,3,3,3,4,3,0,0,0,0,16,16,3,2,0,0,0,1,0,0,0,0,10,540209,-568,-42,0,0,1,0,0,0,1,0
KR_7746599754,15496,13384,297,261,4,2,2,4,1,0,0,1,0,0,17,40,2,6,3,0,0,1,0,1,0,0,10,540282,2112,36,2,-2,1,-1,0,-23,-4,3
KR_7746612818,15978,14677,268,257,7,4,5,7,7,4,0,0,0,0,12,16,3,1,1,1,1,0,0,0,0,0,10,540232,1301,11,3,-2,3,0,0,-4,2,0
KR_7746622921,15808,15137,266,272,5,3,3,5,9,6,0,0,0,0,16,20,6,1,1,0,1,0,0,0,0,0,10,540202,671,-6,2,-2,3,0,0,-4,5,1
KR_7746631212,14188,16332,229,272,5,7,7,5,4,6,0,0,0,0,13,55,2,1,0,3,1,0,0,0,0,0,10,540236,-2144,-43,-2,2,-2,0,0,-42,1,-3
KR_7746632510,15225,15716,263,246,6,6,6,6,8,7,0,0,0,0,12,26,3,3,0,1,1,0,0,0,0,0,10,540238,-491,17,0,0,1,0,0,-14,0,-1
KR_7746660540,7097,8204,104,140,0,1,1,0,0,0,0,0,0,0,6,6,0,0,0,0,0,1,0,0,0,0,7,330159,-1107,-36,-1,1,0,0,0,0,0,0
KR_7746673520,14196,15071,246,220,4,7,7,4,5,9,1,0,0,0,15,14,1,1,1,2,0,1,1,0,0,0,10,540223,-875,26,-3,3,-4,1,0,1,0,-1
KR_7746710038,14673,15877,233,253,4,7,7,4,7,10,0,0,0,0,16,16,4,5,2,1,0,1,0,0,0,0,10,540227,-1204,-20,-3,3,-3,0,0,0,-1,1
KR_7746711668,14581,15086,237,249,5,5,5,5,7,9,0,1,0,0,37,15,1,3,1,1,1,0,0,1,0,0,10,540235,-505,-12,0,0,-2,-1,0,22,-2,0
KR_7746711803,14554,16262,240,266,5,8,8,5,4,15,0,1,0,0,12,19,6,4,0,1,0,1,0,1,0,0,10,540190,-1708,-26,-3,3,-11,-1,0,-7,2,-1
KR_7746729026,14580,15375,278,265,3,5,5,3,4,8,0,0,0,0,29,14,1,6,0,1,1,0,0,0,0,0,10,540206,-795,13,-2,2,-4,0,0,15,-5,-1
KR_7746738122,16383,17534,245,236,8,12,12,8,7,10,0,0,0,0,13,15,0,2,2,1,1,0,0,0,0,0,10,540261,-1151,9,-4,4,-3,0,0,-2,-2,1
KR_7746741370,16288,16149,271,232,7,9,9,7,8,10,0,0,0,0,20,36,4,2,2,0,0,1,0,0,0,0,10,540279,139,39,-2,2,-2,0,0,-16,2,2
KR_7746757309,14962,13461,223,246,7,2,3,7,2,2,0,0,0,0,33,38,4,3,1,0,1,0,0,0,0,0,10,540231,1501,-23,5,-4,0,0,0,-5,1,1
KR_7746758152,16918,15264,236,246,12,7,7,12,17,4,1,0,0,0,13,32,1,2,3,1,1,0,1,0,0,0,10,540249,1654,-10,5,-5,13,1,0,-19,-1,2
KR_7746769049,15182,16375,266,264,6,9,9,6,2,10,0,0,0,0,18,15,3,2,0,0,0,1,0,0,0,0,10,540279,-1193,2,-3,3,-8,0,0,3,1,0
KR_7746769259,14020,14336,246,274,4,2,2,5,3,2,0,0,0,0,17,31,2,1,0,3,1,0,0,0,0,0,10,540106,-316,-28,2,-3,1,0,0,-14,1,-3
KR_7746771294,14607,16690,240,207,5,11,11,5,6,18,0,0,0,0,42,18,1,8,0,0,0,1,0,0,0,0,10,540245,-2083,33,-6,6,-12,0,0,24,-7,0
KR_7746783070,14278,14703,261,275,3,4,4,3,2,2,0,0,0,0,17,33,2,2,1,0,0,1,0,0,0,0,10,540246,-425,-14,-1,1,0,0,0,-16,0,1
KR_7746795930,13656,14251,290,283,1,2,2,1,0,1,1,0,0,0,15,16,4,3,0,1,0,1,1,0,0,0,10,540262,-595,7,-1,1,-1,1,0,-1,1,-1
KR_7746796223,14676,13202,282,239,3,2,2,3,2,3,0,0,0,0,14,13,3,1,1,0,0,1,0,0,0,0,10,540216,1474,43,1,-1,-1,0,0,1,2,1
KR_7746810383,16915,16559,242,252,11,8,8,11,12,8,0,0,0,0,14,18,5,3,0,2,1,0,0,0,0,0,10,540214,356,-10,3,-3,4,0,0,-4,2,-2
KR_7746818800,17139,17085,242,235,10,10,10,10,13,13,0,0,0,0,19,14,2,4,1,1,1,0,0,0,0,0,10,540112,54,7,0,0,0,0,0,5,-2,0
KR_7746843203,13283,16750,242,268,2,10,10,2,1,12,1,0,0,0,15,37,3,4,0,0,0,1,1,0,0,0,10,540263,-3467,-26,-8,8,-11,1,0,-22,-1,0
KR_7746845854,15844,13969,254,260,6,2,2,6,9,3,1,0,0,0,19,17,3,2,2,1,1,0,1,0,0,0,10,540206,1875,-6,4,-4,6,1,0,2,1,1
KR_7746856435,16139,14881,295,272,6,4,4,7,6,2,0,0,0,0,14,13,5,3,0,0,1,0,0,0,0,0,10,540235,1258,23,2,-3,4,0,0,1,2,0
KR_7746863025,14970,16312,291,259,3,8,8,3,2,12,0,0,0,0,72,19,3,5,2,3,0,1,0,0,0,0,10,540196,-1342,32,-5,5,-10,0,0,53,-2,-1
KR_7746876025,14859,15515,263,278,6,6,6,6,2,5,0,0,0,0,15,12,1,0,0,1,1,0,0,0,0,0,10,540249,-656,-15,0,0,-3,0,0,3,1,-1
KR_7746889856,16599,13078,291,240,7,1,1,7,8,2,0,0,0,0,40,16,3,3,1,0,1,0,0,0,0,0,10,540238,3521,51,6,-6,6,0,0,24,0,1
KR_7746915632,13156,17084,232,267,2,10,10,2,1,16,0,0,0,0,11,39,2,2,1,3,0,1,0,0,0,0,10,540210,-3928,-35,-8,8,-15,0,0,-28,0,-2
KR_7746917730,16571,12938,291,243,8,1,1,8,4,2,0,0,0,0,13,15,4,1,1,0,1,0,0,0,0,0,10,540222,3633,48,7,-7,2,0,0,-2,3,1
KR_7746919373,15998,13452,294,251,5,2,2,5,5,1,0,1,0,0,16,29,4,5,2,1,1,0,0,1,0,0,10,540220,2546,43,3,-3,4,-1,0,-13,-1,1
KR_7746929184,15602,16270,275,295,5,6,6,5,4,9,0,0,0,0,18,14,2,2,0,1,1,0,0,0,0,0,10,540214,-668,-20,-1,1,-5,0,0,4,0,-1
KR_7746931679,14153,13874,296,263,2,2,2,2,1,2,1,0,0,0,19,14,1,1,1,0,0,1,1,0,0,0,10,540221,279,33,0,0,-1,1,0,5,0,1
KR_7746945887,15609,15697,286,276,5,6,6,5,5,4,0,0,0,0,12,18,4,0,1,0,1,0,0,0,0,0,10,540256,-88,10,-1,1,1,0,0,-6,4,1
KR_7746957462,15194,14605,278,251,4,5,5,4,5,3,0,1,0,0,33,18,2,1,2,2,1,0,0,1,0,0,10,540191,589,27,-1,1,2,-1,0,15,1,0
KR_7746967439,13787,14844,247,266,3,3,3,3,4,8,0,0,0,0,31,20,4,3,0,1,1,0,0,0,0,0,10,540243,-1057,-19,0,0,-4,0,0,11,1,-1
KR_7746997240,16352,14748,287,253,7,4,4,7,7,5,0,1,0,0,17,22,5,0,1,0,1,0,0,1,0,0,10,540208,1604,34,3,-3,2,-1,0,-5,5,1
KR_7747009615,16067,13590,247,223,10,3,3,10,9,5,0,0,0,0,15,12,1,1,1,0,1,0,0,0,0,0,10,540296,2477,24,7,-7,4,0,0,3,0,1
KR_7747010292,17101,13807,271,215,10,5,5,11,5,5,0,0,0,0,17,12,1,4,1,0,1,0,0,0,0,0,10,540236,3294,56,5,-6,0,0,0,5,-3,1
KR_7747017015,15059,14712,268,271,5,3,3,5,5,4,0,1,0,0,30,17,2,1,0,1,1,0,0,1,0,0,10,540204,347,-3,2,-2,1,-1,0,13,1,-1
KR_7747053028,16465,14584,275,274,8,2,2,8,11,2,0,0,0,0,15,17,2,3,1,1,1,0,0,0,0,0,10,540237,1881,1,6,-6,9,0,0,-2,-1,0
KR_7747064266,14462,16340,261,249,4,8,8,4,2,9,0,0,0,0,34,17,3,4,0,1,1,0,0,0,0,0,10,540214,-1878,12,-4,4,-7,0,0,17,-1,-1
KR_7747077270,15408,13667,257,245,7,3,3,7,5,5,0,0,0,0,33,16,0,2,0,0,1,0,0,0,0,0,10,540215,1741,12,4,-4,0,0,0,17,-2,0
KR_7747093565,16534,14532,299,239,6,4,4,6,8,8,0,0,0,0,16,11,1,5,0,0,1,0,0,0,0,0,10,540283,2002,60,2,-2,0,0,0,5,-4,0
KR_7747119527,15496,13840,254,247,6,3,3,6,13,5,0,0,0,0,15,13,4,4,1,0,1,0,0,0,0,0,10,540244,1656,7,3,-3,8,0,0,2,0,1
KR_7747128489,15120,15913,263,280,5,6,6,5,6,9,0,1,0,0,43,18,4,3,1,0,0,1,0,1,0,0,10,540330,-793,-17,-1,1,-3,-1,0,25,1,1
KR_7747134900,13831,17014,270,250,1,11,11,1,2,18,0,1,0,0,9,26,3,3,0,1,0,1,0,1,0,0,10,540209,-3183,20,-10,10,-16,-1,0,-17,0,-1
KR_7747145344,14411,16025,292,258,2,7,7,2,2,6,0,1,0,0,17,18,5,3,0,3,0,1,0,1,0,0,10,540222,-1614,34,-5,5,-4,-1,0,-1,2,-3
KR_7747149676,15320,16224,239,242,7,9,9,8,9,11,0,0,0,0,15,13,3,3,0,1,0,1,0,0,0,0,10,540185,-904,-3,-2,1,-2,0,0,2,0,-1
KR_7747159905,16344,14103,291,273,7,2,2,7,5,4,0,0,0,0,13,16,6,4,1,0,1,0,0,0,0,0,10,540111,2241,18,5,-5,1,0,0,-3,2,1
KR_7747174699,17766,15870,256,250,14,7,8,14,9,9,0,0,0,0,36,16,2,2,1,0,1,0,0,0,0,0,10,540167,1896,6,7,-6,0,0,0,20,0,1
KR_7747180063,13982,14562,296,296,1,2,2,1,0,2,0,0,0,0,109,14,2,4,0,0,1,0,0,0,0,0,10,540315,-580,0,-1,1,-2,0,0,95,-2,0
KR_7747193776,14033,18018,232,265,4,14,14,4,6,19,0,0,0,0,18,16,3,6,1,1,1,0,0,0,0,0,10,540257,-3985,-33,-10,10,-13,0,0,2,-3,0
KR_7747193787,14174,15865,278,302,3,5,5,3,3,11,0,0,0,0,19,23,5,5,0,1,0,1,0,0,0,0,10,540242,-1691,-24,-2,2,-8,0,0,-4,0,-1
KR_7747215040,13468,15515,262,313,1,3,3,1,2,3,0,0,0,0,12,17,5,4,1,1,0,1,0,0,0,0,10,540235,-2047,-51,-2,2,-1,0,0,-5,1,0
KR_7747252759,14950,14361,300,278,3,3,3,3,0,3,0,1,0,0,12,17,5,3,0,0,0,1,0,1,0,0,10,540230,589,22,0,0,-3,-1,0,-5,2,0
KR_7747254423,14969,18213,230,257,5,12,12,5,4,12,0,0,0,0,18,17,3,3,0,2,0,1,0,0,0,0,10,540263,-3244,-27,-7,7,-8,0,0,1,0,-2
KR_7747274315,15561,14305,243,227,7,4,4,7,11,5,0,0,0,0,36,13,2,2,1,0,0,1,0,0,0,0,10,540200,1256,16,3,-3,6,0,0,23,0,1
KR_7747276107,14715,14907,249,255,5,5,5,5,6,8,0,0,0,0,13,22,6,1,0,0,1,0,0,0,0,0,10,540233,-192,-6,0,0,-2,0,0,-9,5,0
KR_7747278192,14349,15280,284,274,3,5,5,3,1,4,0,0,0,0,17,13,4,4,1,0,0,1,0,0,0,0,10,540210,-931,10,-2,2,-3,0,0,4,0,1
KR_7747287227,14332,13797,279,296,3,1,1,3,7,0,0,0,0,0,17,17,5,3,0,0,1,0,0,0,0,0,10,540179,535,-17,2,-2,7,0,0,0,2,0
KR_7747288040,15595,14634,255,244,6,5,5,6,10,7,0,1,0,0,27,17,3,8,1,1,0,1,0,1,0,0,10,540263,961,11,1,-1,3,-1,0,10,-5,0
KR_7747291499,14177,18630,267,268,3,13,13,3,3,12,0,0,0,0,20,14,2,3,0,3,0,1,0,0,0,0,10,540230,-4453,-1,-10,10,-9,0,0,6,-1,-3
KR_7747303416,15060,16586,260,273,4,7,7,4,7,10,0,0,0,0,18,19,1,4,0,2,0,1,0,0,0,0,10,540238,-1526,-13,-3,3,-3,0,0,-1,-3,-2
KR_7747320494,17548,14101,283,257,9,2,2,9,8,2,0,0,0,0,19,16,4,0,3,0,1,0,0,0,0,0,10,540289,3447,26,7,-7,6,0,0,3,4,3
KR_7747341328,14107,13975,285,276,2,2,2,2,0,2,1,0,0,0,227,16,3,1,1,0,0,1,1,0,0,0,10,540087,132,9,0,0,-2,1,0,211,2,1
KR_7747341872,16504,14087,254,236,9,4,5,9,6,2,0,0,0,0,33,21,4,2,2,0,1,0,0,0,0,0,10,540281,2417,18,5,-4,4,0,0,12,2,2
KR_7747368104,15610,15561,255,252,6,6,6,6,7,6,0,0,0,0,20,19,3,6,0,0,0,1,0,0,0,0,10,540314,49,3,0,0,1,0,0,1,-3,0
KR_7747391163,15718,15040,267,255,6,5,5,6,6,6,0,0,0,0,18,16,4,3,0,2,1,0,0,0,0,0,10,540205,678,12,1,-1,0,0,0,2,1,-2
KR_7747401026,15646,15185,251,242,7,7,7,7,9,11,1,0,0,0,15,14,2,4,1,0,1,0,1,0,0,0,10,540308,461,9,0,0,-2,1,0,1,-2,1
KR_7747401843,14846,15276,280,264,4,6,6,5,2,5,0,1,0,0,29,17,1,4,1,1,1,0,0,1,0,0,10,540256,-430,16,-2,1,-3,-1,0,12,-3,0
KR_7747403885,14785,13501,288,273,5,1,1,5,1,0,1,0,0,0,17,123,3,3,0,0,1,0,1,0,0,0,10,540248,1284,15,4,-4,1,1,0,-106,0,0
KR_7747440470,15304,14235,290,265,4,3,3,4,5,4,0,1,0,0,70,155,5,3,0,1,0,1,0,1,0,0,10,540242,1069,25,1,-1,1,-1,0,-85,2,-1
KR_7747450483,14880,15067,264,258,4,5,5,4,3,5,0,0,0,0,16,15,1,4,1,0,0,1,0,0,0,0,10,540216,-187,6,-1,1,-2,0,0,1,-3,1
KR_7747464795,14621,15408,243,283,5,5,5,5,8,4,0,0,0,0,36,15,2,7,0,2,0,1,0,0,0,0,10,540229,-787,-40,0,0,4,0,0,21,-5,-2
KR_7747471802,14448,15805,255,292,4,5,5,4,2,5,0,0,0,0,12,14,0,1,1,0,0,1,0,0,0,0,10,540235,-1357,-37,-1,1,-3,0,0,-2,-1,1
KR_7747492985,13996,16414,277,264,2,8,8,2,1,8,0,1,0,0,14,17,2,0,2,0,1,0,0,1,0,0,10,540256,-2418,13,-6,6,-7,-1,0,-3,2,2
KR_7747519066,15468,16281,285,288,4,6,6,4,3,4,0,0,0,0,17,21,3,5,1,2,1,0,0,0,0,0,10,540234,-813,-3,-2,2,-1,0,0,-4,-2,-1
KR_7747520084,14520,14742,258,246,3,5,5,3,3,5,0,0,0,0,15,20,8,0,1,1,0,1,0,0,0,0,10,540225,-222,12,-2,2,-2,0,0,-5,8,0
KR_7747521590,15530,15717,260,264,7,7,7,7,6,5,0,1,0,0,25,13,3,3,0,0,1,0,0,1,0,0,10,540247,-187,-4,0,0,1,-1,0,12,0,0
KR_7747524065,18719,14526,286,241,11,4,4,11,12,6,0,0,0,0,37,19,5,4,3,1,0,1,0,0,0,0,10,540252,4193,45,7,-7,6,0,0,18,1,2
KR_7747543635,14321,14695,237,262,5,4,4,5,4,2,0,1,0,0,17,18,3,6,0,0,1,0,0,1,0,0,10,540262,-374,-25,1,-1,2,-1,0,-1,-3,0
KR_7747545715,15741,16847,254,270,7,9,9,7,9,13,0,1,0,0,22,18,4,4,2,0,0,1,0,1,0,0,10,540208,-1106,-16,-2,2,-4,-1,0,4,0,2
KR_7747556627,15239,16255,252,251,6,7,7,6,7,12,0,0,0,0,17,16,2,4,0,0,0,1,0,0,0,0,10,540252,-1016,1,-1,1,-5,0,0,1,-2,0
KR_7747557544,16405,15827,259,257,8,7,7,8,10,7,0,0,0,0,20,39,6,1,0,1,0,1,0,0,0,0,10,540265,578,2,1,-1,3,0,0,-19,5,-1
KR_7747566035,14845,15378,289,288,4,4,4,4,2,7,1,0,0,0,18,113,5,3,1,1,0,1,1,0,0,0,10,540210,-533,1,0,0,-5,1,0,-95,2,0
KR_7747576075,15055,16261,256,269,5,7,7,5,4,9,0,0,0,0,14,90,0,3,1,1,1,0,0,0,0,0,10,540211,-1206,-13,-2,2,-5,0,0,-76,-3,0
KR_7747576592,16295,17309,260,250,6,13,13,6,9,10,0,0,0,0,34,19,4,3,0,0,0,1,0,0,0,0,10,540264,-1014,10,-7,7,-1,0,0,15,1,0
KR_7747593769,14825,15778,276,276,4,6,6,4,2,7,0,1,0,0,15,19,2,2,1,1,0,1,0,1,0,0,10,540242,-953,0,-2,2,-5,-1,0,-4,0,0
KR_7747596413,14255,16584,229,269,4,8,8,4,5,13,0,0,0,0,18,146,4,4,1,0,0,1,0,0,0,0,10,540163,-2329,-40,-4,4,-8,0,0,-128,0,1
KR_7747605583,15196,17741,255,273,5,11,11,5,4,15,1,0,0,0,113,18,2,1,0,1,1,0,1,0,0,0,10,540270,-2545,-18,-6,6,-11,1,0,95,1,-1
KR_7747605787,15802,14990,264,263,6,5,8,6,7,3,0,0,0,0,19,55,2,1,3,1,0,1,0,0,0,0,10,540264,812,1,1,2,4,0,0,-36,1,2
KR_7747607095,18113,15338,290,258,10,4,4,10,9,5,0,0,0,0,34,14,4,3,3,1,0,1,0,0,0,0,10,540210,2775,32,6,-6,4,0,0,20,1,2
KR_7747613521,14781,14963,267,271,4,4,4,4,3,5,0,0,0,0,15,18,6,4,0,2,0,1,0,0,0,0,10,540207,-182,-4,0,0,-2,0,0,-3,2,-2
KR_7747633371,15717,14864,255,264,7,5,5,7,10,8,0,1,0,0,17,15,2,1,0,1,1,0,0,1,0,0,10,540189,853,-9,2,-2,2,-1,0,2,1,-1
KR_7747636903,13978,15113,267,273,3,4,4,3,1,5,0,0,0,0,18,14,3,2,0,0,0,1,0,0,0,0,10,540214,-1135,-6,-1,1,-4,0,0,4,1,0
KR_7747637181,15344,14115,285,259,5,3,3,5,4,4,0,0,0,0,11,25,2,2,2,0,1,0,0,0,0,0,10,540263,1229,26,2,-2,0,0,0,-14,0,2
KR_7747639941,15896,16439,237,281,8,6,6,8,7,11,0,0,0,0,16,17,4,4,0,0,1,0,0,0,0,0,10,540225,-543,-44,2,-2,-4,0,0,-1,0,0
KR_7747641963,14336,18004,257,292,3,9,9,3,7,12,0,0,0,0,14,19,5,3,1,3,0,1,0,0,0,0,10,540215,-3668,-35,-6,6,-5,0,0,-5,2,-2
KR_7747651915,15801,15267,261,237,6,6,6,6,7,4,0,0,0,0,126,14,4,4,2,0,0,1,0,0,0,0,10,540243,534,24,0,0,3,0,0,112,0,2
KR_7747656333,14991,14564,269,270,4,4,4,4,2,9,0,1,0,0,17,90,3,1,1,0,0,1,0,1,0,0,10,540189,427,-1,0,0,-7,-1,0,-73,2,1
KR_7747663100,13719,14531,292,300,1,2,2,1,1,1,0,0,0,0,14,14,4,2,0,0,1,0,0,0,0,0,10,540196,-812,-8,-1,1,0,0,0,0,2,0
KR_7747668266,13639,16172,287,309,1,6,6,1,1,4,0,0,0,0,16,15,5,5,0,1,1,0,0,0,0,0,10,540257,-2533,-22,-5,5,-3,0,0,1,0,-1
KR_7747677328,15726,14820,287,310,5,3,3,5,6,1,0,1,0,0,14,15,3,3,0,0,0,1,0,1,0,0,10,540204,906,-23,2,-2,5,-1,0,-1,0,0
KR_7747677732,17330,12726,276,217,11,2,2,11,6,1,1,0,0,0,15,12,3,3,2,0,1,0,1,0,0,0,10,540267,4604,59,9,-9,5,1,0,3,0,2
KR_7747680888,14254,15535,270,270,3,7,7,3,1,11,0,1,0,0,16,17,1,3,0,0,1,0,0,1,0,0,10,540219,-1281,0,-4,4,-10,-1,0,-1,-2,0
KR_7747694328,14661,14851,238,271,6,4,5,6,3,5,0,0,0,0,15,16,2,5,0,0,1,0,0,0,0,0,10,540194,-190,-33,2,-1,-2,0,0,-1,-3,0
KR_7747697673,16897,13844,281,265,10,2,2,10,6,3,0,1,0,0,18,24,2,5,0,0,1,0,0,1,0,0,10,540244,3053,16,8,-8,3,-1,0,-6,-3,0
KR_7747699259,14516,14928,273,276,3,4,4,3,2,3,0,0,0,0,15,36,2,3,0,2,0,1,0,0,0,0,10,540248,-412,-3,-1,1,-1,0,0,-21,-1,-2
KR_7747700130,13777,16646,256,270,3,8,8,3,3,10,0,0,0,0,16,23,1,6,0,1,1,0,0,0,0,0,10,540246,-2869,-14,-5,5,-7,0,0,-7,-5,-1
KR_7747701442,17479,17722,259,270,10,12,12,10,15,15,0,0,0,0,19,13,2,4,0,0,0,1,0,0,0,0,10,540238,-243,-11,-2,2,0,0,0,6,-2,0
KR_7747704505,14385,14974,252,248,4,5,5,4,3,8,0,0,0,0,48,16,2,4,0,1,0,1,0,0,0,0,10,540260,-589,4,-1,1,-5,0,0,32,-2,-1
KR_7747705903,15009,14853,250,232,5,6,6,5,4,7,0,0,0,0,18,15,1,3,0,0,0,1,0,0,0,0,10,540102,156,18,-1,1,-3,0,0,3,-2,0
KR_7747718852,13670,17365,280,292,1,8,8,1,1,11,0,0,0,0,113,22,5,2,0,2,0,1,0,0,0,0,10,540190,-3695,-12,-7,7,-10,0,0,91,3,-2
KR_7747720028,15325,13356,277,249,6,2,2,6,3,1,1,0,0,0,17,24,5,2,1,0,1,0,1,0,0,0,10,540284,1969,28,4,-4,2,1,0,-7,3,1
KR_7747733554,15443,15572,263,270,5,5,6,5,4,6,0,1,0,0,15,17,3,3,2,2,1,0,0,1,0,0,10,540231,-129,-7,0,1,-2,-1,0,-2,0,0
KR_7747737760,14856,17653,253,264,4,11,11,4,7,12,0,0,0,0,17,16,2,3,2,2,1,0,0,0,0,0,10,540213,-2797,-11,-7,7,-5,0,0,1,-1,0
KR_7747746425,15273,15271,246,264,5,6,6,5,6,7,0,0,0,0,118,16,3,4,1,1,1,0,0,0,0,0,10,540217,2,-18,-1,1,-1,0,0,102,-1,0
KR_7747750484,14279,13738,282,263,2,2,2,2,2,1,0,0,0,0,15,21,3,2,0,1,0,1,0,0,0,0,10,540258,541,19,0,0,1,0,0,-6,1,-1
KR_7747752921,15077,14707,282,269,4,4,4,4,6,5,0,0,0,0,19,16,3,3,1,0,0,1,0,0,0,0,10,540223,370,13,0,0,1,0,0,3,0,1
KR_7747753820,14914,13956,260,270,5,3,3,5,3,3,0,1,0,0,16,15,3,6,0,0,0,1,0,1,0,0,10,540240,958,-10,2,-2,0,-1,0,1,-3,0
KR_7747757385,15582,15252,240,217,8,7,7,8,5,10,0,0,0,0,28,17,3,3,1,0,1,0,0,0,0,0,10,540214,330,23,1,-1,-5,0,0,11,0,1
KR_7747761892,17497,15521,262,255,9,7,7,9,16,8,0,0,0,0,14,28,1,2,1,0,1,0,0,0,0,0,10,540290,1976,7,2,-2,8,0,0,-14,-1,1
KR_7747766720,13121,16149,237,269,1,8,8,1,1,4,1,0,0,0,14,39,0,3,1,2,0,1,1,0,0,0,10,540221,-3028,-32,-7,7,-3,1,0,-25,-3,-1
KR_7747767802,16438,14487,251,233,10,4,4,10,8,4,0,0,0,0,32,15,1,2,2,0,1,0,0,0,0,0,10,540219,1951,18,6,-6,4,0,0,17,-1,2
KR_7747776604,15249,13943,245,220,7,5,5,7,3,5,0,1,0,0,13,11,1,1,0,0,1,0,0,1,0,0,10,540216,1306,25,2,-2,-2,-1,0,2,0,0
KR_7747790999,14643,14373,244,248,6,5,5,6,4,1,0,0,0,0,14,17,1,3,0,1,0,1,0,0,0,0,10,540244,270,-4,1,-1,3,0,0,-3,-2,-1
KR_7747793722,15412,13441,299,267,3,1,2,3,2,1,0,0,0,0,35,17,5,1,3,0,1,0,0,0,0,0,10,540226,1971,32,2,-1,1,0,0,18,4,3
KR_7747797155,13914,15700,280,271,2,6,6,2,1,9,0,1,0,0,16,32,1,1,0,0,1,0,0,1,0,0,10,540240,-1786,9,-4,4,-8,-1,0,-16,0,0
KR_7747802217,15175,16123,261,254,5,9,9,5,6,6,0,1,0,0,9,9,1,1,1,1,1,0,0,1,0,0,10,540188,-948,7,-4,4,0,-1,0,0,0,0
KR_7747813260,13332,15267,260,259,1,6,6,1,1,6,0,0,0,0,12,12,1,1,2,1,0,1,0,0,0,0,10,540230,-1935,1,-5,5,-5,0,0,0,0,1
KR_7747813745,16314,16530,259,263,9,9,9,9,9,7,0,0,0,0,15,34,5,4,0,1,0,1,0,0,0,0,10,540209,-216,-4,0,0,2,0,0,-19,1,-1
KR_7747828478,14641,14403,225,244,7,5,5,7,4,5,0,1,0,0,15,10,1,2,1,0,0,1,0,1,0,0,10,540227,238,-19,2,-2,-1,-1,0,5,-1,1
KR_7747836281,16920,16368,267,271,9,8,8,9,9,12,0,1,0,0,23,39,5,4,1,1,0,1,0,1,0,0,10,540235,552,-4,1,-1,-3,-1,0,-16,1,0
KR_7747928512,16772,14900,265,256,9,6,6,9,14,1,1,0,0,0,17,18,3,1,0,0,0,1,1,0,0,0,10,540247,1872,9,3,-3,13,1,0,-1,2,0
KR_7747928917,13898,15404,254,290,3,6,6,3,6,4,0,0,0,0,15,30,1,2,0,0,0,1,0,0,0,0,10,540205,-1506,-36,-3,3,2,0,0,-15,-1,0
KR_7747967673,14292,14072,282,247,3,4,5,3,2,3,0,0,0,0,17,38,5,2,0,0,0,1,0,0,0,0,10,540214,220,35,-1,2,-1,0,0,-21,3,0
KR_7748015542,14752,15961,283,276,4,7,7,4,1,10,0,0,0,0,15,18,1,0,0,0,0,1,0,0,0,0,10,540253,-1209,7,-3,3,-9,0,0,-3,1,0
KR_7748025936,15959,16719,247,254,7,8,8,7,6,9,0,0,0,0,16,13,1,4,0,0,0,1,0,0,0,0,10,540229,-760,-7,-1,1,-3,0,0,3,-3,0
KR_7748026065,14345,14438,230,237,4,5,5,4,3,6,0,0,0,0,12,32,4,2,1,1,0,1,0,0,0,0,10,540203,-93,-7,-1,1,-3,0,0,-20,2,0
KR_7748044330,13244,14164,289,314,0,1,1,0,0,1,0,1,0,0,15,70,2,3,0,0,0,1,0,1,0,0,10,540239,-920,-25,-1,1,-1,-1,0,-55,-1,0
KR_7748056652,17048,15349,270,223,11,7,7,11,4,7,1,0,0,0,17,12,1,4,1,0,1,0,1,0,0,0,10,540229,1699,47,4,-4,-3,1,0,5,-3,1
KR_7748076929,14711,17962,207,270,6,10,10,6,6,9,0,0,0,0,18,14,1,7,0,0,1,0,0,0,0,0,10,540232,-3251,-63,-4,4,-3,0,0,4,-6,0
KR_7748090486,16458,15744,289,258,8,8,8,8,4,10,0,1,0,0,17,18,4,4,0,0,1,0,0,1,0,0,10,540249,714,31,0,0,-6,-1,0,-1,0,0
KR_7748098082,13977,15140,264,287,2,4,4,2,2,2,0,1,0,0,30,14,1,2,0,0,0,1,0,1,0,0,10,540217,-1163,-23,-2,2,0,-1,0,16,-1,0
KR_7748106342,14792,14511,291,234,3,5,5,3,3,7,0,0,0,0,12,15,5,2,0,0,1,0,0,0,0,0,10,540243,281,57,-2,2,-4,0,0,-3,3,0
KR_7748136586,17016,14951,275,294,8,3,3,8,11,4,0,0,0,0,23,17,4,5,0,0,1,0,0,0,0,0,10,540285,2065,-19,5,-5,7,0,0,6,-1,0
KR_7748142613,16067,15529,277,261,7,5,5,7,6,6,0,0,0,0,29,18,4,4,0,1,1,0,0,0,0,0,10,540236,538,16,2,-2,0,0,0,11,0,-1
KR_7748145856,16369,14476,256,250,8,4,4,8,12,3,0,0,0,0,20,36,1,4,2,0,0,1,0,0,0,0,10,540237,1893,6,4,-4,9,0,0,-16,-3,2
KR_7748161455,16151,14225,252,271,8,3,3,8,10,2,0,0,0,0,19,67,2,5,0,0,0,1,0,0,0,0,10,540259,1926,-19,5,-5,8,0,0,-48,-3,0
KR_7748171999,13766,15606,255,289,3,5,5,3,4,3,0,1,0,0,22,14,0,6,0,0,1,0,0,1,0,0,10,540240,-1840,-34,-2,2,1,-1,0,8,-6,0
KR_7748182820,15418,15849,262,217,5,8,8,5,7,12,0,1,0,0,43,22,3,3,4,0,1,0,0,1,0,0,10,540172,-431,45,-3,3,-5,-1,0,21,0,4
KR_7748186448,15253,13999,286,277,4,2,2,4,6,1,0,0,0,0,17,17,5,1,0,0,1,0,0,0,0,0,10,540241,1254,9,2,-2,5,0,0,0,4,0
KR_7748217204,13646,15270,278,253,1,6,7,1,1,4,0,1,0,0,37,17,2,3,1,1,0,1,0,1,0,0,10,540271,-1624,25,-5,6,-3,-1,0,20,-1,0
KR_7748219968,15004,15070,308,297,3,3,3,3,2,1,0,0,0,0,12,14,4,1,0,0,0,1,0,0,0,0,10,540219,-66,11,0,0,1,0,0,-2,3,0
KR_7748225517,14692,17516,250,278,4,8,8,4,3,9,0,0,0,0,29,20,2,1,0,3,0,1,0,0,0,0,10,540235,-2824,-28,-4,4,-6,0,0,9,1,-3
KR_7748230241,13709,16260,263,292,2,6,6,2,2,8,0,1,0,0,49,67,1,2,0,0,0,1,0,1,0,0,10,540225,-2551,-29,-4,4,-6,-1,0,-18,-1,0
KR_7748256604,14784,14865,239,268,5,5,5,5,7,3,0,0,0,0,20,14,2,5,1,0,0,1,0,0,0,0,10,540232,-81,-29,0,0,4,0,0,6,-3,1
KR_7748275116,14854,13689,288,258,3,3,3,3,5,2,1,0,0,0,22,164,3,1,1,0,1,0,1,0,0,0,10,540265,1165,30,0,0,3,1,0,-142,2,1
KR_7748276412,16748,15075,273,225,9,7,7,9,7,4,0,0,0,0,14,17,5,2,0,0,1,0,0,0,0,0,10,540226,1673,48,2,-2,3,0,0,-3,3,0
KR_7748277328,17652,15628,221,225,13,8,9,13,13,10,0,0,0,0,16,26,3,2,1,1,0,1,0,0,0,0,10,540188,2024,-4,5,-4,3,0,0,-10,1,0
KR_7748292679,13870,15180,245,249,2,6,6,2,3,9,0,1,0,0,13,44,2,2,1,0,0,1,0,1,0,0,10,540260,-1310,-4,-4,4,-6,-1,0,-31,0,1
KR_7748308531,13246,14775,235,255,2,5,5,2,3,5,0,0,0,0,14,16,4,1,0,0,1,0,0,0,0,0,10,540198,-1529,-20,-3,3,-2,0,0,-2,3,0
KR_7748313891,17442,15696,250,229,11,9,9,12,13,9,0,1,0,0,39,14,5,1,1,0,1,0,0,1,0,0,10,540243,1746,21,2,-3,4,-1,0,25,4,1
KR_7748317745,14945,16159,291,246,3,6,6,4,3,9,0,0,0,0,19,28,1,5,2,2,0,1,0,0,0,0,10,540282,-1214,45,-3,2,-6,0,0,-9,-4,0
KR_7748325337,13001,16216,265,250,0,6,6,0,0,7,0,1,0,0,12,11,3,0,1,4,0,1,0,1,0,1,10,540230,-3215,15,-6,6,-7,-1,0,1,3,-3
KR_7748334740,13852,16405,261,276,2,7,7,2,2,12,0,1,0,0,11,15,3,1,0,1,0,1,0,1,0,0,10,540230,-2553,-15,-5,5,-10,-1,0,-4,2,-1
KR_7748345486,15510,14313,284,274,5,3,3,5,4,2,0,1,0,0,16,43,2,4,2,0,1,0,0,1,0,0,10,540221,1197,10,2,-2,2,-1,0,-27,-2,2
KR_7748359547,14702,15612,253,249,5,6,6,5,2,9,0,0,0,0,19,18,1,8,0,1,0,1,0,0,0,0,10,540197,-910,4,-1,1,-7,0,0,1,-7,-1
KR_7748364685,13491,14640,271,279,1,3,3,1,2,5,0,1,0,0,11,21,6,0,1,2,0,1,0,1,0,0,10,540259,-1149,-8,-2,2,-3,-1,0,-10,6,-1
KR_7748366322,16548,14846,304,257,7,5,5,7,7,2,0,0,0,0,21,38,7,2,0,1,1,0,0,0,0,0,10,540257,1702,47,2,-2,5,0,0,-17,5,-1
KR_7748366707,17637,15605,276,264,10,6,6,10,11,6,0,0,0,0,24,18,2,2,0,0,0,1,0,0,0,0,10,540252,2032,12,4,-4,5,0,0,6,0,0
KR_7748396482,15783,15803,294,285,6,7,7,6,3,3,1,0,0,0,16,17,6,6,0,1,0,1,1,0,0,0,10,540244,-20,9,-1,1,0,1,0,-1,0,-1
KR_7748400823,15561,14521,273,281,5,3,3,5,6,2,0,0,0,0,13,18,4,2,1,1,0,1,0,0,0,0,10,540205,1040,-8,2,-2,4,0,0,-5,2,0
KR_7748409338,15525,16947,280,271,6,9,9,6,3,14,0,1,0,0,14,18,7,3,1,1,0,1,0,1,0,0,10,540241,-1422,9,-3,3,-11,-1,0,-4,4,0
KR_7748426251,17264,14830,281,234,9,6,6,9,13,5,0,0,0,0,21,15,3,3,2,0,1,0,0,0,0,0,10,540273,2434,47,3,-3,8,0,0,6,0,2
KR_7748429070,16568,14278,284,247,6,5,5,6,6,3,0,1,0,0,37,28,2,1,1,0,0,1,0,1,0,0,10,540234,2290,37,1,-1,3,-1,0,9,1,1
KR_7748434718,16203,16319,229,248,9,7,7,9,10,9,0,0,0,0,22,18,1,7,1,0,0,1,0,0,0,0,10,540103,-116,-19,2,-2,1,0,0,4,-6,1
KR_7748449798,15083,15514,303,283,3,5,5,3,5,8,0,1,0,0,15,18,5,2,0,0,0,1,0,1,0,0,10,540188,-431,20,-2,2,-3,-1,0,-3,3,0
KR_7748464514,16737,14772,245,284,12,3,3,12,9,2,0,1,0,0,18,110,2,4,1,1,1,0,0,1,0,0,10,540217,1965,-39,9,-9,7,-1,0,-92,-2,0
KR_7748476033,14195,17954,257,259,4,11,11,4,2,10,0,0,0,0,12,14,1,5,0,3,1,0,0,0,0,0,10,540186,-3759,-2,-7,7,-8,0,0,-2,-4,-3
KR_7748478299,13576,17169,251,276,2,9,9,2,3,14,0,0,0,0,17,18,3,2,0,0,0,1,0,0,0,0,10,540212,-3593,-25,-7,7,-11,0,0,-1,1,0
KR_7748480935,13927,14086,287,289,1,1,1,1,1,1,0,1,0,0,20,19,2,2,0,0,0,1,0,1,0,0,10,540212,-159,-2,0,0,0,-1,0,1,0,0
KR_7748490640,15792,13222,293,286,6,1,1,6,5,0,0,0,0,0,19,15,1,2,1,0,1,0,0,0,0,0,10,540242,2570,7,5,-5,5,0,0,4,-1,1
KR_7748495931,14077,15714,251,275,3,6,6,3,3,6,0,0,0,0,16,17,4,2,0,1,1,0,0,0,0,0,10,540272,-1637,-24,-3,3,-3,0,0,-1,2,-1
KR_7748501730,15990,14000,258,284,7,2,2,7,9,1,0,1,0,0,59,14,3,0,0,1,1,0,0,1,0,0,10,540194,1990,-26,5,-5,8,-1,0,45,3,-1
KR_7748511543,15170,14156,304,267,4,3,3,4,4,4,0,1,0,0,36,38,4,4,1,0,1,0,0,1,0,0,10,540209,1014,37,1,-1,0,-1,0,-2,0,1
KR_7748523027,12768,14770,261,264,0,5,5,0,0,4,0,0,0,0,15,28,2,3,0,0,0,1,0,0,0,0,10,540222,-2002,-3,-5,5,-4,0,0,-13,-1,0
KR_7748537154,15018,14455,276,262,5,3,3,5,5,5,1,0,0,0,14,16,3,5,0,0,1,0,1,0,0,0,10,540227,563,14,2,-2,0,1,0,-2,-2,0
KR_7748541928,14705,16286,232,252,5,8,8,5,8,8,0,0,0,0,13,15,4,2,0,0,1,0,0,0,0,0,10,540242,-1581,-20,-3,3,0,0,0,-2,2,0
KR_7748544620,14515,15062,242,238,4,6,6,4,2,6,0,0,0,0,18,10,2,6,1,0,0,1,0,0,0,0,10,540191,-547,4,-2,2,-4,0,0,8,-4,1
KR_7748551537,13604,16969,240,254,3,10,10,3,3,11,0,0,0,0,19,32,4,2,0,0,1,0,0,0,0,0,10,540239,-3365,-14,-7,7,-8,0,0,-13,2,0
KR_7748559493,14445,14603,267,283,3,2,2,3,3,1,0,0,0,0,13,17,3,2,0,1,0,1,0,0,0,0,10,540250,-158,-16,1,-1,2,0,0,-4,1,-1
KR_7748559891,15382,16275,224,259,6,9,10,6,7,13,0,0,0,0,19,11,4,4,0,0,1,0,0,0,0,0,10,540253,-893,-35,-3,4,-6,0,0,8,0,0
KR_7748571072,14427,14487,252,264,4,4,4,4,5,1,1,0,0,0,14,18,3,3,1,2,0,1,1,0,0,0,10,540235,-60,-12,0,0,4,1,0,-4,0,-1
KR_7748585051,14603,15672,294,303,2,4,4,2,4,7,0,0,0,0,15,72,4,7,1,2,0,1,0,0,0,0,10,540271,-1069,-9,-2,2,-3,0,0,-57,-3,-1
KR_7748592333,17062,15832,278,299,8,5,5,8,8,8,1,0,0,0,11,16,4,3,2,0,1,0,1,0,0,0,10,540250,1230,-21,3,-3,0,1,0,-5,1,2
KR_7748605330,17527,14209,291,226,9,3,3,9,8,3,1,0,0,0,14,13,3,6,3,1,1,0,1,0,0,0,10,540204,3318,65,6,-6,5,1,0,1,-3,2
KR_7748621247,15182,14874,276,280,5,3,3,5,5,2,0,1,0,0,16,12,1,2,1,1,1,0,0,1,0,0,10,540234,308,-4,2,-2,3,-1,0,4,-1,0
KR_7748628150,17122,17672,228,260,10,11,11,10,17,10,0,0,0,0,43,34,5,3,1,2,0,1,0,0,0,0,10,540239,-550,-32,-1,1,7,0,0,9,2,-1
KR_7748633001,13149,15922,267,297,1,5,5,1,0,5,1,0,0,0,16,15,0,4,0,1,0,1,1,0,0,0,10,540246,-2773,-30,-4,4,-5,1,0,1,-4,-1
KR_7748634825,15671,14786,280,266,6,4,4,6,5,4,0,0,0,0,34,17,4,5,1,0,1,0,0,0,0,0,10,540216,885,14,2,-2,1,0,0,17,-1,1
KR_7748653476,15676,14645,231,235,9,5,5,9,8,2,0,0,0,0,15,16,1,3,0,2,0,1,0,0,0,0,10,540207,1031,-4,4,-4,6,0,0,-1,-2,-2
KR_7748662444,15476,16076,246,283,7,7,7,7,6,5,0,1,0,0,13,18,5,3,0,1,1,0,0,1,0,0,10,540237,-600,-37,0,0,1,-1,0,-5,2,-1
KR_7748683595,15166,14472,290,277,5,3,3,5,1,4,0,0,0,0,16,15,3,3,0,0,1,0,0,0,0,0,10,540236,694,13,2,-2,-3,0,0,1,0,0
KR_7748707212,16603,15158,274,267,8,7,7,8,8,3,0,0,0,0,40,21,6,5,0,0,0,1,0,0,0,0,10,540195,1445,7,1,-1,5,0,0,19,1,0
KR_7748715221,15292,15749,237,235,6,7,8,6,8,6,0,0,0,0,15,23,4,3,1,0,0,1,0,0,0,0,10,540260,-457,2,-1,2,2,0,0,-8,1,1
KR_7748732280,16966,14693,264,240,9,5,5,9,15,8,0,0,0,0,16,30,3,2,1,0,1,0,0,0,0,0,10,540244,2273,24,4,-4,7,0,0,-14,1,1
KR_7748733460,14026,13810,266,272,2,3,3,2,1,1,0,0,0,0,17,38,7,4,1,0,1,0,0,0,0,0,10,540241,216,-6,-1,1,0,0,0,-21,3,1
KR_7748735088,15063,13934,310,264,2,3,3,2,2,4,0,1,0,0,15,15,2,2,2,1,0,1,0,1,0,0,10,540205,1129,46,-1,1,-2,-1,0,0,0,1
KR_7748749868,14013,13768,288,270,1,2,2,1,2,1,1,0,0,0,40,16,3,2,0,1,1,0,1,0,0,0,10,540280,245,18,-1,1,1,1,0,24,1,-1
KR_7748750054,15944,14835,279,243,6,6,6,6,13,6,0,1,0,0,25,14,2,2,3,0,1,0,0,1,0,0,10,540201,1109,36,0,0,7,-1,0,11,0,3
KR_7748767580,15593,14958,262,276,7,3,3,7,6,4,0,0,0,0,17,19,3,4,0,1,1,0,0,0,0,0,10,540199,635,-14,4,-4,2,0,0,-2,-1,-1
KR_7748793800,16286,15127,238,232,9,5,6,9,12,4,0,0,0,0,22,99,3,3,1,0,1,0,0,0,0,0,10,540208,1159,6,4,-3,8,0,0,-77,0,1
KR_7748797405,15280,17801,249,291,5,10,10,5,5,11,0,1,0,0,14,14,2,3,0,1,1,0,0,1,0,0,10,540174,-2521,-42,-5,5,-6,-1,0,0,-1,-1
KR_7748815209,14652,14072,285,277,3,2,2,3,7,3,0,1,0,0,15,14,2,5,0,1,0,1,0,1,0,0,10,540234,580,8,1,-1,4,-1,0,1,-3,-1
KR_7748817962,12835,15747,259,294,0,6,6,0,0,4,0,0,0,0,20,14,3,5,1,1,0,1,0,0,0,0,10,540163,-2912,-35,-6,6,-4,0,0,6,-2,0
KR_7748840778,16559,14356,262,256,9,4,4,9,11,2,0,1,0,0,19,12,0,5,0,0,0,1,0,1,0,0,10,540223,2203,6,5,-5,9,-1,0,7,-5,0
KR_7748858879,15064,14885,292,302,4,2,2,4,3,3,0,1,0,0,18,16,4,4,1,0,0,1,0,1,0,0,10,540208,179,-10,2,-2,0,-1,0,2,0,1
KR_7748865925,15915,18999,245,269,6,13,13,6,11,22,0,0,0,0,15,20,1,2,2,2,0,1,0,0,0,0,10,540186,-3084,-24,-7,7,-11,0,0,-5,-1,0
KR_7748887499,14588,15730,274,279,3,5,5,3,7,9,1,0,0,0,18,32,1,4,1,0,1,0,1,0,0,0,10,540265,-1142,-5,-2,2,-2,1,0,-14,-3,1
KR_7748901677,16496,15435,226,208,10,9,9,10,10,13,0,0,0,0,12,24,3,2,1,1,1,0,0,0,0,0,10,540251,1061,18,1,-1,-3,0,0,-12,1,0
KR_7748913011,13713,14618,268,248,1,5,5,1,2,6,0,0,0,0,13,102,3,2,1,1,0,1,0,0,0,0,10,540223,-905,20,-4,4,-4,0,0,-89,1,0
KR_7748919520,17583,14444,223,217,13,5,5,13,15,6,0,0,0,0,15,17,4,2,0,0,1,0,0,0,0,0,10,540232,3139,6,8,-8,9,0,0,-2,2,0
KR_7748923660,16245,15677,248,247,8,9,9,8,8,13,0,1,0,0,15,17,2,0,2,0,0,1,0,1,0,0,10,540202,568,1,-1,1,-5,-1,0,-2,2,2
KR_7748931246,17187,15974,250,250,10,8,8,10,19,8,0,0,0,0,20,37,6,4,1,2,1,0,0,0,0,0,10,540279,1213,0,2,-2,11,0,0,-17,2,-1
KR_7748943719,14937,13193,281,247,5,1,1,5,2,0,0,1,0,0,17,16,1,3,0,2,1,0,0,1,0,0,10,540204,1744,34,4,-4,2,-1,0,1,-2,-2
KR_7748990027,15340,15301,252,259,6,7,7,6,6,5,0,0,0,0,37,18,6,4,0,0,0,1,0,0,0,0,10,540088,39,-7,-1,1,1,0,0,19,2,0
KR_7748996665,17051,13164,272,230,10,2,3,10,8,0,0,0,0,0,18,10,1,2,1,0,1,0,0,0,0,0,10,540212,3887,42,8,-7,8,0,0,8,-1,1
KR_7749001636,14297,15798,258,299,4,4,4,4,4,4,0,0,0,0,14,13,1,2,1,1,1,0,0,0,0,0,10,540185,-1501,-41,0,0,0,0,0,1,-1,0
KR_7749006534,16475,15152,247,297,9,4,4,9,18,4,1,0,0,0,21,16,1,2,0,1,0,1,1,0,0,0,10,540264,1323,-50,5,-5,14,1,0,5,-1,-1
KR_7749010164,15216,16322,275,282,5,6,6,5,8,8,1,0,0,0,18,16,6,3,0,1,1,0,1,0,0,0,10,540257,-1106,-7,-1,1,0,1,0,2,3,-1
KR_7749011469,14988,13803,264,246,4,2,2,4,8,3,0,0,0,0,14,17,2,5,1,0,1,0,0,0,0,0,10,540202,1185,18,2,-2,5,0,0,-3,-3,1
KR_7749017259,17712,15241,269,233,11,6,6,11,17,6,0,0,0,0,18,33,8,3,2,0,1,0,0,0,0,0,10,540115,2471,36,5,-5,11,0,0,-15,5,2
KR_7749017663,16194,15217,283,272,6,5,5,6,9,6,0,0,0,0,29,20,5,3,1,1,0,1,0,0,0,0,10,540208,977,11,1,-1,3,0,0,9,2,0
KR_7749019045,14470,14470,257,274,4,3,3,5,5,3,0,0,0,0,17,31,2,4,0,1,0,1,0,0,0,0,10,540271,0,-17,1,-2,2,0,0,-14,-2,-1
KR_7749039852,15741,14815,260,255,7,4,4,7,4,4,0,0,0,0,36,18,2,2,1,0,1,0,0,0,0,0,10,540213,926,5,3,-3,0,0,0,18,0,1
KR_7749063739,13293,13780,271,275,1,1,1,1,1,1,0,0,0,0,59,17,3,3,0,1,1,0,0,0,0,0,10,540203,-487,-4,0,0,0,0,0,42,0,-1
KR_7749067444,16160,18267,198,235,11,13,14,11,19,17,0,1,0,0,21,19,3,5,0,1,0,1,0,1,0,0,10,540242,-2107,-37,-2,3,2,-1,0,2,-2,-1
KR_7749068073,15344,14496,240,254,6,4,4,6,7,3,0,1,0,0,31,13,0,3,1,1,1,0,0,1,0,0,10,540265,848,-14,2,-2,4,-1,0,18,-3,0
KR_7749106292,14322,14896,262,269,3,4,4,3,7,4,0,1,0,0,16,13,5,1,0,2,0,1,0,1,0,0,10,540097,-574,-7,-1,1,3,-1,0,3,4,-2
KR_7749111144,12707,16332,237,264,1,8,8,1,1,13,0,0,0,0,17,39,4,6,0,0,0,1,0,0,0,0,10,540245,-3625,-27,-7,7,-12,0,0,-22,-2,0
KR_7749115624,14150,14045,296,281,1,1,2,1,1,1,0,1,0,0,21,20,2,4,0,0,1,0,0,1,0,0,10,540249,105,15,0,1,0,-1,0,1,-2,0
KR_7749117869,16239,14570,300,307,6,3,3,6,6,1,0,0,0,0,50,12,6,8,0,0,0,1,0,0,0,0,10,540221,1669,-7,3,-3,5,0,0,38,-2,0
KR_7749119426,13723,13653,279,278,2,1,1,2,1,3,0,0,0,0,15,39,2,1,0,0,1,0,0,0,0,0,10,540217,70,1,1,-1,-2,0,0,-24,1,0
KR_7749138607,16032,13881,273,249,7,3,3,7,8,2,1,0,0,0,17,14,2,4,0,0,0,1,1,0,0,0,10,540217,2151,24,4,-4,6,1,0,3,-2,0
KR_7749138632,17468,15673,282,297,8,4,4,8,14,10,0,0,0,0,31,19,4,4,0,0,1,0,0,0,0,0,10,540266,1795,-15,4,-4,4,0,0,12,0,0
KR_7749141982,13337,14719,241,277,2,4,4,2,2,4,0,0,0,0,12,17,3,1,0,0,0,1,0,0,0,0,10,540233,-1382,-36,-2,2,-2,0,0,-5,2,0
KR_7749154387,15698,15623,260,250,6,7,7,6,8,6,0,0,0,0,14,24,6,2,0,0,1,0,0,0,0,0,10,540252,75,10,-1,1,2,0,0,-10,4,0
KR_7749163470,15423,12799,276,258,4,0,0,4,8,0,0,0,0,0,18,17,4,1,1,0,1,0,0,0,0,0,10,540180,2624,18,4,-4,8,0,0,1,3,1
KR_7749165117,13808,16032,287,289,2,6,6,3,0,10,0,1,0,0,18,16,4,4,0,1,0,1,0,1,0,0,10,540207,-2224,-2,-4,3,-10,-1,0,2,0,-1
KR_7749171269,14366,14674,271,266,3,5,5,3,4,7,0,0,0,0,18,45,2,3,0,0,1,0,0,0,0,0,10,540236,-308,5,-2,2,-3,0,0,-27,-1,0
KR_7749180215,15216,15074,227,254,7,5,5,7,8,7,0,1,0,0,39,17,4,3,0,1,1,0,0,1,0,0,10,540224,142,-27,2,-2,1,-1,0,22,1,-1
KR_7749191438,13336,17420,218,269,2,10,10,2,2,9,0,0,0,0,17,18,2,4,0,2,0,1,0,0,0,0,10,540196,-4084,-51,-8,8,-7,0,0,-1,-2,-2
KR_7749196757,16596,14125,282,275,7,3,3,7,5,3,0,1,0,0,14,13,4,2,2,1,0,1,0,1,0,0,10,540275,2471,7,4,-4,2,-1,0,1,2,1
KR_7749198768,15286,16281,250,264,6,7,7,6,5,5,1,0,0,0,14,21,4,2,0,2,0,1,1,0,0,0,10,540250,-995,-14,-1,1,0,1,0,-7,2,-2
KR_7749199086,16155,13790,278,256,6,3,3,6,7,2,0,0,0,0,36,19,4,2,0,0,0,1,0,0,0,0,10,540278,2365,22,3,-3,5,0,0,17,2,0
KR_7749210815,15896,16819,250,241,9,9,9,9,7,11,0,0,0,0,16,13,2,6,0,2,0,1,0,0,0,0,10,540267,-923,9,0,0,-4,0,0,3,-4,-2
KR_7749212555,13644,16897,216,267,3,10,10,3,4,11,0,0,0,0,130,27,0,3,0,0,0,1,0,0,0,0,10,540225,-3253,-51,-7,7,-7,0,0,103,-3,0
KR_7749224730,14764,15353,267,261,5,5,5,5,5,6,0,0,0,0,15,15,3,5,0,0,1,0,0,0,0,0,10,540271,-589,6,0,0,-1,0,0,0,-2,0
KR_7749227059,13238,15656,244,278,2,6,6,2,1,7,1,0,0,0,18,34,2,1,0,0,0,1,1,0,0,0,10,540177,-2418,-34,-4,4,-6,1,0,-16,1,0
KR_7749231661,14448,15674,255,270,4,7,7,4,3,8,0,1,0,0,37,16,2,4,1,0,1,0,0,1,0,0,10,540260,-1226,-15,-3,3,-5,-1,0,21,-2,1
KR_7749233934,14256,14676,250,272,3,3,3,3,3,3,0,0,0,0,20,19,5,2,0,1,1,0,0,0,0,0,10,540206,-420,-22,0,0,0,0,0,1,3,-1
KR_7749244925,14872,14708,254,273,4,4,4,4,6,2,0,1,0,0,16,15,2,1,0,2,1,0,0,1,0,0,10,540102,164,-19,0,0,4,-1,0,1,1,-2
KR_7749257094,14706,16682,287,291,3,8,8,3,6,7,0,0,0,0,34,17,3,4,0,0,0,1,0,0,0,0,10,540218,-1976,-4,-5,5,-1,0,0,17,-1,0
KR_7749262861,14369,14186,270,259,3,4,5,3,2,3,0,1,0,0,13,19,5,2,0,1,1,0,0,1,0,0,10,540289,183,11,-1,2,-1,-1,0,-6,3,-1
KR_7749264693,14874,14391,307,267,3,3,3,3,2,5,1,0,0,0,15,38,6,0,0,0,1,0,1,0,0,0,10,540245,483,40,0,0,-3,1,0,-23,6,0
KR_7749268590,14623,16976,270,262,3,10,10,3,3,13,0,0,0,0,16,15,3,3,0,2,1,0,0,0,0,0,10,540259,-2353,8,-7,7,-10,0,0,1,0,-2
KR_7749274933,15906,15671,267,252,8,7,7,8,4,9,0,0,0,0,14,14,1,4,1,0,0,1,0,0,0,0,10,540256,235,15,1,-1,-5,0,0,0,-3,1
KR_7749276036,14866,15720,252,271,5,7,7,5,4,7,0,1,0,0,16,18,1,4,0,1,0,1,0,1,0,0,10,540285,-854,-19,-2,2,-3,-1,0,-2,-3,-1
KR_7749276561,15159,15489,298,269,4,6,6,4,3,6,0,1,0,0,22,27,5,2,0,0,0,1,0,1,0,0,10,540243,-330,29,-2,2,-3,-1,0,-5,3,0
KR_7749283039,15187,14577,271,261,5,4,5,5,6,5,1,0,0,0,29,18,3,2,0,0,1,0,1,0,0,0,10,540230,610,10,1,0,1,1,0,11,1,0
KR_7749295261,13493,16876,234,279,3,8,8,3,2,9,0,1,0,0,14,125,5,1,0,2,0,1,0,1,0,0,10,540250,-3383,-45,-5,5,-7,-1,0,-111,4,-2
KR_7749297633,14339,17069,269,286,3,10,10,3,4,9,0,0,0,0,23,21,8,5,0,0,0,1,0,0,0,0,10,540188,-2730,-17,-7,7,-5,0,0,2,3,0
KR_7749313582,14086,15926,260,275,4,7,7,4,3,6,1,0,0,0,33,21,3,1,0,0,1,0,1,0,0,0,10,540241,-1840,-15,-3,3,-3,1,0,12,2,0
KR_7749316603,17188,15335,289,274,8,5,5,8,9,5,1,0,0,0,39,13,1,4,2,2,1,0,1,0,0,0,10,540226,1853,15,3,-3,4,1,0,26,-3,0
KR_7749318235,13499,15436,241,281,2,6,6,2,1,7,0,1,0,0,16,18,1,1,0,0,0,1,0,1,0,0,10,540199,-1937,-40,-4,4,-6,-1,0,-2,0,0
KR_7749321976,14634,15543,274,276,4,5,5,4,3,5,0,0,0,0,13,15,1,1,0,1,1,0,0,0,0,0,10,540216,-909,-2,-1,1,-2,0,0,-2,0,-1
KR_7749328014,17098,15105,250,250,10,6,6,10,11,6,0,0,0,0,18,17,4,5,0,0,0,1,0,0,0,0,10,540236,1993,0,4,-4,5,0,0,1,-1,0
KR_7749337609,14917,15581,263,257,4,6,6,4,7,5,0,0,0,0,37,36,7,4,2,0,1,0,0,0,0,0,10,540245,-664,6,-2,2,2,0,0,1,3,2
KR_7749340081,14304,14952,292,286,2,4,4,2,0,7,0,0,0,0,17,38,4,3,0,0,0,1,0,0,0,0,10,540274,-648,6,-2,2,-7,0,0,-21,1,0
KR_7749341568,14962,14582,241,273,5,4,4,5,8,3,1,0,0,0,17,17,4,4,0,0,1,0,1,0,0,0,10,540191,380,-32,1,-1,5,1,0,0,0,0
KR_7749348994,14421,14464,283,261,2,3,3,2,5,4,1,0,0,0,18,17,1,2,2,1,0,1,1,0,0,0,10,540225,-43,22,-1,1,1,1,0,1,-1,1
KR_7749353366,16694,13511,295,246,7,2,2,7,9,4,0,0,0,0,18,33,2,2,1,0,1,0,0,0,0,0,10,540197,3183,49,5,-5,5,0,0,-15,0,1
KR_7749360296,15302,15126,258,292,5,5,5,5,11,2,1,0,0,0,10,17,6,1,2,1,1,0,1,0,0,0,10,540230,176,-34,0,0,9,1,0,-7,5,1
KR_7749365827,17584,14419,290,235,9,4,4,9,15,8,0,1,0,0,86,36,3,1,0,0,0,1,0,1,0,0,10,540223,3165,55,5,-5,7,-1,0,50,2,0
KR_7749368575,16629,13695,282,263,7,2,2,7,7,2,0,0,0,0,141,112,1,2,0,0,1,0,0,0,0,0,10,540096,2934,19,5,-5,5,0,0,29,-1,0
KR_7749372584,14613,16921,250,248,6,9,9,6,3,13,0,0,0,0,31,15,6,3,0,0,1,0,0,0,0,0,10,540195,-2308,2,-3,3,-10,0,0,16,3,0
KR_7749386961,16133,12070,255,223,7,0,1,7,9,0,0,0,0,0,36,39,3,2,1,0,1,0,0,0,0,0,10,540257,4063,32,7,-6,9,0,0,-3,1,1
KR_7749391218,15925,15343,267,274,7,5,5,7,5,6,0,0,0,0,16,17,3,4,1,0,0,1,0,0,0,0,10,540211,582,-7,2,-2,-1,0,0,-1,-1,1
KR_7749396040,14600,14257,281,278,3,3,3,3,4,2,0,1,0,0,17,17,3,4,0,0,0,1,0,1,0,0,10,540259,343,3,0,0,2,-1,0,0,-1,0
KR_7749401984,14175,17253,222,246,4,11,11,5,5,14,0,0,0,0,17,87,0,4,1,2,0,1,0,0,0,0,10,540239,-3078,-24,-7,6,-9,0,0,-70,-4,-1
KR_7749403190,15448,14538,266,220,7,5,5,7,6,6,0,0,0,0,17,13,4,2,0,0,0,1,0,0,0,0,10,540242,910,46,2,-2,0,0,0,4,2,0
KR_7749414192,13772,14839,267,318,2,2,2,2,2,2,0,0,0,0,23,13,1,5,0,1,0,1,0,0,0,0,10,540194,-1067,-51,0,0,0,0,0,10,-4,-1
KR_7749421765,14908,17225,269,286,4,10,10,4,3,8,0,0,0,0,15,21,4,1,0,0,0,1,0,0,0,0,10,540232,-2317,-17,-6,6,-5,0,0,-6,3,0
KR_7749424076,15342,15517,260,270,7,6,6,7,4,11,0,1,0,0,14,15,3,4,0,0,1,0,0,1,0,0,10,540241,-175,-10,1,-1,-7,-1,0,-1,-1,0
KR_7749424090,16231,17134,273,271,7,10,10,7,7,7,0,1,0,0,16,18,4,1,0,1,0,1,0,1,0,0,10,540207,-903,2,-3,3,0,-1,0,-2,3,-1
KR_7749431703,14852,15525,265,295,5,4,4,5,6,4,0,1,0,0,15,17,3,3,0,1,1,0,0,1,0,0,10,540234,-673,-30,1,-1,2,-1,0,-2,0,-1
KR_7749442580,16107,14057,278,270,6,1,1,6,8,1,0,0,0,0,11,14,2,2,0,2,1,0,0,0,0,0,10,540226,2050,8,5,-5,7,0,0,-3,0,-2
KR_7749450576,14272,13448,255,245,4,2,2,5,1,3,0,0,0,0,34,15,3,3,1,0,1,0,0,0,0,0,10,540196,824,10,2,-3,-2,0,0,19,0,1
KR_7749456607,15540,13363,305,268,5,1,1,5,1,1,0,1,0,0,16,16,2,6,2,0,1,0,0,1,0,0,10,540184,2177,37,4,-4,0,-1,0,0,-4,2
KR_7749459544,12578,15470,230,278,1,6,6,1,1,5,0,1,0,0,13,14,3,2,0,2,0,1,0,1,0,0,10,540226,-2892,-48,-5,5,-4,-1,0,-1,1,-2
KR_7749459634,15422,15476,299,256,5,5,5,5,4,8,0,1,0,0,22,16,0,7,0,2,1,0,0,1,0,0,10,540197,-54,43,0,0,-4,-1,0,6,-7,-2
KR_7749466998,16287,13184,256,228,7,2,2,7,8,3,0,1,0,0,57,10,2,5,1,1,1,0,0,1,0,0,10,540221,3103,28,5,-5,5,-1,0,47,-3,0
KR_7749486461,16546,12744,271,253,8,0,0,8,13,0,0,1,0,0,18,18,3,3,0,0,1,0,0,1,0,0,10,540105,3802,18,8,-8,13,-1,0,0,0,0
KR_7749489328,13962,16053,248,221,3,10,10,3,2,13,0,0,0,0,17,16,0,3,0,0,1,0,0,0,0,0,10,540263,-2091,27,-7,7,-11,0,0,1,-3,0
KR_7749489972,15901,13897,282,256,6,3,3,6,3,2,0,1,0,0,12,16,2,2,1,0,1,0,0,1,0,0,10,540233,2004,26,3,-3,1,-1,0,-4,0,1
KR_7749503666,16715,14224,260,236,9,4,4,9,11,1,0,0,0,0,19,26,1,2,0,0,1,0,0,0,0,0,10,540188,2491,24,5,-5,10,0,0,-7,-1,0
KR_7749514508,16414,15975,230,221,10,9,9,10,10,12,1,0,0,0,16,14,1,4,1,2,0,1,1,0,0,0,10,540314,439,9,1,-1,-2,1,0,2,-3,-1
KR_7749523961,15032,14940,226,244,7,4,4,8,5,7,1,0,0,0,12,20,0,3,2,2,1,0,1,0,0,0,10,540258,92,-18,3,-4,-2,1,0,-8,-3,0
KR_7749560476,14249,15367,245,251,4,7,7,4,5,5,1,0,0,0,18,18,4,4,0,0,1,0,1,0,0,0,10,540205,-1118,-6,-3,3,0,1,0,0,0,0
KR_7749569203,16862,14019,272,255,9,3,3,9,10,2,1,0,0,0,62,16,2,5,0,1,0,1,1,0,0,0,10,540238,2843,17,6,-6,8,1,0,46,-3,-1
KR_7749625162,17536,13278,277,229,10,2,2,10,14,6,0,1,0,0,24,15,3,8,1,0,1,0,0,1,0,0,10,540227,4258,48,8,-8,8,-1,0,9,-5,1
KR_7749627830,15345,13877,266,274,6,2,2,6,8,2,0,0,0,0,37,17,3,5,0,0,1,0,0,0,0,0,10,540188,1468,-8,4,-4,6,0,0,20,-2,0
KR_7749651641,15544,15749,225,230,6,7,7,6,6,10,0,0,0,0,25,26,3,2,1,1,1,0,0,0,0,0,10,540255,-205,-5,-1,1,-4,0,0,-1,1,0
KR_7749673630,19470,15783,271,195,14,9,9,14,15,14,0,0,0,0,15,12,3,4,6,0,1,0,0,0,0,0,10,540220,3687,76,5,-5,1,0,0,3,-1,6
KR_7749690566,16323,15968,280,263,6,7,7,6,11,12,0,0,0,0,16,14,5,5,2,0,0,1,0,0,0,0,10,540289,355,17,-1,1,-1,0,0,2,0,2
KR_7749715323,16095,16587,254,207,7,12,12,7,8,15,0,0,0,0,13,25,3,2,0,1,0,1,0,0,0,0,10,540208,-492,47,-5,5,-7,0,0,-12,1,-1
KR_7749746079,15369,14787,281,263,4,5,5,4,3,5,0,0,0,0,14,22,6,5,0,1,0,1,0,0,0,0,10,540267,582,18,-1,1,-2,0,0,-8,1,-1
KR_7749749894,16896,13836,292,262,8,2,2,8,9,3,1,0,0,0,15,16,2,1,1,1,1,0,1,0,0,0,10,540226,3060,30,6,-6,6,1,0,-1,1,0
KR_7749752789,16343,14737,283,280,8,3,3,8,7,5,0,1,0,0,39,31,8,4,0,0,1,0,0,1,0,0,10,540126,1606,3,5,-5,2,-1,0,8,4,0
KR_7749770194,13655,15992,271,282,2,7,7,2,0,7,0,0,0,0,18,16,4,6,0,0,0,1,0,0,0,0,10,540266,-2337,-11,-5,5,-7,0,0,2,-2,0
KR_7749771956,15038,14010,292,292,3,1,1,3,7,0,0,1,0,0,12,14,2,0,2,0,1,0,0,1,0,0,10,540220,1028,0,2,-2,7,-1,0,-2,2,2
KR_7749779111,15051,15601,301,285,3,5,5,3,2,4,0,0,0,0,16,15,3,6,0,1,1,0,0,0,0,0,10,540281,-550,16,-2,2,-2,0,0,1,-3,-1
KR_7749796047,15541,15912,240,250,6,6,6,6,8,6,0,1,0,0,43,16,5,14,0,0,1,0,0,1,0,0,10,540272,-371,-10,0,0,2,-1,0,27,-9,0
KR_7749797021,17351,13262,289,250,9,1,1,9,11,1,1,0,0,0,17,10,2,3,2,0,1,0,1,0,0,0,10,540197,4089,39,8,-8,10,1,0,7,-1,2
KR_7749817279,15912,13965,308,258,5,3,3,5,5,1,0,0,0,0,20,17,5,3,0,0,1,0,0,0,0,0,10,540246,1947,50,2,-2,4,0,0,3,2,0
KR_7749822382,15287,14559,264,229,4,6,6,4,5,8,0,0,0,0,15,15,3,3,3,0,1,0,0,0,0,0,10,540235,728,35,-2,2,-3,0,0,0,0,3
KR_7749825130,14533,14382,284,281,3,3,3,3,4,6,1,0,0,0,13,15,3,4,1,0,1,0,1,0,0,0,10,540206,151,3,0,0,-2,1,0,-2,-1,1
KR_7749828590,15947,15580,262,238,8,7,7,8,6,7,1,0,0,0,37,15,2,2,0,0,0,1,1,0,0,0,10,540251,367,24,1,-1,-1,1,0,22,0,0
KR_7749847887,14197,13943,311,271,1,2,2,1,1,2,0,0,0,0,18,17,5,1,1,0,0,1,0,0,0,0,10,540190,254,40,-1,1,-1,0,0,1,4,1
KR_7749850163,17413,13665,266,244,10,3,3,10,17,1,0,1,0,0,30,17,6,4,1,0,1,0,0,1,0,0,10,540250,3748,22,7,-7,16,-1,0,13,2,1
KR_7749857526,15738,16387,258,223,7,10,10,7,5,11,0,1,0,0,18,15,3,4,1,2,0,1,0,1,0,0,10,540233,-649,35,-3,3,-6,-1,0,3,-1,-1
KR_7749861998,14775,14250,283,278,3,2,2,3,3,4,0,0,0,0,20,50,4,3,0,0,0,1,0,0,0,0,10,540218,525,5,1,-1,-1,0,0,-30,1,0
KR_7749876518,15602,16844,232,253,8,9,9,8,9,10,0,0,0,0,13,30,3,2,0,0,1,0,0,0,0,0,10,540254,-1242,-21,-1,1,-1,0,0,-17,1,0
KR_7749889323,15664,18247,250,245,6,13,13,6,6,14,0,0,0,0,19,14,2,2,0,1,0,1,0,0,0,0,10,540279,-2583,5,-7,7,-8,0,0,5,0,-1
KR_7749900441,15052,18213,249,282,5,12,12,5,6,16,0,0,0,0,17,18,3,3,2,0,0,1,0,0,0,0,10,540272,-3161,-33,-7,7,-10,0,0,-1,0,2
KR_7749906764,14042,13994,283,267,2,2,2,2,1,1,0,0,0,0,39,17,5,6,0,1,1,0,0,0,0,0,10,540293,48,16,0,0,0,0,0,22,-1,-1
KR_7749911516,15415,15592,276,277,5,5,5,5,6,7,0,0,0,0,15,28,1,4,1,0,1,0,0,0,0,0,10,540229,-177,-1,0,0,-1,0,0,-13,-3,1
KR_7749913554,13111,14259,284,284,0,2,2,0,0,1,1,0,0,0,35,14,6,4,0,0,0,1,1,0,0,0,10,540211,-1148,0,-2,2,-1,1,0,21,2,0
KR_7749916079,14838,15455,270,283,4,4,4,4,10,3,0,0,0,0,15,16,5,2,0,1,1,0,0,0,0,0,10,540188,-617,-13,0,0,7,0,0,-1,3,-1
KR_7749921339,14566,15903,259,287,4,6,6,4,4,6,0,0,0,0,12,68,4,1,1,0,0,1,0,0,0,0,10,540109,-1337,-28,-2,2,-2,0,0,-56,3,1
KR_7749927725,16003,15138,301,318,5,3,3,5,6,4,0,1,0,0,16,26,3,5,0,0,1,0,0,1,0,0,10,540229,865,-17,2,-2,2,-1,0,-10,-2,0
KR_7749933833,14675,15232,240,278,5,4,4,5,7,3,0,1,0,0,15,37,1,1,0,2,0,1,0,1,0,0,10,540234,-557,-38,1,-1,4,-1,0,-22,0,-2
KR_7749938287,16701,16841,248,243,9,11,11,9,10,15,0,0,0,0,27,19,5,3,1,1,0,1,0,0,0,0,10,540244,-140,5,-2,2,-5,0,0,8,2,0
KR_7749958170,14221,15440,232,240,6,7,7,6,2,7,0,0,0,0,16,15,3,3,0,2,0,1,0,0,0,0,10,540275,-1219,-8,-1,1,-5,0,0,1,0,-2
KR_7749965901,15377,14835,263,261,5,5,6,5,8,5,0,0,0,0,20,15,0,3,0,0,1,0,0,0,0,0,10,540236,542,2,0,1,3,0,0,5,-3,0
KR_7749966085,18138,13039,281,237,11,2,2,11,15,2,0,0,0,0,16,19,2,0,1,0,1,0,0,0,0,0,10,540259,5099,44,9,-9,13,0,0,-3,2,1
KR_7749971400,14522,14682,277,283,3,3,3,3,4,3,1,0,0,0,15,12,2,3,1,1,1,0,1,0,0,0,10,540230,-160,-6,0,0,1,1,0,3,-1,0
KR_7749972601,15276,15078,275,276,4,4,4,4,6,6,0,1,0,0,20,62,4,6,1,0,0,1,0,1,0,0,10,540185,198,-1,0,0,0,-1,0,-42,-2,1
KR_7750002478,17287,15499,266,234,10,7,7,10,13,13,1,0,0,0,17,17,6,5,1,0,1,0,1,0,0,0,10,540184,1788,32,3,-3,0,1,0,0,1,1
KR_7750002727,15857,15618,245,251,8,5,5,8,7,7,0,0,0,0,195,12,1,3,2,0,0,1,0,0,0,0,10,540217,239,-6,3,-3,0,0,0,183,-2,2
KR_7750016540,14993,15642,250,276,4,5,5,4,5,3,0,0,0,0,21,17,2,1,2,1,1,0,0,0,0,0,10,540231,-649,-26,-1,1,2,0,0,4,1,1
KR_7750026469,15820,16356,238,280,8,6,6,8,9,9,0,1,0,0,15,15,3,6,0,2,1,0,0,1,0,0,10,540217,-536,-42,2,-2,0,-1,0,0,-3,-2
KR_7750030094,15638,15508,217,234,8,7,7,8,12,8,0,0,0,0,16,42,7,1,1,1,1,0,0,0,0,0,10,540232,130,-17,1,-1,4,0,0,-26,6,0
KR_7750032518,13918,15518,269,286,2,5,5,3,4,7,1,0,0,0,36,15,2,4,0,1,1,0,1,0,0,0,10,540204,-1600,-17,-3,2,-3,1,0,21,-2,-1
KR_7750042674,13627,16181,279,265,1,7,7,2,0,8,0,0,0,0,15,20,3,2,0,1,0,1,0,0,0,0,10,540230,-2554,14,-6,5,-8,0,0,-5,1,-1
KR_7750072819,16161,13238,287,288,7,0,0,7,6,0,1,0,0,0,19,17,7,2,0,0,1,0,1,0,0,0,10,540227,2923,-1,7,-7,6,1,0,2,5,0
KR_7750081548,16168,13710,242,255,8,2,2,8,5,1,0,0,0,0,55,18,4,2,2,0,1,0,0,0,0,0,10,540272,2458,-13,6,-6,4,0,0,37,2,2
KR_7750081866,14197,17269,233,288,4,9,9,4,3,3,0,0,0,0,17,23,3,2,0,3,0,1,0,0,0,0,10,540224,-3072,-55,-5,5,0,0,0,-6,1,-3
KR_7750082611,14518,15337,265,256,4,5,5,4,5,5,0,1,0,0,12,13,2,4,0,2,0,1,0,1,0,0,10,540168,-819,9,-1,1,0,-1,0,-1,-2,-2
KR_7750094587,15434,14822,269,276,7,4,4,7,4,3,1,0,0,0,16,15,2,4,1,0,1,0,1,0,0,0,10,540201,612,-7,3,-3,1,1,0,1,-2,1
KR_7750103164,15075,14813,286,286,4,3,3,4,4,4,0,0,0,0,18,20,3,4,0,0,0,1,0,0,0,0,10,540237,262,0,1,-1,0,0,0,-2,-1,0
KR_7750113389,16757,14988,277,258,8,5,5,8,8,10,0,1,0,0,17,17,3,5,0,0,1,0,0,1,0,0,10,540198,1769,19,3,-3,-2,-1,0,0,-2,0
KR_7750123374,15154,18242,228,259,7,11,11,7,4,13,0,0,0,0,54,37,6,3,1,0,1,0,0,0,0,0,10,540258,-3088,-31,-4,4,-9,0,0,17,3,1
KR_7750123895,15830,14967,255,260,6,4,4,6,6,7,0,1,0,0,16,74,2,2,0,0,1,0,0,1,0,0,10,540220,863,-5,2,-2,-1,-1,0,-58,0,0
KR_7750142820,14598,15319,266,264,4,5,5,4,7,4,0,0,0,0,37,15,2,4,1,0,1,0,0,0,0,0,10,540254,-721,2,-1,1,3,0,0,22,-2,1
KR_7750155160,15465,14324,252,235,5,5,5,5,6,2,0,1,0,0,52,17,2,4,1,1,1,0,0,1,0,0,10,540203,1141,17,0,0,4,-1,0,35,-2,0
KR_7750155580,14590,13842,272,244,3,2,2,3,2,3,0,1,0,0,16,22,3,3,0,0,1,0,0,1,0,0,10,540264,748,28,1,-1,-1,-1,0,-6,0,0
KR_7750164544,15213,15595,284,254,4,6,6,4,6,8,0,0,0,0,14,16,8,1,1,1,1,0,0,0,0,0,10,540229,-382,30,-2,2,-2,0,0,-2,7,0
KR_7750165528,14834,16839,229,242,6,10,10,6,5,11,0,0,0,0,14,18,2,2,0,0,0,1,0,0,0,0,10,540242,-2005,-13,-4,4,-6,0,0,-4,0,0
KR_7750187764,15295,13797,258,271,5,2,2,5,7,1,0,0,0,0,17,12,1,5,0,0,0,1,0,0,0,0,10,540219,1498,-13,3,-3,6,0,0,5,-4,0
KR_7750188187,15492,15855,245,234,7,9,9,7,8,6,0,1,0,0,22,34,6,5,1,1,1,0,0,1,0,0,10,540219,-363,11,-2,2,2,-1,0,-12,1,0
KR_7750191707,14597,13768,265,258,4,2,2,5,4,2,0,0,0,0,31,17,0,3,0,0,1,0,0,0,0,0,10,540252,829,7,2,-3,2,0,0,14,-3,0
KR_7750200630,14157,13610,285,258,2,2,2,2,2,3,0,0,0,0,18,17,3,2,0,1,0,1,0,0,0,0,10,540272,547,27,0,0,-1,0,0,1,1,-1
KR_7750203892,15018,15166,268,258,6,6,6,6,1,4,0,0,0,0,22,12,2,3,1,0,1,0,0,0,0,0,10,540314,-148,10,0,0,-3,0,0,10,-1,1
KR_7750211928,16663,17580,258,276,8,11,11,8,14,17,0,0,0,0,9,29,4,1,1,0,1,0,0,0,0,0,10,540235,-917,-18,-3,3,-3,0,0,-20,3,1
KR_7750218964,15553,14291,292,276,5,2,2,5,7,2,1,0,0,0,22,23,5,3,0,1,1,0,1,0,0,0,10,540220,1262,16,3,-3,5,1,0,-1,2,-1
KR_7750230835,13586,14981,241,278,3,4,4,3,1,2,0,0,0,0,14,14,1,4,0,1,0,1,0,0,0,0,10,540134,-1395,-37,-1,1,-1,0,0,0,-3,-1
KR_7750243102,14789,15543,198,239,6,8,8,6,5,9,0,0,0,0,17,24,3,4,3,1,0,1,0,0,0,0,10,540254,-754,-41,-2,2,-4,0,0,-7,-1,2
KR_7750246653,16482,16590,255,298,8,7,7,8,8,4,1,0,0,0,26,11,3,3,0,1,0,1,1,0,0,0,10,540213,-108,-43,1,-1,4,1,0,15,0,-1
KR_7750261354,16839,14171,297,235,7,3,3,7,7,4,0,0,0,0,31,11,2,4,2,0,1,0,0,0,0,0,10,540236,2668,62,4,-4,3,0,0,20,-2,2
KR_7750273698,14912,14923,261,296,5,4,4,5,11,1,0,0,0,0,17,40,4,4,0,0,1,0,0,0,0,0,10,540221,-11,-35,1,-1,10,0,0,-23,0,0
KR_7750275706,16624,15991,262,258,7,7,7,7,8,10,0,0,0,0,22,15,2,3,0,0,0,1,0,0,0,0,10,540242,633,4,0,0,-2,0,0,7,-1,0
KR_7750278024,15087,17144,266,259,5,9,10,5,4,15,0,0,0,0,18,17,3,4,1,2,0,1,0,0,0,0,10,540230,-2057,7,-4,5,-11,0,0,1,-1,-1
KR_7750290535,14454,14820,264,235,4,6,6,4,4,6,0,1,0,0,31,13,2,2,0,0,1,0,0,1,0,0,10,540248,-366,29,-2,2,-2,-1,0,18,0,0
KR_7750291723,17445,12792,292,249,9,1,1,9,6,1,0,1,0,0,18,13,1,2,2,0,1,0,0,1,0,0,10,540114,4653,43,8,-8,5,-1,0,5,-1,2
KR_7750296273,16155,13761,249,237,8,3,3,8,7,2,0,0,0,0,42,173,0,7,3,1,0,1,0,0,0,0,10,540257,2394,12,5,-5,5,0,0,-131,-7,2
KR_7750304760,14973,15158,287,298,3,4,4,3,3,3,0,1,0,0,18,14,0,3,0,1,0,1,0,1,0,0,10,540273,-185,-11,-1,1,0,-1,0,4,-3,-1
KR_7750305598,16125,14068,300,248,6,3,3,6,7,3,0,0,0,0,18,14,7,4,0,0,1,0,0,0,0,0,10,540268,2057,52,3,-3,4,0,0,4,3,0
KR_7750319474,15920,16120,279,260,6,6,7,6,11,11,1,0,0,0,16,15,4,3,2,0,0,1,1,0,0,0,10,540229,-200,19,0,1,0,1,0,1,1,2
KR_7750326712,16002,15470,239,247,10,7,7,10,11,4,0,0,0,0,15,26,4,2,0,0,1,0,0,0,0,0,10,540280,532,-8,3,-3,7,0,0,-11,2,0
KR_7750329838,16999,14685,263,269,10,3,3,10,11,1,0,0,0,0,21,20,5,5,0,1,1,0,0,0,0,0,10,540243,2314,-6,7,-7,10,0,0,1,0,-1
KR_7750333709,14351,15543,258,275,4,6,6,4,3,6,0,1,0,0,21,14,3,5,1,1,0,1,0,1,0,0,10,540266,-1192,-17,-2,2,-3,-1,0,7,-2,0
KR_7750337131,12868,14644,260,294,0,3,3,0,0,2,1,0,0,0,15,16,2,4,0,0,0,1,1,0,0,0,10,540236,-1776,-34,-3,3,-2,1,0,-1,-2,0
KR_7750348629,14622,14913,291,308,1,3,3,1,1,3,0,1,0,0,20,39,3,4,1,0,0,1,0,1,0,0,10,540189,-291,-17,-2,2,-2,-1,0,-19,-1,1
KR_7750353748,17348,14784,260,219,9,5,6,9,17,9,0,0,0,0,13,93,3,3,1,1,1,0,0,0,0,0,10,540229,2564,41,4,-3,8,0,0,-80,0,0
KR_7750372042,14243,16762,244,265,3,8,8,3,4,8,0,0,0,0,43,22,3,2,0,1,0,1,0,0,0,0,10,540201,-2519,-21,-5,5,-4,0,0,21,1,-1
KR_7750381414,13713,15027,269,275,1,4,4,1,1,5,0,0,0,0,39,19,7,7,0,0,0,1,0,0,0,0,10,540220,-1314,-6,-3,3,-4,0,0,20,0,0
KR_7750390123,15005,15761,253,261,5,7,7,5,7,11,0,0,0,0,16,24,1,2,0,0,0,1,0,0,0,0,10,540259,-756,-8,-2,2,-4,0,0,-8,-1,0
KR_7750398420,15148,16115,296,313,4,6,6,4,2,6,0,1,0,0,17,21,5,3,0,0,1,0,0,1,0,0,10,540268,-967,-17,-2,2,-4,-1,0,-4,2,0
KR_7750423901,15614,14643,268,268,6,4,4,6,10,3,0,1,0,0,13,17,4,1,1,0,0,1,0,1,0,0,10,540239,971,0,2,-2,7,-1,0,-4,3,1
KR_7750425224,14612,16467,277,310,2,7,7,2,3,7,0,1,0,0,17,18,2,2,0,1,0,1,0,1,0,0,10,540218,-1855,-33,-5,5,-4,-1,0,-1,0,-1
KR_7750430019,14360,14552,277,263,2,5,5,2,2,6,0,1,0,0,16,15,1,1,1,1,0,1,0,1,0,0,10,540273,-192,14,-3,3,-4,-1,0,1,0,0
KR_7750433501,17284,16189,278,261,8,7,8,8,11,9,0,0,0,0,71,16,6,5,1,1,0,1,0,0,0,0,10,540276,1095,17,1,0,2,0,0,55,1,0
KR_7750438483,14866,15623,225,258,6,7,7,6,13,4,0,1,0,0,18,24,1,4,0,2,0,1,0,1,0,0,10,540208,-757,-33,-1,1,9,-1,0,-6,-3,-2
KR_7750496172,16025,15029,266,285,8,4,4,8,7,3,1,0,0,0,17,14,1,5,0,2,1,0,1,0,0,0,10,540208,996,-19,4,-4,4,1,0,3,-4,-2
KR_7750504835,15516,14317,268,259,5,2,2,5,6,2,1,0,0,0,29,22,5,1,0,3,0,1,1,0,0,0,10,540206,1199,9,3,-3,4,1,0,7,4,-3
KR_7750505678,14298,15981,275,297,2,6,7,2,3,8,0,1,0,0,44,15,0,4,1,0,0,1,0,1,0,0,10,540194,-1683,-22,-4,5,-5,-1,0,29,-4,1
KR_7750517848,16141,15166,281,282,6,4,4,6,8,9,1,0,0,0,16,30,1,1,1,1,1,0,1,0,0,0,10,540253,975,-1,2,-2,-1,1,0,-14,0,0
KR_7750523727,15163,14915,313,280,3,5,5,3,2,3,0,1,0,0,14,131,6,6,0,0,0,1,0,1,0,0,10,540282,248,33,-2,2,-1,-1,0,-117,0,0
KR_7750524029,15142,17100,279,303,4,6,6,4,6,16,0,0,0,0,18,17,2,5,0,0,0,1,0,0,0,0,10,540212,-1958,-24,-2,2,-10,0,0,1,-3,0
KR_7750546036,16446,15573,269,275,9,5,5,9,8,6,0,1,0,0,17,16,2,1,0,0,0,1,0,1,0,0,10,540204,873,-6,4,-4,2,-1,0,1,1,0
KR_7750574910,12733,14550,263,293,0,2,2,0,0,3,1,0,0,0,34,19,3,3,0,0,0,1,1,0,0,0,10,540218,-1817,-30,-2,2,-3,1,0,15,0,0
KR_7750576154,16727,13453,294,228,7,3,3,7,9,4,0,1,0,0,15,14,3,3,1,0,1,0,0,1,0,0,10,540213,3274,66,4,-4,5,-1,0,1,0,1
KR_7750592230,17209,15726,289,267,9,6,6,9,9,6,0,1,0,0,36,12,1,3,2,0,1,0,0,1,0,0,10,540224,1483,22,3,-3,3,-1,0,24,-2,2
KR_7750597110,15080,15008,296,269,5,5,5,5,5,4,0,1,0,0,13,16,5,1,0,0,1,0,0,1,0,0,10,540224,72,27,0,0,1,-1,0,-3,4,0
KR_7750604797,16880,14428,260,229,10,6,6,10,10,3,1,0,0,0,18,17,3,4,0,0,0,1,1,0,0,0,10,540218,2452,31,4,-4,7,1,0,1,-1,0
KR_7750620898,13557,15869,246,248,3,7,7,3,1,7,0,0,0,0,18,34,3,4,0,1,0,1,0,0,0,0,10,540233,-2312,-2,-4,4,-6,0,0,-16,-1,-1
KR_7750622881,14170,16778,259,271,3,9,9,3,3,10,0,0,0,0,16,39,2,4,0,0,0,1,0,0,0,0,10,540246,-2608,-12,-6,6,-7,0,0,-23,-2,0
KR_7750629307,17128,15956,283,259,10,7,7,10,10,7,0,0,0,0,14,18,2,2,0,0,1,0,0,0,0,0,10,540224,1172,24,3,-3,3,0,0,-4,0,0
KR_7750637013,15426,14491,256,247,6,5,5,6,7,5,0,0,0,0,11,14,2,2,1,0,1,0,0,0,0,0,10,540202,935,9,1,-1,2,0,0,-3,0,1
KR_7750648124,12508,15344,246,289,1,5,5,1,0,2,0,0,0,0,11,113,2,5,0,1,0,1,0,0,0,0,10,540186,-2836,-43,-4,4,-2,0,0,-102,-3,-1
KR_7750671985,16207,14711,299,292,6,2,2,6,6,3,1,0,0,0,22,20,6,1,1,0,1,0,1,0,0,0,10,540236,1496,7,4,-4,3,1,0,2,5,1
KR_7750673083,15909,13162,296,239,5,3,3,5,7,1,0,0,0,0,12,13,4,1,1,0,0,1,0,0,0,0,10,540274,2747,57,2,-2,6,0,0,-1,3,1
KR_7750688087,15472,14198,272,280,5,2,2,5,11,3,0,1,0,0,17,19,4,5,1,0,1,0,0,1,0,0,10,540248,1274,-8,3,-3,8,-1,0,-2,-1,1
KR_7750702522,14624,15525,270,259,3,6,6,3,2,8,1,0,0,0,17,16,3,5,0,0,1,0,1,0,0,0,10,540227,-901,11,-3,3,-6,1,0,1,-2,0
KR_7750706460,16805,14957,272,258,8,4,4,8,11,9,1,0,0,0,57,15,5,2,3,0,1,0,1,0,0,0,10,540230,1848,14,4,-4,2,1,0,42,3,3
KR_7750716843,16093,15828,246,242,8,8,8,8,9,11,0,0,0,0,34,16,1,1,0,0,0,1,0,0,0,0,10,540217,265,4,0,0,-2,0,0,18,0,0
KR_7750721853,15158,15779,273,259,4,6,6,4,5,7,0,0,0,0,19,15,8,5,0,2,0,1,0,0,0,0,10,540243,-621,14,-2,2,-2,0,0,4,3,-2
KR_7750751183,15467,17284,234,260,7,10,10,7,6,12,0,1,0,0,13,25,2,4,0,0,1,0,0,1,0,0,10,540255,-1817,-26,-3,3,-6,-1,0,-12,-2,0
KR_7750758137,13793,14721,251,287,2,3,3,2,3,2,0,0,0,0,19,23,1,3,0,1,0,1,0,0,0,0,10,540201,-928,-36,-1,1,1,0,0,-4,-2,-1
KR_7750766628,14466,15695,266,262,4,6,6,4,2,7,1,0,0,0,168,27,5,3,0,1,1,0,1,0,0,0,10,540251,-1229,4,-2,2,-5,1,0,141,2,-1
KR_7750771919,14254,14701,291,294,2,2,2,2,5,5,0,0,0,0,15,16,6,4,0,1,0,1,0,0,0,0,10,540238,-447,-3,0,0,0,0,0,-1,2,-1
KR_7750774053,14966,12220,279,224,4,1,1,5,2,0,0,1,0,0,21,15,4,3,1,0,1,0,0,1,0,0,10,540269,2746,55,3,-4,2,-1,0,6,1,1
KR_7750787815,13940,15556,262,253,3,8,8,3,2,7,0,1,0,0,14,20,5,6,0,0,0,1,0,1,0,0,10,540203,-1616,9,-5,5,-5,-1,0,-6,-1,0
KR_7750799563,16181,16322,259,291,7,7,7,7,11,8,0,0,0,0,21,15,1,7,0,0,0,1,0,0,0,0,10,540235,-141,-32,0,0,3,0,0,6,-6,0
KR_7750801000,15921,15948,275,267,6,6,6,6,9,8,1,0,0,0,35,17,6,2,2,0,0,1,1,0,0,0,10,540238,-27,8,0,0,1,1,0,18,4,2
KR_7750807345,15137,14794,321,278,3,4,4,3,1,6,0,1,0,0,19,11,1,2,0,0,1,0,0,1,0,0,10,540212,343,43,-1,1,-5,-1,0,8,-1,0
KR_7750823128,16076,15332,281,266,6,6,6,6,8,8,0,1,0,0,13,17,2,2,0,0,0,1,0,1,0,0,10,540254,744,15,0,0,0,-1,0,-4,0,0
KR_7750828120,16302,12857,253,266,8,0,0,8,8,0,0,0,0,0,19,14,3,3,2,0,1,0,0,0,0,0,10,540252,3445,-13,8,-8,8,0,0,5,0,2
KR_7750843547,16420,14170,292,293,6,2,2,6,7,3,0,1,0,0,23,18,6,2,0,0,0,1,0,1,0,0,10,540220,2250,-1,4,-4,4,-1,0,5,4,0
KR_7750844734,14549,14429,291,242,3,4,4,3,1,5,0,0,0,0,16,19,2,7,0,0,1,0,0,0,0,0,10,540233,120,49,-1,1,-4,0,0,-3,-5,0
KR_7750858485,15548,17713,238,305,7,10,10,7,11,10,0,1,0,0,13,13,2,2,0,2,0,1,0,1,0,0,10,540282,-2165,-67,-3,3,1,-1,0,0,0,-2
KR_7750867487,15436,14625,257,277,5,2,2,5,6,3,0,1,0,0,19,17,4,2,1,1,1,0,0,1,0,0,10,540220,811,-20,3,-3,3,-1,0,2,2,0
KR_7750872537,14100,14220,274,246,3,3,4,3,2,4,0,1,0,0,13,16,4,4,0,0,1,0,0,1,0,0,10,540266,-120,28,0,1,-2,-1,0,-3,0,0
KR_7750872762,15095,14870,272,304,5,3,4,5,4,1,0,1,0,0,37,14,3,6,1,1,0,1,0,1,0,0,10,540204,225,-32,2,-1,3,-1,0,23,-3,0
KR_7750898558,14491,17312,256,264,5,11,11,5,3,12,1,0,0,0,11,14,3,2,1,1,0,1,1,0,0,0,10,540183,-2821,-8,-6,6,-9,1,0,-3,1,0
KR_7750918751,14646,17043,231,230,4,10,10,4,7,10,0,0,0,0,17,16,4,3,2,1,1,0,0,0,0,0,10,540244,-2397,1,-6,6,-3,0,0,1,1,1
KR_7750928671,14767,14765,277,270,3,5,5,3,4,3,0,1,0,0,14,13,6,5,2,0,1,0,0,1,0,0,10,540246,2,7,-2,2,1,-1,0,1,1,2
KR_7750938404,15963,15109,237,247,8,5,5,8,6,6,0,0,0,0,16,14,2,4,3,1,1,0,0,0,0,0,10,540208,854,-10,3,-3,0,0,0,2,-2,2
KR_7750938943,15699,13924,253,248,6,4,4,6,12,1,0,0,0,0,17,16,1,3,0,1,0,1,0,0,0,0,10,540255,1775,5,2,-2,11,0,0,1,-2,-1
KR_7750944366,16217,18556,239,209,8,15,15,8,14,22,0,0,0,0,15,20,1,2,0,1,0,1,0,0,0,0,10,540238,-2339,30,-7,7,-8,0,0,-5,-1,-1
KR_7750950318,15951,14531,261,252,8,4,4,8,7,3,1,0,0,0,37,17,4,4,0,0,1,0,1,0,0,0,10,540249,1420,9,4,-4,4,1,0,20,0,0
KR_7750952492,14610,14573,279,270,3,4,5,3,4,7,0,1,0,0,14,16,7,3,0,1,0,1,0,1,0,0,10,540237,37,9,-1,2,-3,-1,0,-2,4,-1
KR_7750959172,17538,13532,314,266,8,1,1,8,10,1,0,1,0,0,16,18,2,2,1,0,1,0,0,1,0,0,10,540201,4006,48,7,-7,9,-1,0,-2,0,1
KR_7750967015,13182,15413,263,306,1,4,4,1,1,2,0,1,0,0,14,16,4,4,0,1,0,1,0,1,0,0,10,540236,-2231,-43,-3,3,-1,-1,0,-2,0,-1
KR_7750968871,14864,14563,267,221,4,5,5,4,3,8,0,0,0,0,16,15,2,2,1,1,0,1,0,0,0,0,10,540188,301,46,-1,1,-5,0,0,1,0,0
KR_7750984217,12979,16074,263,289,1,6,6,1,0,4,0,1,0,0,13,19,7,2,0,0,0,1,0,1,0,0,10,540206,-3095,-26,-5,5,-4,-1,0,-6,5,0
KR_7750996159,13483,17220,234,266,4,12,12,4,2,11,0,0,0,0,12,18,1,2,0,1,0,1,0,0,0,0,10,540240,-3737,-32,-8,8,-9,0,0,-6,-1,-1
KR_7750996219,16423,15060,276,294,7,3,3,7,15,5,0,1,0,0,16,19,1,4,0,1,1,0,0,1,0,0,10,540218,1363,-18,4,-4,10,-1,0,-3,-3,-1
KR_7751000767,13226,15259,279,315,0,2,2,0,0,2,0,0,0,0,13,22,4,1,0,2,0,1,0,0,0,0,10,540241,-2033,-36,-2,2,-2,0,0,-9,3,-2
KR_7751006801,14559,16134,268,266,2,7,7,3,3,8,0,1,0,0,12,43,5,4,0,1,0,1,0,1,0,0,10,540231,-1575,2,-5,4,-5,-1,0,-31,1,-1
KR_7751012625,14439,14258,258,238,5,4,4,5,3,6,1,0,0,0,20,15,4,1,0,0,1,0,1,0,0,0,10,540311,181,20,1,-1,-3,1,0,5,3,0
KR_7751026983,14138,14628,237,244,4,5,5,5,4,7,0,0,0,0,14,17,1,4,1,0,1,0,0,0,0,0,10,540261,-490,-7,-1,0,-3,0,0,-3,-3,1
KR_7751027068,15474,15005,298,290,4,3,3,4,4,3,0,1,0,0,14,18,4,4,0,1,1,0,0,1,0,0,10,540234,469,8,1,-1,1,-1,0,-4,0,-1
KR_7751028999,14050,16034,270,289,2,6,6,2,2,7,0,0,0,0,110,19,3,5,0,0,0,1,0,0,0,0,10,540216,-1984,-19,-4,4,-5,0,0,91,-2,0
KR_7751038971,16786,13208,278,221,9,3,3,9,6,3,0,1,0,0,19,33,1,5,0,0,1,0,0,1,0,0,10,540253,3578,57,6,-6,3,-1,0,-14,-4,0
KR_7751048852,14231,15134,240,275,4,5,5,4,4,2,0,0,0,0,16,15,3,3,3,2,1,0,0,0,0,0,10,540250,-903,-35,-1,1,2,0,0,1,0,1
KR_7751053819,14887,17723,277,265,4,10,10,4,3,13,0,0,0,0,14,17,2,1,1,3,1,0,0,0,0,0,10,540185,-2836,12,-6,6,-10,0,0,-3,1,-2
KR_7751054149,13911,15403,289,301,1,3,3,1,1,4,0,1,0,0,21,17,3,7,0,2,0,1,0,1,0,0,10,540265,-1492,-12,-2,2,-3,-1,0,4,-4,-2
KR_7751063660,16496,13250,254,261,10,2,3,10,9,0,0,0,0,0,14,15,3,2,1,0,1,0,0,0,0,0,10,540214,3246,-7,8,-7,9,0,0,-1,1,1
KR_7751066661,16301,14043,241,225,9,4,4,9,13,5,0,0,0,0,36,19,5,3,0,0,1,0,0,0,0,0,10,540241,2258,16,5,-5,8,0,0,17,2,0
KR_7751068468,16312,14993,275,264,8,5,5,8,3,2,1,0,0,0,16,35,3,3,1,1,0,1,1,0,0,0,10,540189,1319,11,3,-3,1,1,0,-19,0,0
KR_7751075419,17473,13132,240,228,12,2,2,12,14,3,0,0,0,0,16,12,2,1,3,0,1,0,0,0,0,0,10,540093,4341,12,10,-10,11,0,0,4,1,3
KR_7751076902,14328,17025,223,269,4,9,10,4,6,11,0,0,0,0,21,19,4,0,0,2,0,1,0,0,0,0,10,540237,-2697,-46,-5,6,-5,0,0,2,4,-2
KR_7751079201,16510,15176,215,282,10,4,4,10,15,4,0,0,0,0,19,15,3,0,0,0,0,1,0,0,0,0,10,540251,1334,-67,6,-6,11,0,0,4,3,0
KR_7751084313,15995,16662,274,245,6,8,8,6,6,12,0,0,0,0,21,20,3,3,0,1,1,0,0,0,0,0,10,540234,-667,29,-2,2,-6,0,0,1,0,-1
KR_7751094669,15736,14150,293,282,5,2,2,5,8,3,0,1,0,0,16,15,3,1,0,1,0,1,0,1,0,0,10,540213,1586,11,3,-3,5,-1,0,1,2,-1
KR_7751097279,14031,15717,263,278,2,6,6,2,3,6,0,0,0,0,15,18,4,4,0,0,1,0,0,0,0,0,10,540191,-1686,-15,-4,4,-3,0,0,-3,0,0
KR_7751099005,15433,13862,291,250,4,3,3,4,6,2,0,0,0,0,117,13,3,1,3,0,0,1,0,0,0,0,10,540230,1571,41,1,-1,4,0,0,104,2,3
KR_7751099332,15087,14193,305,262,3,3,3,3,0,4,1,0,0,0,16,17,5,3,0,0,0,1,1,0,0,0,10,540219,894,43,0,0,-4,1,0,-1,2,0
KR_7751102448,14171,14915,281,276,2,4,4,2,4,6,0,0,0,0,13,17,3,0,0,0,1,0,0,0,0,0,10,540214,-744,5,-2,2,-2,0,0,-4,3,0
KR_7751111375,13789,14301,267,276,4,4,4,4,2,4,0,1,0,0,16,13,3,8,0,0,0,1,0,1,0,0,10,540222,-512,-9,0,0,-2,-1,0,3,-5,0
KR_7751128368,15125,13924,272,259,4,2,2,4,4,3,0,1,0,0,14,31,2,4,2,0,1,0,0,1,0,0,10,540307,1201,13,2,-2,1,-1,0,-17,-2,2
KR_7751133244,13516,15162,268,299,2,3,3,2,1,3,1,0,0,0,13,19,3,0,0,1,0,1,1,0,0,0,10,540195,-1646,-31,-1,1,-2,1,0,-6,3,-1
KR_7751139028,18120,16148,252,241,12,7,7,12,13,7,0,0,0,0,14,35,3,2,1,0,1,0,0,0,0,0,10,540210,1972,11,5,-5,6,0,0,-21,1,1
KR_7751145239,15869,14898,300,288,5,3,3,5,6,6,0,0,0,0,39,18,3,1,1,1,1,0,0,0,0,0,10,540211,971,12,2,-2,0,0,0,21,2,0
KR_7751154887,17153,15110,261,277,9,5,5,9,14,6,0,0,0,0,32,15,3,2,1,1,0,1,0,0,0,0,10,540199,2043,-16,4,-4,8,0,0,17,1,0
KR_7751157828,13361,18145,236,292,2,10,11,2,1,13,0,0,0,0,15,15,4,4,0,1,1,0,0,0,0,0,10,540232,-4784,-56,-8,9,-12,0,0,0,0,-1
KR_7751167276,16049,14176,291,259,6,3,3,6,4,1,0,1,0,0,16,16,6,2,1,0,1,0,0,1,0,0,10,540260,1873,32,3,-3,3,-1,0,0,4,1
KR_7751173655,14521,13929,276,256,5,2,2,5,1,3,0,1,0,0,23,19,1,1,2,3,1,0,0,1,0,0,10,540236,592,20,3,-3,-2,-1,0,4,0,-1
KR_7751180224,16475,18011,239,253,9,13,13,9,7,9,0,0,0,0,18,14,4,2,0,0,0,1,0,0,0,0,10,540272,-1536,-14,-4,4,-2,0,0,4,2,0
KR_7751180844,16131,14706,281,281,7,3,3,7,8,2,0,0,0,0,19,30,2,4,0,0,1,0,0,0,0,0,10,540203,1425,0,4,-4,6,0,0,-11,-2,0
KR_7751182057,15665,14369,256,269,6,3,3,6,9,4,0,0,0,0,17,16,2,2,0,1,0,1,0,0,0,0,10,540203,1296,-13,3,-3,5,0,0,1,0,-1
KR_7751189647,15762,14812,253,255,6,5,5,6,13,11,0,0,0,0,16,17,3,1,1,0,1,0,0,0,0,0,10,540240,950,-2,1,-1,2,0,0,-1,2,1
KR_7751196366,14665,12982,285,260,3,0,0,3,4,0,1,0,0,0,17,58,5,3,1,1,1,0,1,0,0,0,10,540226,1683,25,3,-3,4,1,0,-41,2,0
KR_7751224413,16539,14279,277,214,8,6,6,8,8,5,1,0,0,0,14,27,1,1,2,0,0,1,1,0,0,0,10,540240,2260,63,2,-2,3,1,0,-13,0,2
KR_7751229719,14523,16204,240,275,4,6,6,4,6,8,0,0,0,0,15,17,3,5,0,4,0,1,0,0,0,0,10,540228,-1681,-35,-2,2,-2,0,0,-2,-2,-4
KR_7751231119,15838,18258,263,273,6,11,11,7,5,11,0,0,0,0,16,16,2,1,0,0,0,1,0,0,0,0,10,540211,-2420,-10,-5,4,-6,0,0,0,1,0
KR_7751233406,15110,14636,282,287,5,3,3,5,4,3,0,0,0,0,14,19,4,3,0,0,1,0,0,0,0,0,10,540276,474,-5,2,-2,1,0,0,-5,1,0
KR_7751250665,15961,15693,249,258,7,6,6,7,11,10,0,0,0,0,18,15,3,6,2,0,1,0,0,0,0,0,10,540211,268,-9,1,-1,1,0,0,3,-3,2
KR_7751261712,16179,15467,265,275,7,4,4,7,10,5,0,0,0,0,18,26,4,4,0,0,1,0,0,0,0,0,10,540224,712,-10,3,-3,5,0,0,-8,0,0
KR_7751272163,15386,18664,228,259,6,15,15,6,7,12,0,1,0,0,15,14,1,2,0,3,0,1,0,1,0,0,10,540254,-3278,-31,-9,9,-5,-1,0,1,-1,-3
KR_7751272814,14470,15505,191,242,7,6,6,7,7,6,0,1,0,0,18,36,3,5,0,2,0,1,0,1,0,0,10,540254,-1035,-51,1,-1,1,-1,0,-18,-2,-2
KR_7751285973,13682,17041,228,248,3,9,9,3,3,10,0,0,0,0,18,14,1,3,1,0,0,1,0,0,0,0,10,540243,-3359,-20,-6,6,-7,0,0,4,-2,1
KR_7751288927,16260,14176,275,270,8,3,3,8,7,2,1,0,0,0,40,12,2,5,0,0,0,1,1,0,0,0,10,540281,2084,5,5,-5,5,1,0,28,-3,0
KR_7751300938,13536,15449,270,286,1,3,3,1,2,6,0,0,0,0,8,31,3,1,0,5,0,1,0,0,0,0,10,540239,-1913,-16,-2,2,-4,0,0,-23,2,-5
KR_7751303892,15424,15402,276,264,5,5,5,5,9,8,0,0,0,0,19,11,2,2,0,1,0,1,0,0,0,0,10,540218,22,12,0,0,1,0,0,8,0,-1
KR_7751336234,16418,14194,285,258,8,3,3,8,7,2,0,1,0,0,17,35,4,2,1,0,1,0,0,1,0,0,10,540221,2224,27,5,-5,5,-1,0,-18,2,1
KR_7751351642,14517,14865,245,261,5,5,5,5,6,5,0,1,0,0,28,14,4,3,0,0,1,0,0,1,0,0,10,540207,-348,-16,0,0,1,-1,0,14,1,0
KR_7751374015,16732,15468,255,264,9,5,5,9,10,3,0,0,0,0,31,14,4,3,1,0,1,0,0,0,0,0,10,540239,1264,-9,4,-4,7,0,0,17,1,1
KR_7751395716,14561,15933,269,256,4,7,7,4,5,8,1,0,0,0,18,12,4,0,0,1,1,0,1,0,0,0,10,540231,-1372,13,-3,3,-3,1,0,6,4,-1
KR_7751438034,17398,17230,265,270,7,11,11,7,12,10,0,0,0,0,15,102,6,3,0,1,0,1,0,0,0,0,10,540242,168,-5,-4,4,2,0,0,-87,3,-1
KR_7751462923,15006,14846,262,260,4,5,5,4,4,4,0,0,0,0,16,15,4,5,0,0,1,0,0,0,0,0,10,540206,160,2,-1,1,0,0,0,1,-1,0
KR_7751480132,14517,16006,234,254,4,7,7,4,5,7,0,0,0,0,17,17,1,2,0,1,0,1,0,0,0,0,10,540265,-1489,-20,-3,3,-2,0,0,0,-1,-1
KR_7751490602,15284,14826,276,261,4,4,4,4,7,5,0,1,0,0,110,16,3,3,0,1,1,0,0,1,0,0,10,540255,458,15,0,0,2,-1,0,94,0,-1
KR_7751508381,14741,14552,287,292,4,3,3,4,2,1,0,1,0,0,15,12,3,3,0,0,1,0,0,1,0,0,10,540250,189,-5,1,-1,1,-1,0,3,0,0
KR_7751509374,14676,18799,216,272,6,12,12,6,5,11,0,0,0,0,36,30,1,4,0,4,0,1,0,0,0,0,10,540217,-4123,-56,-6,6,-6,0,0,6,-3,-4
KR_7751511135,15399,17144,264,268,6,8,8,6,9,12,0,1,0,0,15,17,4,5,0,0,1,0,0,1,0,0,10,540220,-1745,-4,-2,2,-3,-1,0,-2,-1,0
KR_7751519993,14449,15997,277,303,2,5,5,2,3,8,0,1,0,0,15,86,2,2,0,2,0,1,0,1,0,0,10,540270,-1548,-26,-3,3,-5,-1,0,-71,0,-2
KR_7751555866,14780,14745,268,285,5,3,3,5,3,4,0,1,0,0,39,32,3,4,2,2,1,0,0,1,0,0,10,540225,35,-17,2,-2,-1,-1,0,7,-1,0
KR_7751562036,14829,14467,304,264,4,3,3,4,2,5,0,0,0,0,17,38,3,5,0,0,0,1,0,0,0,0,10,540208,362,40,1,-1,-3,0,0,-21,-2,0
KR_7751573340,18938,15548,268,265,17,5,5,17,16,3,1,0,0,0,16,105,2,2,2,0,1,0,1,0,0,0,10,540278,3390,3,12,-12,13,1,0,-89,0,2
KR_7751608388,14522,15718,245,249,4,7,7,4,3,5,0,1,0,0,19,10,3,1,2,1,0,1,0,1,0,0,10,540234,-1196,-4,-3,3,-2,-1,0,9,2,1
KR_7751611468,15964,15391,247,258,9,6,6,9,7,5,0,0,0,0,22,18,5,2,0,1,1,0,0,0,0,0,10,540254,573,-11,3,-3,2,0,0,4,3,-1
KR_7751613858,14118,16676,232,265,4,8,8,4,4,9,0,0,0,0,13,19,4,0,0,1,0,1,0,0,0,0,10,540217,-2558,-33,-4,4,-5,0,0,-6,4,-1
KR_7751619810,16572,14870,254,243,8,5,5,8,10,6,0,1,0,0,20,41,3,4,1,1,1,0,0,1,0,0,10,540237,1702,11,3,-3,4,-1,0,-21,-1,0
KR_7751622992,15568,13852,247,225,7,3,3,7,10,5,0,0,0,0,17,16,5,4,1,1,1,0,0,0,0,0,10,540283,1716,22,4,-4,5,0,0,1,1,0
KR_7751626797,16739,17359,240,280,8,9,9,8,11,11,0,0,0,0,19,17,5,2,1,1,1,0,0,0,0,0,10,540239,-620,-40,-1,1,0,0,0,2,3,0
KR_7751646529,14607,16163,238,296,4,6,6,4,5,8,0,1,0,0,18,16,6,5,1,0,1,0,0,1,0,0,10,540230,-1556,-58,-2,2,-3,-1,0,2,1,1
KR_7751653057,13467,16297,251,251,2,8,8,2,2,11,0,1,0,0,32,19,5,3,1,0,0,1,0,1,0,0,10,540291,-2830,0,-6,6,-9,-1,0,13,2,1
KR_7751661588,13465,15290,259,266,2,6,6,2,0,6,1,0,0,0,20,17,3,7,1,1,0,1,1,0,0,0,10,540190,-1825,-7,-4,4,-6,1,0,3,-4,0
KR_7751678015,15834,14182,303,270,5,3,3,5,3,4,1,0,0,0,16,17,7,2,0,0,1,0,1,0,0,0,10,540206,1652,33,2,-2,-1,1,0,-1,5,0
KR_7751679635,13508,19287,247,274,3,13,13,3,9,25,1,0,0,0,16,15,2,6,0,2,0,1,1,0,0,0,10,540217,-5779,-27,-10,10,-16,1,0,1,-4,-2
KR_7751690613,15987,13208,254,230,8,2,2,8,7,1,0,0,0,0,16,9,3,7,3,0,1,0,0,0,0,0,10,540211,2779,24,6,-6,6,0,0,7,-4,3
KR_7751704083,14894,14756,295,251,3,4,4,3,3,5,0,0,0,0,38,17,4,1,1,1,1,0,0,0,0,0,10,540104,138,44,-1,1,-2,0,0,21,3,0
KR_7751714619,13506,13678,271,279,1,1,1,1,0,1,0,1,0,0,17,17,1,5,1,0,0,1,0,1,0,0,10,540231,-172,-8,0,0,-1,-1,0,0,-4,1
KR_7751725944,13251,16644,252,264,1,9,9,1,1,9,0,0,0,0,19,32,4,3,0,2,0,1,0,0,0,0,10,540190,-3393,-12,-8,8,-8,0,0,-13,1,-2
KR_7751743757,16111,15808,258,254,9,7,7,9,4,12,0,0,0,0,12,15,3,3,0,0,1,0,0,0,0,0,10,540115,303,4,2,-2,-8,0,0,-3,0,0
KR_7751746773,16080,14582,271,289,7,3,3,7,7,2,0,0,0,0,13,20,5,1,0,1,1,0,0,0,0,0,10,540266,1498,-18,4,-4,5,0,0,-7,4,-1
KR_7751753897,14833,15626,265,255,4,7,7,4,6,12,0,1,0,0,32,24,3,4,2,0,1,0,0,1,0,0,10,540187,-793,10,-3,3,-6,-1,0,8,-1,2
KR_7751761385,15851,15377,262,283,7,4,4,7,6,3,0,1,0,0,20,169,2,8,2,2,1,0,0,1,0,0,10,540219,474,-21,3,-3,3,-1,0,-149,-6,0
KR_7751766254,16743,13950,251,263,10,3,3,10,13,2,0,0,0,0,15,16,5,2,2,0,1,0,0,0,0,0,10,540218,2793,-12,7,-7,11,0,0,-1,3,2
KR_7751779430,16676,19985,249,283,8,15,15,8,14,21,0,1,0,0,17,16,1,4,1,2,0,1,0,1,0,0,10,540263,-3309,-34,-7,7,-7,-1,0,1,-3,-1
KR_7751785022,14562,17069,257,284,4,8,8,4,3,9,0,0,0,0,16,85,2,7,1,1,1,0,0,0,0,0,10,540301,-2507,-27,-4,4,-6,0,0,-69,-5,0
KR_7751796758,13906,14934,258,253,3,6,6,3,2,5,0,0,0,0,20,12,3,5,0,0,0,1,0,0,0,0,10,540230,-1028,5,-3,3,-3,0,0,8,-2,0
KR_7751817049,14852,15691,273,291,4,5,5,4,2,8,0,1,0,0,16,16,2,5,0,3,0,1,0,1,0,0,10,540227,-839,-18,-1,1,-6,-1,0,0,-3,-3
KR_7751817321,16564,14249,282,247,7,4,4,7,8,6,0,0,0,0,35,13,3,1,3,0,1,0,0,0,0,0,10,540122,2315,35,3,-3,2,0,0,22,2,3
KR_7751825076,15296,14339,281,286,4,3,3,4,5,0,1,0,0,0,136,13,2,4,2,1,1,0,1,0,0,0,10,540284,957,-5,1,-1,5,1,0,123,-2,1
KR_7751871430,15633,15001,292,286,4,4,4,4,5,4,0,1,0,0,20,19,7,3,2,0,1,0,0,1,0,0,10,540233,632,6,0,0,1,-1,0,1,4,2
KR_7751886454,16285,13181,284,254,6,1,1,6,9,1,0,0,0,0,13,38,6,3,1,0,1,0,0,0,0,0,10,540201,3104,30,5,-5,8,0,0,-25,3,1
KR_7751900740,13719,16083,259,272,2,6,6,2,3,10,0,1,0,0,16,18,5,1,1,2,1,0,0,1,0,0,10,540162,-2364,-13,-4,4,-7,-1,0,-2,4,-1
KR_7751905029,14040,13851,267,249,3,3,3,3,1,5,0,0,0,0,16,16,6,4,0,0,0,1,0,0,0,0,10,540232,189,18,0,0,-4,0,0,0,2,0
KR_7751925637,16916,15166,265,272,8,3,3,8,10,4,0,1,0,0,13,14,1,3,2,1,1,0,0,1,0,0,10,540257,1750,-7,5,-5,6,-1,0,-1,-2,1
KR_7751939432,16152,16963,241,239,7,11,12,7,13,12,0,0,0,0,13,19,0,1,2,0,0,1,0,0,0,0,10,540182,-811,2,-4,5,1,0,0,-6,-1,2
KR_7751943294,14299,14152,258,277,2,2,2,2,2,3,0,0,0,0,28,20,4,2,2,0,0,1,0,0,0,0,10,540211,147,-19,0,0,-1,0,0,8,2,2
KR_7751953850,16406,14792,275,275,8,3,3,8,6,4,0,0,0,0,34,18,3,1,1,0,1,0,0,0,0,0,10,540239,1614,0,5,-5,2,0,0,16,2,1
KR_7751978797,14524,13446,306,265,2,2,2,2,3,0,1,0,0,0,16,17,6,4,0,1,0,1,1,0,0,0,10,540212,1078,41,0,0,3,1,0,-1,2,-1
KR_7751992045,14726,16409,257,273,4,7,7,4,4,11,0,0,0,0,15,17,1,3,0,1,0,1,0,0,0,0,10,540222,-1683,-16,-3,3,-7,0,0,-2,-2,-1
KR_7752000915,14311,15136,248,280,4,5,5,4,7,7,0,1,0,0,19,24,2,3,0,0,1,0,0,1,0,0,10,540207,-825,-32,-1,1,0,-1,0,-5,-1,0
KR_7752004143,13814,16562,227,227,4,11,11,4,2,13,0,1,0,0,18,182,2,7,0,2,0,1,0,1,0,0,10,540279,-2748,0,-7,7,-11,-1,0,-164,-5,-2
KR_7752007991,16353,13868,304,290,6,2,2,6,6,1,0,1,0,0,15,15,4,6,2,0,1,0,0,1,0,0,10,540275,2485,14,4,-4,5,-1,0,0,-2,2
KR_7752023666,15721,15253,239,274,6,6,6,6,7,9,0,0,0,0,19,16,2,1,0,0,1,0,0,0,0,0,10,540205,468,-35,0,0,-2,0,0,3,1,0
KR_7752043457,15980,14371,311,264,5,3,3,5,2,5,0,0,0,0,14,10,1,7,2,0,1,0,0,0,0,0,10,540251,1609,47,2,-2,-3,0,0,4,-6,2
KR_7752055899,15387,16171,257,232,6,9,9,6,4,11,1,0,0,0,17,12,4,2,1,0,0,1,1,0,0,0,10,540230,-784,25,-3,3,-7,1,0,5,2,1
KR_7752085534,13063,14719,274,266,0,5,5,0,0,7,0,1,0,0,35,18,4,2,0,1,0,1,0,1,0,0,10,540273,-1656,8,-5,5,-7,-1,0,17,2,-1
KR_7752094153,14120,16706,229,247,5,11,11,5,6,10,0,0,0,0,15,19,3,5,0,2,1,0,0,0,0,0,10,540092,-2586,-18,-6,6,-4,0,0,-4,-2,-2
KR_7752107351,16590,15169,273,273,7,4,4,7,8,5,0,0,0,0,15,16,5,3,2,1,1,0,0,0,0,0,10,540221,1421,0,3,-3,3,0,0,-1,2,1
KR_7752110589,12624,14489,202,251,2,5,5,2,2,1,0,0,0,0,16,20,0,3,0,2,0,1,0,0,0,0,10,540213,-1865,-49,-3,3,1,0,0,-4,-3,-2
KR_7752158076,15534,15523,265,267,6,6,6,6,6,8,0,0,0,0,14,15,3,2,0,0,0,1,0,0,0,0,10,540234,11,-2,0,0,-2,0,0,-1,1,0
KR_7752177289,14059,14227,286,309,2,1,1,2,3,2,1,0,0,0,22,16,6,2,0,0,1,0,1,0,0,0,10,540194,-168,-23,1,-1,1,1,0,6,4,0
KR_7752184009,13519,16560,237,278,2,8,8,3,2,10,0,0,0,0,15,13,1,5,0,0,0,1,0,0,0,0,10,540207,-3041,-41,-6,5,-8,0,0,2,-4,0
KR_7752216565,15037,15309,278,238,4,8,8,4,3,6,0,0,0,0,13,12,3,1,1,0,0,1,0,0,0,0,10,540224,-272,40,-4,4,-3,0,0,1,2,1
KR_7752225610,13823,15503,249,267,3,6,6,3,1,5,0,1,0,0,17,13,2,3,0,0,0,1,0,1,0,0,10,540242,-1680,-18,-3,3,-4,-1,0,4,-1,0
KR_7752226262,15346,16351,224,272,6,8,8,6,6,8,0,0,0,0,16,20,6,1,0,0,1,0,0,0,0,0,10,540244,-1005,-48,-2,2,-2,0,0,-4,5,0
KR_7752232091,14579,15300,253,262,5,6,6,5,4,2,0,0,0,0,20,17,3,2,0,2,1,0,0,0,0,0,10,540224,-721,-9,-1,1,2,0,0,3,1,-2
KR_7752233951,15720,14206,293,263,5,2,2,5,8,1,1,0,0,0,18,20,7,2,0,1,1,0,1,0,0,0,10,540211,1514,30,3,-3,7,1,0,-2,5,-1
KR_7752272253,15299,14179,299,288,3,2,2,3,4,2,0,0,0,0,14,16,3,0,0,1,1,0,0,0,0,0,10,540235,1120,11,1,-1,2,0,0,-2,3,-1
KR_7752286332,15628,15683,269,247,6,6,6,6,3,10,1,0,0,0,13,29,3,4,3,1,1,0,1,0,0,0,10,540262,-55,22,0,0,-7,1,0,-16,-1,2
KR_7752294928,14326,14004,285,253,2,3,3,2,2,5,0,1,0,0,16,19,2,6,0,0,0,1,0,1,0,0,10,540294,322,32,-1,1,-3,-1,0,-3,-4,0
KR_7752307947,14491,14261,249,273,5,3,3,5,10,3,0,0,0,0,16,19,4,5,0,0,0,1,0,0,0,0,10,540248,230,-24,2,-2,7,0,0,-3,-1,0
KR_7752322454,13707,14177,233,250,4,4,4,4,2,3,1,0,0,0,15,18,5,6,1,1,0,1,1,0,0,0,10,540228,-470,-17,0,0,-1,1,0,-3,-1,0
KR_7752353856,13170,15829,250,247,1,10,10,1,1,7,0,0,0,0,46,28,5,3,1,0,0,1,0,0,0,0,10,540270,-2659,3,-9,9,-6,0,0,18,2,1
KR_7752366463,16189,15836,226,246,10,6,6,10,10,10,0,0,0,0,31,13,3,2,1,0,1,0,0,0,0,0,10,540272,353,-20,4,-4,0,0,0,18,1,1
KR_7752384656,15468,14788,276,259,5,4,5,5,6,4,0,0,0,0,24,115,3,6,1,0,1,0,0,0,0,0,10,540108,680,17,1,0,2,0,0,-91,-3,1
KR_7752401850,14262,14244,220,238,5,4,4,5,2,4,0,1,0,0,15,19,3,2,2,0,1,0,0,1,0,0,10,540268,18,-18,1,-1,-2,-1,0,-4,1,2
KR_7752417009,15776,16116,246,266,7,8,8,7,9,5,0,0,0,0,16,18,3,7,2,3,0,1,0,0,0,0,10,540078,-340,-20,-1,1,4,0,0,-2,-4,-1
KR_7752421442,15527,14975,282,290,5,3,3,5,5,4,0,0,0,0,34,16,3,4,0,0,1,0,0,0,0,0,10,540222,552,-8,2,-2,1,0,0,18,-1,0
KR_7752423658,13928,16645,247,264,4,9,9,4,1,10,0,0,0,0,17,13,2,2,1,1,0,1,0,0,0,0,10,540108,-2717,-17,-5,5,-9,0,0,4,0,0
KR_7752440983,15057,17051,269,279,4,10,10,4,6,15,0,1,0,0,12,15,3,3,0,0,1,0,0,1,0,0,10,540129,-1994,-10,-6,6,-9,-1,0,-3,0,0
KR_7752460968,14475,15058,291,268,2,5,5,2,1,7,0,1,0,0,16,15,5,1,0,0,0,1,0,1,0,0,10,540117,-583,23,-3,3,-6,-1,0,1,4,0
KR_7752482910,15814,14988,261,275,8,3,3,8,14,5,1,0,0,0,14,19,0,4,0,0,1,0,1,0,0,0,10,540253,826,-14,5,-5,9,1,0,-5,-4,0
KR_7752502842,16038,15182,266,237,6,7,7,6,7,8,0,0,0,0,17,13,4,1,2,0,1,0,0,0,0,0,10,540243,856,29,-1,1,-1,0,0,4,3,2
KR_7752509538,13204,16017,270,271,1,6,6,1,1,7,0,1,0,0,32,20,2,2,0,2,0,1,0,1,0,0,10,540188,-2813,-1,-5,5,-6,-1,0,12,0,-2
KR_7752513980,17872,13425,276,224,10,3,3,10,7,2,0,0,0,0,17,22,2,1,3,0,1,0,0,0,0,0,10,540233,4447,52,7,-7,5,0,0,-5,1,3
KR_7752516005,14736,14483,267,289,5,3,3,5,3,4,0,0,0,0,17,16,4,5,0,0,1,0,0,0,0,0,10,540157,253,-22,2,-2,-1,0,0,1,-1,0
KR_7752521913,15049,15024,246,267,5,4,4,5,7,4,0,1,0,0,11,16,3,3,0,1,0,1,0,1,0,0,10,540193,25,-21,1,-1,3,-1,0,-5,0,-1
KR_7752524562,17686,13058,287,226,10,3,3,10,12,3,1,0,0,0,18,11,3,2,1,0,0,1,1,0,0,0,10,540283,4628,61,7,-7,9,1,0,7,1,1
KR_7752547448,16610,15847,293,294,7,5,5,7,5,2,0,0,0,0,17,18,3,3,2,0,1,0,0,0,0,0,10,540238,763,-1,2,-2,3,0,0,-1,0,2
KR_7752569180,15551,15922,278,241,6,7,8,6,4,6,0,0,0,0,19,18,5,6,0,0,1,0,0,0,0,0,10,540221,-371,37,-1,2,-2,0,0,1,-1,0
KR_7752588702,15065,13297,279,260,5,1,1,5,4,0,1,0,0,0,17,40,3,2,0,1,1,0,1,0,0,0,10,540252,1768,19,4,-4,4,1,0,-23,1,-1
KR_7752609659,18566,14195,283,243,11,3,3,11,12,4,0,0,0,0,38,18,6,0,3,2,1,0,0,0,0,0,10,540187,4371,40,8,-8,8,0,0,20,6,1
KR_7752629746,14002,17205,242,256,3,10,10,3,3,9,0,1,0,0,18,21,2,6,1,2,0,1,0,1,0,0,10,540218,-3203,-14,-7,7,-6,-1,0,-3,-4,-1
KR_7752634098,15451,13690,276,263,5,1,1,5,8,1,0,0,0,0,17,14,0,3,0,2,1,0,0,0,0,0,10,540177,1761,13,4,-4,7,0,0,3,-3,-2
KR_7752666557,14866,17110,275,275,4,9,9,4,4,10,1,0,0,0,14,13,3,2,0,0,0,1,1,0,0,0,10,540220,-2244,0,-5,5,-6,1,0,1,1,0
KR_7752697179,16284,14772,288,279,7,4,4,7,4,7,1,0,0,0,19,12,3,6,1,0,0,1,1,0,0,0,10,540221,1512,9,3,-3,-3,1,0,7,-3,1
KR_7752703910,15705,15356,290,268,5,6,6,5,4,7,0,1,0,0,15,10,0,7,0,1,0,1,0,1,0,0,10,540235,349,22,-1,1,-3,-1,0,5,-7,-1
KR_7752706521,14965,17233,260,284,5,9,9,5,2,10,0,1,0,0,22,17,3,3,0,3,0,1,0,1,0,0,10,540223,-2268,-24,-4,4,-8,-1,0,5,0,-3
KR_7752718245,15435,15858,267,265,5,7,7,5,6,6,0,0,0,0,24,12,2,4,0,0,1,0,0,0,0,0,10,540200,-423,2,-2,2,0,0,0,12,-2,0
KR_7752728585,15139,16029,277,282,4,7,7,4,6,8,0,0,0,0,19,13,3,6,1,0,1,0,0,0,0,0,10,540257,-890,-5,-3,3,-2,0,0,6,-3,1
KR_7752735518,16444,14678,262,270,8,4,4,8,15,4,1,0,0,0,16,17,5,1,2,0,1,0,1,0,0,0,10,540129,1766,-8,4,-4,11,1,0,-1,4,2
KR_7752773915,15020,13883,280,263,4,2,2,4,5,4,0,0,0,0,15,15,6,1,0,1,1,0,0,0,0,0,10,540205,1137,17,2,-2,1,0,0,0,5,-1
KR_7752787459,14942,13068,286,263,4,1,1,4,1,1,0,1,0,0,16,36,3,2,0,0,0,1,0,1,0,0,10,540253,1874,23,3,-3,0,-1,0,-20,1,0
KR_7752789180,13490,13637,281,269,1,1,1,1,1,1,1,0,0,0,20,16,2,2,0,0,0,1,1,0,0,0,10,540255,-147,12,0,0,0,1,0,4,0,0
KR_7752801768,16993,15818,267,262,9,6,6,10,14,5,0,0,0,0,17,30,3,4,0,2,1,0,0,0,0,0,10,540225,1175,5,3,-4,9,0,0,-13,-1,-2
KR_7752815058,14799,16297,265,281,4,6,6,4,4,6,0,0,0,0,19,17,4,3,0,2,0,1,0,0,0,0,10,540116,-1498,-16,-2,2,-2,0,0,2,1,-2
KR_7752827264,14251,14987,275,265,2,5,5,2,3,8,1,0,0,0,14,20,2,4,0,0,0,1,1,0,0,0,10,540241,-736,10,-3,3,-5,1,0,-6,-2,0
KR_7752830959,14994,16198,273,280,4,6,6,4,7,7,0,1,0,0,18,17,6,3,0,1,1,0,0,1,0,0,10,540253,-1204,-7,-2,2,0,-1,0,1,3,-1
KR_7752849451,14626,14782,269,264,4,5,5,4,3,3,0,0,0,0,37,15,6,1,0,0,1,0,0,0,0,0,10,540230,-156,5,-1,1,0,0,0,22,5,0
KR_7752865202,12682,17426,231,279,1,10,10,1,1,14,0,0,0,0,14,25,3,4,0,0,0,1,0,0,0,0,10,540205,-4744,-48,-9,9,-13,0,0,-11,-1,0
KR_7752890208,14574,14636,277,288,3,4,4,3,5,2,0,1,0,0,15,22,1,3,0,0,0,1,0,1,0,0,10,540260,-62,-11,-1,1,3,-1,0,-7,-2,0
KR_7752895773,15337,15324,276,271,4,5,5,4,6,7,0,0,0,0,15,17,3,3,3,2,0,1,0,0,0,0,10,540207,13,5,-1,1,-1,0,0,-2,0,1
KR_7752902502,13733,16792,253,267,2,9,9,3,2,12,0,0,0,0,19,15,3,4,0,1,0,1,0,0,0,0,10,540307,-3059,-14,-7,6,-10,0,0,4,-1,-1
KR_7752903941,15144,15320,281,273,4,5,5,4,3,8,0,1,0,0,13,21,4,2,1,2,1,0,0,1,0,0,10,540201,-176,8,-1,1,-5,-1,0,-8,2,-1
KR_7752904006,15303,15157,279,288,5,4,4,5,6,4,0,0,0,0,14,18,2,2,0,0,1,0,0,0,0,0,10,540226,146,-9,1,-1,2,0,0,-4,0,0
KR_7752925478,14588,16403,264,238,3,8,8,3,4,17,0,1,0,0,19,14,1,2,2,0,0,1,0,1,0,0,10,540214,-1815,26,-5,5,-13,-1,0,5,-1,2
KR_7752932256,17064,15953,249,267,10,6,6,10,14,7,0,0,0,0,24,13,2,2,2,2,1,0,0,0,0,0,10,540212,1111,-18,4,-4,7,0,0,11,0,0
KR_7752944865,15813,15917,240,257,7,6,7,7,13,11,1,0,0,0,14,16,1,2,1,3,0,1,1,0,0,0,10,540245,-104,-17,1,0,2,1,0,-2,-1,-2
KR_7752946075,16380,14572,298,287,6,2,2,6,5,3,0,1,0,0,16,14,0,6,1,0,1,0,0,1,0,0,10,540260,1808,11,4,-4,2,-1,0,2,-6,1
KR_7752963991,15372,13942,250,270,7,2,2,7,9,2,1,0,0,0,21,13,3,3,0,0,1,0,1,0,0,0,10,540184,1430,-20,5,-5,7,1,0,8,0,0
KR_7752968926,18111,15191,274,218,10,7,7,10,12,9,0,1,0,0,17,14,3,5,5,1,1,0,0,1,0,0,10,540174,2920,56,3,-3,3,-1,0,3,-2,4
KR_7752974339,13761,14973,309,294,0,4,4,0,0,2,0,1,0,0,18,15,3,4,0,0,0,1,0,1,0,0,10,540168,-1212,15,-4,4,-2,-1,0,3,-1,0
KR_7752990572,13885,14451,260,261,2,4,4,2,6,3,0,0,0,0,18,13,1,5,0,1,0,1,0,0,0,0,10,540219,-566,-1,-2,2,3,0,0,5,-4,-1
KR_7753000654,16007,14705,262,256,8,5,5,8,9,5,0,0,0,0,21,13,1,5,0,0,0,1,0,0,0,0,10,540250,1302,6,3,-3,4,0,0,8,-4,0
KR_7753003743,15890,15913,284,271,6,6,6,6,4,6,0,1,0,0,12,13,3,1,2,1,1,0,0,1,0,0,10,540210,-23,13,0,0,-2,-1,0,-1,2,1
KR_7753014223,13544,14239,258,279,2,2,2,2,0,2,1,0,0,0,55,16,5,2,0,0,0,1,1,0,0,0,10,540227,-695,-21,0,0,-2,1,0,39,3,0
KR_7753019401,15277,15841,254,257,6,7,7,6,5,4,0,1,0,0,36,22,2,2,1,0,1,0,0,1,0,0,10,540218,-564,-3,-1,1,1,-1,0,14,0,1
KR_7753029736,14482,14686,268,275,3,4,4,3,2,3,0,0,0,0,13,20,3,2,1,0,0,1,0,0,0,0,10,540217,-204,-7,-1,1,-1,0,0,-7,1,1
KR_7753052859,15315,13585,273,265,5,2,2,5,4,2,0,0,0,0,17,14,2,4,0,0,1,0,0,0,0,0,10,540248,1730,8,3,-3,2,0,0,3,-2,0
KR_7753074174,16739,14479,275,240,8,4,4,8,11,3,0,1,0,0,18,17,2,4,2,0,1,0,0,1,0,0,10,540244,2260,35,4,-4,8,-1,0,1,-2,2
KR_7753075338,14350,13588,272,268,3,2,2,3,1,2,0,1,0,0,17,17,4,1,0,0,1,0,0,1,0,0,10,540194,762,4,1,-1,-1,-1,0,0,3,0
KR_7753075930,14993,15211,287,284,4,3,3,4,5,9,0,0,0,0,15,19,2,5,0,0,1,0,0,0,0,0,10,540211,-218,3,1,-1,-4,0,0,-4,-3,0
KR_7753077278,15992,14114,285,259,5,3,3,5,5,1,0,1,0,0,19,16,1,6,0,1,0,1,0,1,0,0,10,540241,1878,26,2,-2,4,-1,0,3,-5,-1
KR_7753086607,15103,14199,292,267,3,3,3,3,4,3,0,1,0,0,105,17,1,2,0,0,0,1,0,1,0,0,10,540232,904,25,0,0,1,-1,0,88,-1,0
KR_7753096451,17256,16284,275,287,9,6,6,9,13,6,1,0,0,0,17,19,7,4,0,0,1,0,1,0,0,0,10,540202,972,-12,3,-3,7,1,0,-2,3,0
KR_7753106975,14687,17853,230,251,6,13,13,6,7,21,0,1,0,0,37,17,6,4,0,1,1,0,0,1,0,0,10,540257,-3166,-21,-7,7,-14,-1,0,20,2,-1
KR_7753121655,13811,16164,268,258,3,8,8,3,2,13,0,1,0,0,15,20,3,5,0,0,0,1,0,1,0,0,10,540212,-2353,10,-5,5,-11,-1,0,-5,-2,0
KR_7753127179,15320,15156,249,264,6,5,5,6,11,5,1,0,0,0,15,14,4,4,0,1,1,0,1,0,0,0,10,540219,164,-15,1,-1,6,1,0,1,0,-1
KR_7753128580,14731,14662,263,285,5,3,3,5,5,1,0,1,0,0,13,28,4,4,0,2,1,0,0,1,0,0,10,540223,69,-22,2,-2,4,-1,0,-15,0,-2
KR_7753130829,14882,16703,209,265,6,7,7,6,5,15,0,0,0,0,17,20,5,3,0,2,0,1,0,0,0,0,10,540247,-1821,-56,-1,1,-10,0,0,-3,2,-2
KR_7753133036,14281,14576,317,308,1,2,2,1,0,1,1,0,0,0,18,15,3,7,1,1,1,0,1,0,0,0,10,540221,-295,9,-1,1,-1,1,0,3,-4,0
KR_7753137297,15523,16420,264,258,4,8,8,4,5,13,0,0,0,0,18,19,3,6,0,0,0,1,0,0,0,0,10,540246,-897,6,-4,4,-8,0,0,-1,-3,0
KR_7753138147,16371,15351,262,248,7,6,6,8,6,8,0,0,0,0,16,128,3,0,1,1,1,0,0,0,0,0,10,540205,1020,14,1,-2,-2,0,0,-112,3,0
KR_7753146459,13644,15476,265,266,2,6,6,2,3,8,0,1,0,0,21,24,5,8,0,0,1,0,0,1,0,0,10,540194,-1832,-1,-4,4,-5,-1,0,-3,-3,0
KR_7753169043,16968,12812,288,253,9,1,1,9,8,0,1,0,0,0,16,17,4,2,0,0,1,0,1,0,0,0,10,540232,4156,35,8,-8,8,1,0,-1,2,0
KR_7753183395,16654,14261,242,247,9,4,4,9,13,3,0,0,0,0,31,16,5,3,0,0,1,0,0,0,0,0,10,540090,2393,-5,5,-5,10,0,0,15,2,0
KR_7753191726,15434,14531,264,272,6,3,3,6,2,5,0,0,0,0,37,22,1,4,1,0,0,1,0,0,0,0,10,540246,903,-8,3,-3,-3,0,0,15,-3,1
KR_7753193663,14117,15037,258,258,3,5,5,3,3,7,0,0,0,0,17,15,5,2,0,0,1,0,0,0,0,0,10,540242,-920,0,-2,2,-4,0,0,2,3,0
KR_7753203190,17506,16586,230,258,13,9,9,14,13,8,1,0,0,0,23,16,3,3,3,1,1,0,1,0,0,0,10,540247,920,-28,4,-5,5,1,0,7,0,2
KR_7753220575,16394,14628,294,269,6,3,3,6,5,3,0,0,0,0,22,17,4,4,1,0,1,0,0,0,0,0,10,540183,1766,25,3,-3,2,0,0,5,0,1
KR_7753221224,15445,17680,270,276,4,9,9,4,5,14,0,0,0,0,19,19,4,6,2,0,0,1,0,0,0,0,10,540230,-2235,-6,-5,5,-9,0,0,0,-2,2
KR_7753222449,14237,16064,270,293,2,6,6,2,2,5,0,0,0,0,15,19,5,7,1,1,0,1,0,0,0,0,10,540234,-1827,-23,-4,4,-3,0,0,-4,-2,0
KR_7753233772,13870,17440,215,267,2,10,10,2,4,15,0,1,0,0,110,19,4,5,3,2,0,1,0,1,0,0,10,540238,-3570,-52,-8,8,-11,-1,0,91,-1,1
KR_7753243231,13844,14662,301,289,0,3,3,0,0,6,0,1,0,0,17,21,7,5,0,0,0,1,0,1,0,0,10,540233,-818,12,-3,3,-6,-1,0,-4,2,0
KR_7753244686,17140,17052,289,304,7,7,8,7,9,9,0,1,0,0,45,120,3,5,0,0,0,1,0,1,0,0,10,540185,88,-15,0,1,0,-1,0,-75,-2,0
KR_7753260997,13861,14141,291,278,1,2,2,1,0,2,0,0,0,0,21,20,6,5,0,0,1,0,0,0,0,0,10,540248,-280,13,-1,1,-2,0,0,1,1,0
KR_7753262925,17230,14613,260,218,10,6,6,10,8,7,1,0,0,0,16,25,2,2,1,0,1,0,1,0,0,0,10,540207,2617,42,4,-4,1,1,0,-9,0,1
KR_7753272413,16326,14661,262,261,9,4,4,9,6,2,1,0,0,0,17,18,4,7,2,2,1,0,1,0,0,0,10,540216,1665,1,5,-5,4,1,0,-1,-3,0
KR_7753284881,12374,14768,254,287,1,4,4,1,0,1,1,0,0,0,14,15,1,0,0,0,0,1,1,0,0,0,10,540220,-2394,-33,-3,3,-1,1,0,-1,1,0
KR_7753295477,14502,14635,252,244,4,7,7,4,6,5,0,1,0,0,18,11,1,1,1,0,1,0,0,1,0,0,10,540268,-133,8,-3,3,1,-1,0,7,0,1
KR_7753303696,14106,14884,207,244,5,4,4,5,2,4,0,1,0,0,17,14,3,0,1,0,1,0,0,1,0,0,10,540127,-778,-37,1,-1,-2,-1,0,3,3,1
KR_7753315862,13298,15249,248,266,2,5,5,2,2,4,0,0,0,0,15,15,3,2,0,0,1,0,0,0,0,0,10,540241,-1951,-18,-3,3,-2,0,0,0,1,0
KR_7753321212,17303,14073,319,282,7,2,2,7,10,2,0,0,0,0,116,17,6,4,1,0,1,0,0,0,0,0,10,540195,3230,37,5,-5,8,0,0,99,2,1
KR_7753335278,16033,15061,292,266,6,5,5,6,10,6,0,0,0,0,13,213,2,2,1,0,1,0,0,0,0,0,10,540201,972,26,1,-1,4,0,0,-200,0,1
KR_7753342854,12015,17589,201,291,1,8,8,1,2,12,0,0,0,0,32,32,5,3,0,0,0,1,0,0,0,0,10,540248,-5574,-90,-7,7,-10,0,0,0,2,0
KR_7753437127,16627,16182,251,237,11,7,7,12,5,8,0,0,0,0,9,14,1,1,0,0,1,0,0,0,0,0,10,540250,445,14,4,-5,-3,0,0,-5,0,0
KR_7753456440,17884,15963,261,215,12,8,8,12,7,11,1,0,0,0,16,33,3,1,1,0,0,1,1,0,0,0,10,540272,1921,46,4,-4,-4,1,0,-17,2,1
KR_7753482707,13296,16759,281,284,1,9,9,1,0,11,0,0,0,0,32,15,3,3,0,0,0,1,0,0,0,0,10,540267,-3463,-3,-8,8,-11,0,0,17,0,0
KR_7753488615,14937,16078,244,243,6,8,8,6,7,9,1,0,0,0,9,17,2,1,0,1,1,0,1,0,0,0,10,540201,-1141,1,-2,2,-2,1,0,-8,1,-1
KR_7753495110,18380,17742,239,245,15,11,11,15,13,9,0,0,0,0,20,21,0,4,2,1,1,0,0,0,0,0,10,540096,638,-6,4,-4,4,0,0,-1,-4,1
KR_7753506057,16517,14544,250,274,9,4,4,9,9,3,0,1,0,0,55,13,3,5,1,0,1,0,0,1,0,0,10,540298,1973,-24,5,-5,6,-1,0,42,-2,1
KR_7753561997,17079,18101,220,234,11,12,12,11,12,16,0,1,0,0,17,18,0,3,1,0,0,1,0,1,0,0,10,540239,-1022,-14,-1,1,-4,-1,0,-1,-3,1
KR_7753586469,15769,14188,254,252,7,3,3,7,16,3,0,0,0,0,44,18,1,4,0,1,1,0,0,0,0,0,10,540218,1581,2,4,-4,13,0,0,26,-3,-1
KR_7753609316,14628,15129,262,285,4,4,4,4,8,7,1,0,0,0,15,33,1,1,0,1,0,1,1,0,0,0,10,540255,-501,-23,0,0,1,1,0,-18,0,-1
KR_7753627265,14933,15672,260,262,5,7,7,6,3,9,1,0,0,0,41,14,5,2,0,0,0,1,1,0,0,0,10,540121,-739,-2,-2,1,-6,1,0,27,3,0
KR_7753642755,15129,15132,294,297,3,4,4,3,4,4,0,1,0,0,16,17,0,1,2,0,0,1,0,1,0,0,10,540208,-3,-3,-1,1,0,-1,0,-1,-1,2
KR_7753667997,15120,15992,252,224,5,10,10,5,7,10,0,0,0,0,17,17,2,6,0,0,0,1,0,0,0,0,10,540216,-872,28,-5,5,-3,0,0,0,-4,0
KR_7753700279,16011,14526,249,269,7,3,3,7,6,3,0,0,0,0,14,13,4,2,1,1,0,1,0,0,0,0,10,540237,1485,-20,4,-4,3,0,0,1,2,0
KR_7753713940,14264,13648,276,259,2,2,2,2,2,4,0,0,0,0,15,32,2,5,2,1,0,1,0,0,0,0,10,540286,616,17,0,0,-2,0,0,-17,-3,1
KR_7753718939,15947,17996,253,261,7,12,12,7,10,21,0,0,0,0,13,40,2,3,0,2,0,1,0,0,0,0,10,540253,-2049,-8,-5,5,-11,0,0,-27,-1,-2
KR_7753740621,13823,14396,229,257,3,4,4,3,6,4,0,1,0,0,14,21,5,3,0,0,1,0,0,1,0,0,10,540225,-573,-28,-1,1,2,-1,0,-7,2,0
KR_7753747786,15490,16562,251,236,7,11,11,7,8,13,1,0,0,0,15,18,6,4,0,1,1,0,1,0,0,0,10,540236,-1072,15,-4,4,-5,1,0,-3,2,-1
KR_7753769758,17706,13295,285,228,9,2,2,9,8,3,0,0,0,0,42,12,1,3,3,0,0,1,0,0,0,0,10,540273,4411,57,7,-7,5,0,0,30,-2,3
KR_7753786301,18617,16874,253,255,12,8,8,12,17,10,1,0,0,0,17,18,6,4,2,1,1,0,1,0,0,0,10,540119,1743,-2,4,-4,7,1,0,-1,2,1
KR_7753786942,14681,15563,256,287,5,5,5,5,8,7,0,0,0,0,37,17,4,0,0,0,1,0,0,0,0,0,10,540200,-882,-31,0,0,1,0,0,20,4,0
KR_7753793718,16562,16158,240,230,9,9,9,9,9,7,0,0,0,0,17,13,5,4,0,1,0,1,0,0,0,0,10,540242,404,10,0,0,2,0,0,4,1,-1
KR_7753813170,16306,14491,257,259,8,4,4,8,12,5,0,0,0,0,17,36,8,2,1,1,0,1,0,0,0,0,10,540297,1815,-2,4,-4,7,0,0,-19,6,0
KR_7753817409,15722,17459,251,269,6,13,13,6,4,6,0,1,0,0,16,37,3,1,1,1,0,1,0,1,0,0,10,540260,-1737,-18,-7,7,-2,-1,0,-21,2,0
KR_7753818696,14087,14754,282,263,2,4,4,2,4,8,0,0,0,0,35,18,3,3,0,1,1,0,0,0,0,0,10,540238,-667,19,-2,2,-4,0,0,17,0,-1
KR_7753841039,15416,15412,284,285,4,6,6,4,8,6,0,1,0,0,14,18,5,4,1,1,0,1,0,1,0,0,10,540223,4,-1,-2,2,2,-1,0,-4,1,0
KR_7753842245,15817,15274,258,253,8,7,7,8,10,9,0,0,0,0,16,15,2,2,0,0,0,1,0,0,0,0,10,540278,543,5,1,-1,1,0,0,1,0,0
KR_7753853876,13457,16212,228,291,2,6,6,2,3,6,0,0,0,0,39,13,1,7,0,2,0,1,0,0,0,0,10,540222,-2755,-63,-4,4,-3,0,0,26,-6,-2
KR_7753857677,16313,13410,271,225,10,2,2,10,5,2,1,0,0,0,18,17,5,1,2,0,1,0,1,0,0,0,10,540231,2903,46,8,-8,3,1,0,1,4,2
KR_7753873066,17438,13742,282,271,9,2,2,9,8,1,0,0,0,0,14,10,1,3,2,0,1,0,0,0,0,0,10,540286,3696,11,7,-7,7,0,0,4,-2,2
KR_7753896199,14089,17127,216,272,4,11,11,4,5,6,0,0,0,0,14,22,2,0,0,2,0,1,0,0,0,0,10,540218,-3038,-56,-7,7,-1,0,0,-8,2,-2
KR_7753901502,15020,17461,206,249,8,11,11,8,11,10,0,0,0,0,16,17,2,2,0,1,0,1,0,0,0,0,10,540201,-2441,-43,-3,3,1,0,0,-1,0,-1
KR_7753904048,14917,15576,253,258,5,5,5,5,9,9,0,0,0,0,14,16,4,1,1,2,1,0,0,0,0,0,10,540255,-659,-5,0,0,0,0,0,-2,3,-1
KR_7753911638,12933,15817,275,275,0,6,6,0,0,3,0,0,0,0,15,19,1,3,0,4,0,1,0,0,0,0,10,540222,-2884,0,-6,6,-3,0,0,-4,-2,-4
KR_7753954117,16131,16211,266,260,6,8,8,6,6,6,0,1,0,0,15,15,2,0,1,1,0,1,0,1,0,0,10,540193,-80,6,-2,2,0,-1,0,0,2,0
KR_7753965473,15485,16367,264,238,6,8,8,6,6,15,0,0,0,0,20,19,2,2,2,1,0,1,0,0,0,0,10,540207,-882,26,-2,2,-9,0,0,1,0,1
KR_7753966465,15216,18426,233,286,6,11,11,6,9,8,1,0,0,0,16,17,4,3,0,1,0,1,1,0,0,0,10,540217,-3210,-53,-5,5,1,1,0,-1,1,-1
KR_7753974396,15527,15206,236,175,7,9,9,7,5,14,0,0,0,0,12,16,2,2,3,0,1,0,0,0,0,0,10,540196,321,61,-2,2,-9,0,0,-4,0,3
KR_7753985778,14985,15474,275,284,5,5,5,5,5,3,1,0,0,0,17,15,4,3,0,3,1,0,1,0,0,0,10,540089,-489,-9,0,0,2,1,0,2,1,-3
KR_7753997878,14013,16917,235,264,4,9,9,4,6,16,0,0,0,0,17,13,3,2,1,0,1,0,0,0,0,0,10,540112,-2904,-29,-5,5,-10,0,0,4,1,1
KR_7754028693,12716,14218,208,289,2,2,2,2,4,2,0,0,0,0,18,37,4,4,0,1,1,0,0,0,0,0,10,540272,-1502,-81,0,0,2,0,0,-19,0,-1
KR_7754029784,16021,13639,240,243,8,2,2,8,11,2,0,0,0,0,35,41,4,4,1,0,1,0,0,0,0,0,10,540086,2382,-3,6,-6,9,0,0,-6,0,1
KR_7754039147,13808,16061,246,259,4,7,7,4,2,4,0,0,0,0,16,22,1,2,1,2,1,0,0,0,0,0,10,540200,-2253,-13,-3,3,-2,0,0,-6,-1,-1
KR_7754050089,14466,16261,264,268,4,9,9,4,3,9,1,0,0,0,36,23,1,2,0,0,0,1,1,0,0,0,10,540153,-1795,-4,-5,5,-6,1,0,13,-1,0
KR_7754071225,14127,16282,261,287,3,7,7,3,1,6,0,0,0,0,16,33,5,5,0,1,0,1,0,0,0,0,10,540238,-2155,-26,-4,4,-5,0,0,-17,0,-1
KR_7754082948,15300,14306,297,262,4,3,3,4,2,3,0,0,0,0,12,16,4,1,1,0,1,0,0,0,0,0,10,540242,994,35,1,-1,-1,0,0,-4,3,1
KR_7754103150,15489,13543,293,259,4,2,2,5,5,4,0,1,0,0,31,25,0,2,0,0,0,1,0,1,0,0,10,540216,1946,34,2,-3,1,-1,0,6,-2,0
KR_7754105646,13947,15480,244,260,3,6,6,3,2,4,0,0,0,0,20,17,2,5,0,3,0,1,0,0,0,0,10,540216,-1533,-16,-3,3,-2,0,0,3,-3,-3
KR_7754108307,15792,15027,281,267,7,5,5,7,5,6,0,0,0,0,14,18,2,4,0,0,1,0,0,0,0,0,10,540233,765,14,2,-2,-1,0,0,-4,-2,0
KR_7754115857,14993,14137,276,260,5,3,3,5,4,7,1,0,0,0,17,14,2,5,1,0,1,0,1,0,0,0,10,540237,856,16,2,-2,-3,1,0,3,-3,1
KR_7754135874,15302,16819,283,278,4,7,7,4,5,11,0,0,0,0,16,34,7,5,1,0,0,1,0,0,0,0,10,540178,-1517,5,-3,3,-6,0,0,-18,2,1
KR_7754136714,14585,14995,242,265,6,4,4,6,10,3,0,1,0,0,16,22,6,3,0,1,1,0,0,1,0,0,10,540270,-410,-23,2,-2,7,-1,0,-6,3,-1
KR_7754142927,14632,17387,259,308,5,9,9,5,7,14,0,1,0,0,26,63,3,4,0,0,0,1,0,1,0,0,10,540253,-2755,-49,-4,4,-7,-1,0,-37,-1,0
KR_7754160330,17002,13702,286,250,10,2,2,10,9,2,1,0,0,0,15,12,1,0,2,0,1,0,1,0,0,0,10,540151,3300,36,8,-8,7,1,0,3,1,2
KR_7754176344,15293,14367,248,243,6,4,4,6,10,5,0,0,0,0,16,46,6,2,1,2,1,0,0,0,0,0,10,540281,926,5,2,-2,5,0,0,-30,4,-1
KR_7754182572,15862,13567,286,237,6,2,2,6,5,3,0,0,0,0,17,14,3,3,2,1,1,0,0,0,0,0,10,540182,2295,49,4,-4,2,0,0,3,0,1
KR_7754190863,19014,14256,275,250,13,3,3,13,14,3,0,0,0,0,37,15,0,2,1,0,0,1,0,0,0,0,10,540211,4758,25,10,-10,11,0,0,22,-2,1
KR_7754210178,15335,15244,269,272,4,4,5,4,3,8,0,1,0,0,19,18,2,4,2,0,1,0,0,1,0,0,10,540234,91,-3,0,1,-5,-1,0,1,-2,2
KR_7754231181,15240,16190,269,248,5,8,8,5,5,14,0,1,0,0,17,19,2,4,1,0,1,0,0,1,0,0,10,540202,-950,21,-3,3,-9,-1,0,-2,-2,1
KR_7754243520,13240,16074,281,286,0,6,6,0,0,6,0,1,0,0,14,18,1,3,0,0,0,1,0,1,0,0,10,540244,-2834,-5,-6,6,-6,-1,0,-4,-2,0
KR_7754244024,15263,15504,245,265,6,6,7,6,7,5,0,1,0,0,19,14,4,3,1,1,0,1,0,1,0,0,10,540231,-241,-20,0,1,2,-1,0,5,1,0
KR_7754273462,14123,15696,269,259,2,7,7,2,2,4,0,0,0,0,15,36,5,6,0,0,0,1,0,0,0,0,10,540179,-1573,10,-5,5,-2,0,0,-21,-1,0
KR_7754291317,15507,15701,256,278,5,6,6,5,5,7,0,0,0,0,21,89,0,2,0,0,1,0,0,0,0,0,10,540100,-194,-22,-1,1,-2,0,0,-68,-2,0
KR_7754298305,13425,14630,265,258,1,4,4,1,1,6,0,0,0,0,16,16,4,4,0,0,1,0,0,0,0,0,10,540235,-1205,7,-3,3,-5,0,0,0,0,0
KR_7754343258,16434,14341,217,209,12,6,6,12,8,5,0,0,0,0,14,11,1,2,2,0,0,1,0,0,0,0,10,540203,2093,8,6,-6,3,0,0,3,-1,2
KR_7754372482,14220,16997,227,247,5,11,11,5,5,9,0,0,0,0,14,15,4,3,0,0,1,0,0,0,0,0,10,540091,-2777,-20,-6,6,-4,0,0,-1,1,0
KR_7754373246,15851,14844,267,265,5,4,4,5,8,3,1,0,0,0,32,16,5,2,0,0,0,1,1,0,0,0,10,540239,1007,2,1,-1,5,1,0,16,3,0
KR_7754383944,15723,13657,269,242,6,3,3,6,8,3,0,0,0,0,60,17,2,0,1,0,0,1,0,0,0,0,10,540203,2066,27,3,-3,5,0,0,43,2,1
KR_7754396984,14623,16628,254,257,4,8,8,4,5,12,0,0,0,0,14,18,3,5,2,1,1,0,0,0,0,0,10,540204,-2005,-3,-4,4,-7,0,0,-4,-2,1
KR_7754410995,18406,15039,270,253,13,4,4,13,14,9,0,0,0,0,21,21,4,7,1,0,1,0,0,0,0,0,10,540289,3367,17,9,-9,5,0,0,0,-3,1
KR_7754416938,18639,15148,276,237,15,5,5,15,16,7,1,0,0,0,14,14,1,3,0,0,1,0,1,0,0,0,10,540146,3491,39,10,-10,9,1,0,0,-2,0
KR_7754429883,14455,15573,236,245,4,8,8,4,8,6,0,1,0,0,15,17,0,0,0,1,0,1,0,1,0,0,10,540238,-1118,-9,-4,4,2,-1,0,-2,0,-1
KR_7754444979,16912,14564,244,247,9,4,4,9,9,5,0,1,0,0,20,14,4,3,2,0,1,0,0,1,0,0,10,540225,2348,-3,5,-5,4,-1,0,6,1,2
KR_7754460644,16549,16581,261,223,9,10,10,9,5,10,1,0,0,0,17,15,3,5,1,1,1,0,1,0,0,0,10,540222,-32,38,-1,1,-5,1,0,2,-2,0
KR_7754476061,15200,15512,266,270,4,5,5,4,6,7,0,1,0,0,18,16,2,3,3,1,1,0,0,1,0,0,10,540247,-312,-4,-1,1,-1,-1,0,2,-1,2
KR_7754507149,13280,15644,239,293,2,5,5,2,0,4,0,1,0,0,36,35,4,3,0,2,0,1,0,1,0,0,10,540222,-2364,-54,-3,3,-4,-1,0,1,1,-2
KR_7754514669,14517,15038,242,247,4,6,6,4,4,8,0,1,0,0,15,70,1,2,2,0,1,0,0,1,0,0,10,540232,-521,-5,-2,2,-4,-1,0,-55,-1,2
KR_7754525423,16238,15585,249,254,7,7,7,7,7,6,1,0,0,0,63,19,5,1,3,1,0,1,1,0,0,0,10,540239,653,-5,0,0,1,1,0,44,4,2
KR_7754540408,14292,15883,246,307,4,4,4,4,2,5,0,0,0,0,17,21,7,0,1,2,0,1,0,0,0,0,10,540234,-1591,-61,0,0,-3,0,0,-4,7,-1
KR_7754559453,16358,15932,258,254,8,7,7,8,16,9,0,0,0,0,27,19,5,2,2,0,1,0,0,0,0,0,10,540230,426,4,1,-1,7,0,0,8,3,2
KR_7754576573,15602,15147,264,291,7,5,5,7,6,1,0,1,0,0,12,19,5,1,1,1,0,1,0,1,0,0,10,540223,455,-27,2,-2,5,-1,0,-7,4,0
KR_7754601691,15850,14255,287,229,5,5,5,5,9,3,1,0,0,0,16,15,5,4,2,0,1,0,1,0,0,0,10,540167,1595,58,0,0,6,1,0,1,1,2
KR_7754608388,15498,15541,261,256,7,6,6,7,6,7,1,0,0,0,13,16,6,2,0,0,1,0,1,0,0,0,10,540230,-43,5,1,-1,-1,1,0,-3,4,0
KR_7754616525,15667,14235,266,256,6,5,5,6,12,0,0,0,0,0,13,13,2,2,0,0,0,1,0,0,0,0,10,540246,1432,10,1,-1,12,0,0,0,0,0
KR_7754620088,16912,14657,263,256,8,4,7,8,11,4,1,0,0,0,16,18,1,4,2,1,0,1,1,0,0,0,10,540295,2255,7,4,-1,7,1,0,-2,-3,1
KR_7754640686,14625,16613,239,241,6,9,9,6,4,17,0,1,0,0,76,23,4,2,0,0,1,0,0,1,0,0,10,540254,-1988,-2,-3,3,-13,-1,0,53,2,0
KR_7754645545,16591,17078,273,261,8,8,8,8,9,13,0,0,0,0,20,35,6,4,3,2,1,0,0,0,0,0,10,540201,-487,12,0,0,-4,0,0,-15,2,1
KR_7754677766,16319,17811,217,284,10,10,10,10,14,9,0,1,0,0,19,14,3,2,0,1,0,1,0,1,0,0,10,540293,-1492,-67,0,0,5,-1,0,5,1,-1
KR_7754682874,16916,16405,286,259,7,9,9,7,12,10,0,0,0,0,18,17,5,3,1,0,0,1,0,0,0,0,10,540218,511,27,-2,2,2,0,0,1,2,1
KR_7754705925,13647,14382,268,273,2,3,3,2,1,4,0,1,0,0,13,33,1,2,0,0,1,0,0,1,0,0,10,540134,-735,-5,-1,1,-3,-1,0,-20,-1,0
KR_7754710043,14734,15173,257,268,4,4,4,4,4,6,1,0,0,0,18,17,3,4,0,1,1,0,1,0,0,0,10,540214,-439,-11,0,0,-2,1,0,1,-1,-1
KR_7754760856,14397,15733,258,271,3,6,6,3,3,11,0,1,0,0,43,14,0,5,1,0,1,0,0,1,0,0,10,540200,-1336,-13,-3,3,-8,-1,0,29,-5,1
KR_7754768743,15514,14889,264,226,6,5,5,7,8,5,0,0,0,0,23,14,5,2,1,0,0,1,0,0,0,0,10,540273,625,38,1,-2,3,0,0,9,3,1
KR_7754771693,13797,17343,242,287,3,9,9,3,3,10,0,1,0,0,17,34,0,4,1,0,0,1,0,1,0,0,10,540090,-3546,-45,-6,6,-7,-1,0,-17,-4,1
KR_7754775016,13459,13207,270,237,1,2,2,1,0,2,0,0,0,0,16,18,4,5,0,0,0,1,0,0,0,0,10,540236,252,33,-1,1,-2,0,0,-2,-1,0
KR_7754785314,17254,15504,244,243,13,7,7,13,10,4,0,0,0,0,112,17,1,1,0,1,0,1,0,0,0,0,10,540115,1750,1,6,-6,6,0,0,95,0,-1
KR_7754790004,16786,14681,271,253,8,4,4,8,5,3,0,0,0,0,21,17,1,2,3,1,1,0,0,0,0,0,10,540224,2105,18,4,-4,2,0,0,4,-1,2
KR_7754798526,15287,15763,242,274,6,6,6,6,9,6,0,0,0,0,12,18,0,3,0,1,0,1,0,0,0,0,10,540202,-476,-32,0,0,3,0,0,-6,-3,-1
KR_7754799128,14248,14713,264,282,2,3,3,2,4,4,0,0,0,0,14,13,1,3,0,1,0,1,0,0,0,0,10,540256,-465,-18,-1,1,0,0,0,1,-2,-1
KR_7754799775,15359,15674,267,280,5,5,5,5,7,6,0,1,0,0,25,16,1,3,2,2,0,1,0,1,0,0,10,540244,-315,-13,0,0,1,-1,0,9,-2,0
KR_7754807312,13788,16010,270,286,1,5,5,1,2,5,0,0,0,0,17,19,1,5,2,1,0,1,0,0,0,0,10,540265,-2222,-16,-4,4,-3,0,0,-2,-4,1
KR_7754824481,14460,18591,229,272,4,13,13,4,6,16,0,0,0,0,88,20,0,2,0,1,0,1,0,0,0,0,10,540245,-4131,-43,-9,9,-10,0,0,68,-2,-1
KR_7754856963,12430,16160,251,273,0,7,7,0,0,9,0,0,0,0,16,20,6,2,0,1,0,1,0,0,0,0,10,540200,-3730,-22,-7,7,-9,0,0,-4,4,-1
KR_7754858972,15865,15164,262,243,8,6,6,8,9,5,1,0,0,0,86,19,2,1,1,0,1,0,1,0,0,0,10,540248,701,19,2,-2,4,1,0,67,1,1
KR_7754859690,16513,16148,248,257,9,8,8,9,9,5,1,0,0,0,14,13,2,0,2,2,1,0,1,0,0,0,10,540201,365,-9,1,-1,4,1,0,1,2,0
KR_7754875778,16152,16141,273,262,7,6,7,7,7,9,0,0,0,0,14,19,6,3,0,1,1,0,0,0,0,0,10,540261,11,11,1,0,-2,0,0,-5,3,-1
KR_7754882945,14447,14364,263,264,4,4,4,4,3,4,0,1,0,0,17,16,1,5,0,0,0,1,0,1,0,0,10,540274,83,-1,0,0,-1,-1,0,1,-4,0
KR_7754886616,13567,13513,243,280,3,1,1,3,2,0,0,1,0,0,15,21,4,2,0,0,0,1,0,1,0,0,10,540201,54,-37,2,-2,2,-1,0,-6,2,0
KR_7754892998,15318,15293,262,241,5,7,7,5,4,11,0,0,0,0,17,33,3,5,1,0,1,0,0,0,0,0,10,540236,25,21,-2,2,-7,0,0,-16,-2,1
KR_7754910705,18733,16041,273,257,14,7,7,14,14,14,0,1,0,0,14,17,4,2,0,0,1,0,0,1,0,0,10,540265,2692,16,7,-7,0,-1,0,-3,2,0
KR_7754935260,13948,15107,276,283,2,4,4,2,1,5,0,0,0,0,35,15,1,5,1,0,1,0,0,0,0,0,10,540101,-1159,-7,-2,2,-4,0,0,20,-4,1
KR_7754935795,15474,16447,239,226,7,9,9,7,4,10,0,0,0,0,14,16,5,5,0,1,1,0,0,0,0,0,10,540120,-973,13,-2,2,-6,0,0,-2,0,-1
KR_7754936016,16226,13425,252,257,8,2,2,8,8,2,0,0,0,0,18,15,3,2,1,0,1,0,0,0,0,0,10,540219,2801,-5,6,-6,6,0,0,3,1,1
KR_7754957103,14294,15689,259,263,3,7,7,3,2,6,0,0,0,0,16,17,2,3,1,0,0,1,0,0,0,0,10,540078,-1395,-4,-4,4,-4,0,0,-1,-1,1
KR_7754960656,13626,15035,238,279,3,3,3,3,3,4,0,0,0,0,39,51,0,1,0,1,0,1,0,0,0,0,10,540248,-1409,-41,0,0,-1,0,0,-12,-1,-1
KR_7754965404,15798,17192,260,254,6,10,10,6,6,11,0,0,0,0,14,19,4,1,1,1,0,1,0,0,0,0,10,540086,-1394,6,-4,4,-5,0,0,-5,3,0
KR_7754974107,16604,14191,238,237,10,5,5,10,13,4,0,1,0,0,17,15,3,2,1,0,1,0,0,1,0,0,10,540229,2413,1,5,-5,9,-1,0,2,1,1
KR_7754988228,14139,16559,254,284,4,8,8,4,2,6,0,0,0,0,17,16,3,3,0,1,0,1,0,0,0,0,10,540270,-2420,-30,-4,4,-4,0,0,1,0,-1
KR_7754998898,15150,13793,303,282,4,2,2,4,3,1,0,1,0,0,16,19,2,3,0,0,1,0,0,1,0,0,10,540088,1357,21,2,-2,2,-1,0,-3,-1,0
KR_7755006621,14857,13549,236,243,5,3,3,5,4,4,0,0,0,0,15,14,4,6,1,0,0,1,0,0,0,0,10,540211,1308,-7,2,-2,0,0,0,1,-2,1
KR_7755012985,16340,14743,285,248,7,5,5,7,10,7,1,0,0,0,21,15,3,3,0,0,0,1,1,0,0,0,10,540260,1597,37,2,-2,3,1,0,6,0,0
KR_7755015380,14676,16184,280,284,3,5,6,3,7,8,0,0,0,0,18,39,2,6,0,0,0,1,0,0,0,0,10,540194,-1508,-4,-2,3,-1,0,0,-21,-4,0
KR_7755038139,14579,16117,249,247,5,8,8,5,3,11,1,0,0,0,21,34,3,5,1,0,0,1,1,0,0,0,10,540224,-1538,2,-3,3,-8,1,0,-13,-2,1
KR_7755040186,15177,18076,259,296,5,11,11,5,6,9,0,0,0,0,11,14,2,2,1,2,0,1,0,0,0,0,10,540182,-2899,-37,-6,6,-3,0,0,-3,0,-1
KR_7755043784,14473,13576,267,267,4,1,1,4,5,4,0,1,0,0,12,24,4,2,0,1,0,1,0,1,0,0,10,540201,897,0,3,-3,1,-1,0,-12,2,-1
KR_7755049317,19186,13213,284,226,12,2,2,12,13,1,0,0,0,0,112,33,2,3,4,0,1,0,0,0,0,0,10,540247,5973,58,10,-10,12,0,0,79,-1,4
KR_7755066001,16386,16052,248,268,10,7,7,10,7,6,0,1,0,0,16,18,4,3,0,2,1,0,0,1,0,0,10,540184,334,-20,3,-3,1,-1,0,-2,1,-2
KR_7755077894,14206,13975,240,252,4,2,2,4,2,4,0,0,0,0,28,16,3,2,0,2,1,0,0,0,0,0,10,540227,231,-12,2,-2,-2,0,0,12,1,-2
KR_7755096268,16355,13530,270,273,7,2,2,7,8,0,0,1,0,0,33,14,1,2,1,0,1,0,0,1,0,0,10,540193,2825,-3,5,-5,8,-1,0,19,-1,1
KR_7755098086,14075,14572,261,262,3,4,4,3,2,3,0,0,0,0,14,14,4,1,0,0,0,1,0,0,0,0,10,540155,-497,-1,-1,1,-1,0,0,0,3,0
KR_7755102023,15010,18031,276,283,4,9,9,4,3,16,0,0,0,0,15,18,4,5,1,2,1,0,0,0,0,0,10,540248,-3021,-7,-5,5,-13,0,0,-3,-1,-1
KR_7755108270,16199,17047,276,270,6,9,9,6,10,9,0,0,0,0,19,18,5,3,0,0,1,0,0,0,0,0,10,540168,-848,6,-3,3,1,0,0,1,2,0
KR_7755109590,15631,14180,251,259,6,3,3,6,11,3,0,0,0,0,22,17,4,5,1,1,1,0,0,0,0,0,10,540260,1451,-8,3,-3,8,0,0,5,-1,0
KR_7755116235,16135,14783,316,268,5,4,4,5,3,5,0,0,0,0,103,15,3,1,2,1,1,0,0,0,0,0,10,540190,1352,48,1,-1,-2,0,0,88,2,1
KR_7755121010,15355,16713,237,255,5,10,10,5,11,9,0,1,0,0,20,36,1,5,1,2,0,1,0,1,0,0,10,540224,-1358,-18,-5,5,2,-1,0,-16,-4,-1
KR_7755135002,15275,15848,277,282,5,6,6,5,3,11,0,0,0,0,40,19,5,4,0,0,1,0,0,0,0,0,10,540189,-573,-5,-1,1,-8,0,0,21,1,0
KR_7755140471,14759,14733,270,300,4,3,4,4,4,4,0,0,0,0,14,16,2,3,0,0,0,1,0,0,0,0,10,540267,26,-30,1,0,0,0,0,-2,-1,0
KR_7755160154,14476,15211,256,267,4,6,6,4,3,6,0,1,0,0,14,14,2,4,0,0,1,0,0,1,0,0,10,540282,-735,-11,-2,2,-3,-1,0,0,-2,0
KR_7755164717,14647,13689,282,273,3,1,1,3,2,0,0,0,0,0,14,18,4,4,0,1,1,0,0,0,0,0,10,540230,958,9,2,-2,2,0,0,-4,0,-1
KR_7755171311,17242,16236,267,241,10,8,8,10,7,7,0,0,0,0,15,19,2,1,3,0,1,0,0,0,0,0,10,540281,1006,26,2,-2,0,0,0,-4,1,3
KR_7755171328,14347,13709,298,283,2,1,1,2,1,2,0,1,0,0,15,111,4,1,1,1,0,1,0,1,0,0,10,540241,638,15,1,-1,-1,-1,0,-96,3,0
KR_7755173208,15453,12954,262,273,6,0,0,6,8,0,1,0,0,0,16,23,2,5,0,0,1,0,1,0,0,0,10,540254,2499,-11,6,-6,8,1,0,-7,-3,0
KR_7755178645,13108,17986,254,273,1,13,13,1,0,17,0,1,0,0,15,23,4,3,0,0,1,0,0,1,0,0,10,540153,-4878,-19,-12,12,-17,-1,0,-8,1,0
KR_7755180026,16664,14971,255,236,10,6,7,10,13,9,0,0,0,0,17,15,3,4,0,0,0,1,0,0,0,0,10,540246,1693,19,4,-3,4,0,0,2,-1,0
KR_7755183143,14023,15437,271,283,2,5,5,2,0,4,0,1,0,0,15,20,3,4,1,1,1,0,0,1,0,0,10,540187,-1414,-12,-3,3,-4,-1,0,-5,-1,0
KR_7755187335,15947,14876,287,260,6,4,4,7,5,5,1,0,0,0,13,26,5,2,1,1,1,0,1,0,0,0,10,540225,1071,27,2,-3,0,1,0,-13,3,0
KR_7755189228,16607,15142,264,264,9,4,4,9,9,2,0,1,0,0,16,33,10,3,0,1,1,0,0,1,0,0,10,540238,1465,0,5,-5,7,-1,0,-17,7,-1
KR_7755195442,16481,15328,256,252,8,7,7,8,8,8,0,0,0,0,19,14,2,3,0,0,1,0,0,0,0,0,10,540241,1153,4,1,-1,0,0,0,5,-1,0
KR_7755202248,14320,15756,298,280,2,6,6,2,1,7,1,0,0,0,18,16,2,7,0,2,0,1,1,0,0,0,10,540200,-1436,18,-4,4,-6,1,0,2,-5,-2
KR_7755204027,14986,14822,280,287,4,3,3,4,4,2,0,0,0,0,20,15,4,6,1,0,1,0,0,0,0,0,10,540255,164,-7,1,-1,2,0,0,5,-2,1
KR_7755211892,14442,13145,293,280,3,0,0,3,1,0,0,1,0,0,21,16,1,4,0,0,1,0,0,1,0,0,10,540227,1297,13,3,-3,1,-1,0,5,-3,0
KR_7755216425,14739,14176,240,257,6,4,4,6,3,3,0,0,0,0,12,13,2,0,0,0,0,1,0,0,0,0,10,540272,563,-17,2,-2,0,0,0,-1,2,0
KR_7755216754,16932,14655,289,240,8,5,5,8,5,7,0,1,0,0,37,16,3,2,1,2,0,1,0,1,0,0,10,540283,2277,49,3,-3,-2,-1,0,21,1,-1
KR_7755221244,16894,15768,240,270,9,4,4,9,15,4,0,0,0,0,116,18,2,2,0,1,1,0,0,0,0,0,10,540186,1126,-30,5,-5,11,0,0,98,0,-1
KR_7755233380,14613,14646,263,248,4,5,5,4,5,7,0,0,0,0,15,14,1,5,0,0,0,1,0,0,0,0,10,540233,-33,15,-1,1,-2,0,0,1,-4,0
KR_7755239263,15475,16466,254,282,6,6,6,6,7,7,0,1,0,0,16,34,2,3,1,1,1,0,0,1,0,0,10,540117,-991,-28,0,0,0,-1,0,-18,-1,0
KR_7755248533,16344,14157,284,286,7,2,2,7,7,2,0,1,0,0,15,14,4,5,0,0,1,0,0,1,0,0,10,540232,2187,-2,5,-5,5,-1,0,1,-1,0
KR_7755248829,15395,15166,265,278,5,4,4,5,6,3,0,1,0,0,15,35,1,1,1,1,0,1,0,1,0,0,10,540217,229,-13,1,-1,3,-1,0,-20,0,0
KR_7755249254,16013,13959,285,273,7,2,2,7,13,0,0,0,0,0,20,19,6,2,0,0,0,1,0,0,0,0,10,540220,2054,12,5,-5,13,0,0,1,4,0
KR_7755249809,15942,14650,276,241,6,4,4,6,3,3,0,0,0,0,133,33,5,4,2,1,1,0,0,0,0,0,10,540281,1292,35,2,-2,0,0,0,100,1,1
KR_7755250210,17462,12944,285,259,9,1,1,9,15,0,0,1,0,0,17,25,8,1,0,0,1,0,0,1,0,0,10,540270,4518,26,8,-8,15,-1,0,-8,7,0
KR_7755260769,15473,14032,294,290,4,1,1,4,3,2,0,0,0,0,18,34,0,2,0,1,1,0,0,0,0,0,10,540247,1441,4,3,-3,1,0,0,-16,-2,-1
KR_7755263434,15542,15450,293,296,4,5,5,4,2,6,0,1,0,0,15,20,6,3,2,0,1,0,0,1,0,0,10,540262,92,-3,-1,1,-4,-1,0,-5,3,2
KR_7755275061,16403,14146,266,262,9,2,2,9,15,3,1,0,0,0,42,16,2,4,0,1,1,0,1,0,0,0,10,540204,2257,4,7,-7,12,1,0,26,-2,-1
KR_7755276020,13812,16382,251,293,2,7,7,2,5,10,0,1,0,0,18,20,4,5,0,1,0,1,0,1,0,0,10,540251,-2570,-42,-5,5,-5,-1,0,-2,-1,-1
KR_7755283042,13972,14326,262,251,2,5,5,3,1,3,0,1,0,0,16,31,5,2,1,0,0,1,0,1,0,0,10,540214,-354,11,-3,2,-2,-1,0,-15,3,1
KR_7755284250,17287,15076,257,249,10,5,5,10,22,9,1,0,0,0,16,16,5,2,0,1,0,1,1,0,0,0,10,540225,2211,8,5,-5,13,1,0,0,3,-1
KR_7755292515,14209,15820,260,288,4,6,6,4,3,5,0,1,0,0,14,18,2,4,1,2,0,1,0,1,0,0,10,540239,-1611,-28,-2,2,-2,-1,0,-4,-2,-1
KR_7755296702,14501,14156,256,281,4,2,2,4,5,2,0,0,0,0,15,15,3,3,0,1,1,0,0,0,0,0,10,540222,345,-25,2,-2,3,0,0,0,0,-1
KR_7755297534,15297,15354,242,273,6,4,4,6,7,8,0,0,0,0,106,19,5,3,1,2,0,1,0,0,0,0,10,540248,-57,-31,2,-2,-1,0,0,87,2,-1
KR_7755303827,16065,15398,279,281,7,5,5,7,8,4,1,0,0,0,106,48,4,3,0,0,1,0,1,0,0,0,10,540235,667,-2,2,-2,4,1,0,58,1,0
KR_7755303888,13769,13136,243,252,3,1,1,3,2,2,0,0,0,0,15,15,4,2,0,0,1,0,0,0,0,0,10,540226,633,-9,2,-2,0,0,0,0,2,0
KR_7755309049,15554,13329,285,225,5,2,2,5,7,4,1,0,0,0,19,16,5,2,0,0,0,1,1,0,0,0,10,540262,2225,60,3,-3,3,1,0,3,3,0
KR_7755309756,17121,14631,254,279,9,2,2,9,11,2,0,1,0,0,15,17,5,1,0,1,1,0,0,1,0,0,10,540251,2490,-25,7,-7,9,-1,0,-2,4,-1
KR_7755325749,17891,13787,275,263,12,2,2,12,13,2,0,0,0,0,15,19,3,3,0,1,1,0,0,0,0,0,10,540251,4104,12,10,-10,11,0,0,-4,0,-1
KR_7755333649,14313,16041,290,259,2,7,7,2,2,9,0,0,0,0,17,37,4,3,0,0,0,1,0,0,0,0,10,540194,-1728,31,-5,5,-7,0,0,-20,1,0
KR_7755339818,13810,17886,245,261,4,12,12,4,2,8,1,0,0,0,15,136,5,1,0,0,1,0,1,0,0,0,10,540243,-4076,-16,-8,8,-6,1,0,-121,4,0
KR_7755352547,15296,14993,290,277,5,5,5,5,3,8,0,1,0,0,16,35,2,4,0,0,0,1,0,1,0,0,10,540240,303,13,0,0,-5,-1,0,-19,-2,0
KR_7755371607,13652,16170,294,295,1,5,5,1,0,7,0,0,0,0,367,14,2,2,1,1,0,1,0,0,0,0,10,540268,-2518,-1,-4,4,-7,0,0,353,0,0
KR_7755384348,16601,14568,257,264,9,3,3,9,9,4,0,0,0,0,19,17,6,4,0,0,1,0,0,0,0,0,10,540228,2033,-7,6,-6,5,0,0,2,2,0
KR_7755387415,16755,15474,268,258,7,7,7,7,9,8,0,1,0,0,22,17,2,3,4,0,0,1,0,1,0,0,10,540259,1281,10,0,0,1,-1,0,5,-1,4
KR_7755405016,13945,15211,256,244,3,8,8,3,3,9,0,1,0,0,14,18,2,2,0,0,0,1,0,1,0,0,10,540300,-1266,12,-5,5,-6,-1,0,-4,0,0
KR_7755414741,15358,16562,263,247,5,9,9,5,6,10,0,0,0,0,16,17,3,3,1,1,1,0,0,0,0,0,10,540238,-1204,16,-4,4,-4,0,0,-1,0,0
KR_7755420484,15075,14671,256,245,6,5,5,6,4,5,0,0,0,0,76,18,4,2,0,0,0,1,0,0,0,0,10,540230,404,11,1,-1,-1,0,0,58,2,0
KR_7755425675,16540,13192,276,280,7,0,0,7,10,0,0,1,0,0,86,11,5,1,2,1,1,0,0,1,0,0,10,540259,3348,-4,7,-7,10,-1,0,75,4,1
KR_7755427218,15967,17045,224,248,8,10,10,8,7,10,0,0,0,0,16,35,1,4,0,0,0,1,0,0,0,0,10,540236,-1078,-24,-2,2,-3,0,0,-19,-3,0
KR_7755429547,14298,14684,269,277,2,5,5,2,2,2,0,1,0,0,15,216,3,4,0,2,0,1,0,1,0,0,10,540214,-386,-8,-3,3,0,-1,0,-201,-1,-2
KR_7755435912,13471,16769,225,287,3,8,8,3,5,10,1,0,0,0,15,15,1,3,0,3,1,0,1,0,0,0,10,540248,-3298,-62,-5,5,-5,1,0,0,-2,-3
KR_7755444244,12557,16436,227,248,1,8,8,1,1,11,0,0,0,0,11,36,3,5,0,0,1,0,0,0,0,0,10,540182,-3879,-21,-7,7,-10,0,0,-25,-2,0
KR_7755452037,14702,13415,266,256,5,2,2,5,5,5,0,1,0,0,15,11,1,2,0,0,1,0,0,1,0,0,10,540248,1287,10,3,-3,0,-1,0,4,-1,0
KR_7755456541,17518,13458,249,276,10,1,2,10,19,0,0,1,0,0,15,15,3,3,1,0,1,0,0,1,0,0,10,540265,4060,-27,9,-8,19,-1,0,0,0,1
KR_7755464592,15777,16456,252,275,7,9,9,7,8,5,0,0,0,0,16,89,2,3,0,0,0,1,0,0,0,0,10,540214,-679,-23,-2,2,3,0,0,-73,-1,0
KR_7755479967,15309,14985,298,271,4,5,5,4,3,5,0,1,0,0,16,13,2,5,0,0,1,0,0,1,0,0,10,540243,324,27,-1,1,-2,-1,0,3,-3,0
KR_7755512609,17153,15963,208,211,12,9,9,12,11,7,0,0,0,0,46,195,2,2,1,1,1,0,0,0,0,0,10,540284,1190,-3,3,-3,4,0,0,-149,0,0
KR_7755533517,13778,13762,259,234,2,4,4,2,2,2,0,0,0,0,20,22,3,3,0,0,0,1,0,0,0,0,10,540209,16,25,-2,2,0,0,0,-2,0,0
KR_7755546649,13500,16798,222,247,2,10,10,2,2,13,0,0,0,0,14,24,1,4,2,1,0,1,0,0,0,0,10,540100,-3298,-25,-8,8,-11,0,0,-10,-3,1
KR_7755555822,13966,16144,268,236,3,9,9,3,4,6,0,0,0,0,15,29,1,5,0,1,1,0,0,0,0,0,10,540226,-2178,32,-6,6,-2,0,0,-14,-4,-1
KR_7755588419,14632,15689,295,287,2,4,4,2,3,8,0,1,0,0,17,32,0,3,2,1,0,1,0,1,0,0,10,540232,-1057,8,-2,2,-5,-1,0,-15,-3,1
KR_7755596091,15716,17233,228,270,8,8,8,8,14,9,0,1,0,0,12,14,2,0,1,2,1,0,0,1,0,1,10,540212,-1517,-42,0,0,5,-1,0,-2,2,-1
KR_7755608262,11995,17211,209,261,1,12,12,1,1,12,0,1,0,0,18,25,4,2,0,0,0,1,0,1,0,0,10,540236,-5216,-52,-11,11,-11,-1,0,-7,2,0
KR_7755615704,17459,16263,250,261,10,6,6,10,18,13,1,0,0,0,16,16,1,4,2,0,1,0,1,0,0,0,10,540244,1196,-11,4,-4,5,1,0,0,-3,2
KR_7755620426,16001,16387,266,256,7,9,9,7,9,8,0,0,0,0,16,104,1,2,0,0,0,1,0,0,0,0,10,540238,-386,10,-2,2,1,0,0,-88,-1,0
KR_7755641549,15461,14050,252,252,6,2,2,6,8,3,0,0,0,0,15,15,2,4,1,0,0,1,0,0,0,0,10,540261,1411,0,4,-4,5,0,0,0,-2,1
KR_7755645837,14240,17539,240,258,4,12,12,4,3,14,0,1,0,0,121,17,1,5,0,1,0,1,0,1,0,0,10,540105,-3299,-18,-8,8,-11,-1,0,104,-4,-1
KR_7755647478,14965,13688,275,251,4,2,2,4,3,2,0,0,0,0,16,15,5,5,0,1,0,1,0,0,0,0,10,540256,1277,24,2,-2,1,0,0,1,0,-1
KR_7755650347,15169,14644,262,236,5,5,5,5,6,11,0,0,0,0,62,22,1,1,0,1,0,1,0,0,0,0,10,540187,525,26,0,0,-5,0,0,40,0,-1
KR_7755666933,14097,16633,254,277,3,8,8,3,4,9,0,0,0,0,24,163,0,3,0,1,0,1,0,0,0,0,10,540200,-2536,-23,-5,5,-5,0,0,-139,-3,-1
KR_7755672982,14709,15020,277,256,4,6,6,4,3,9,0,1,0,0,16,25,4,4,0,0,0,1,0,1,0,0,10,540189,-311,21,-2,2,-6,-1,0,-9,0,0
KR_7755684396,14342,13416,295,248,2,2,2,2,2,4,0,1,0,0,27,27,2,3,0,0,1,0,0,1,0,0,10,540101,926,47,0,0,-2,-1,0,0,-1,0
KR_7755691907,16534,13748,241,249,9,3,3,9,13,4,1,0,0,0,19,11,1,3,0,0,0,1,1,0,0,0,10,540215,2786,-8,6,-6,9,1,0,8,-2,0
KR_7755694863,15576,14828,292,257,5,4,4,5,2,7,0,1,0,0,15,17,6,2,1,0,1,0,0,1,0,0,10,540246,748,35,1,-1,-5,-1,0,-2,4,1
KR_7755708898,16603,15149,233,249,9,6,6,9,12,7,1,0,0,0,25,35,1,1,1,0,0,1,1,0,0,0,10,540251,1454,-16,3,-3,5,1,0,-10,0,1
KR_7755714365,13369,16714,273,275,1,10,10,1,1,13,0,1,0,0,28,23,1,3,0,1,0,1,0,1,0,0,10,540253,-3345,-2,-9,9,-12,-1,0,5,-2,-1
KR_7755716975,13637,16209,242,244,2,9,9,2,2,9,0,0,0,0,13,126,2,3,0,0,0,1,0,0,0,0,10,540224,-2572,-2,-7,7,-7,0,0,-113,-1,0
KR_7755721917,17187,15487,248,284,11,5,5,11,22,8,1,0,0,0,19,18,3,4,1,2,0,1,1,0,0,0,10,540200,1700,-36,6,-6,14,1,0,1,-1,-1
KR_7755724184,14272,15518,241,237,4,7,8,4,3,10,0,0,0,0,22,13,2,2,0,0,0,1,0,0,0,0,10,540258,-1246,4,-3,4,-7,0,0,9,0,0
KR_7755724912,15333,14483,278,271,5,3,3,5,5,2,0,0,0,0,16,16,1,5,1,0,1,0,0,0,0,0,10,540233,850,7,2,-2,3,0,0,0,-4,1
KR_7755738634,15014,14578,303,271,4,3,3,4,2,4,0,1,0,0,11,17,6,2,0,0,1,0,0,1,0,0,10,540200,436,32,1,-1,-2,-1,0,-6,4,0
KR_7755750508,15797,15558,261,260,6,7,7,6,7,5,0,1,0,0,12,14,2,1,0,0,0,1,0,1,0,0,10,540244,239,1,-1,1,2,-1,0,-2,1,0
KR_7755751699,15241,17078,255,284,7,8,8,7,4,9,1,0,0,0,20,17,1,7,0,1,0,1,1,0,0,0,10,540272,-1837,-29,-1,1,-5,1,0,3,-6,-1
KR_7755752915,13786,13446,283,252,1,1,1,1,0,1,0,0,0,0,16,202,1,2,1,0,1,0,0,0,0,0,10,540253,340,31,0,0,-1,0,0,-186,-1,1
KR_7755764916,16053,14758,282,264,6,4,4,6,4,6,0,0,0,0,14,28,1,2,2,0,0,1,0,0,0,0,10,540218,1295,18,2,-2,-2,0,0,-14,-1,2
KR_7755770796,18222,14627,280,252,12,4,4,12,12,9,0,1,0,0,14,10,4,0,3,0,1,0,0,1,0,0,10,540210,3595,28,8,-8,3,-1,0,4,4,3
KR_7755782580,16637,14778,260,252,10,4,5,10,14,4,0,0,0,0,15,18,2,3,2,2,1,0,0,0,0,0,10,540237,1859,8,6,-5,10,0,0,-3,-1,0
KR_7755792510,17129,17622,260,240,9,11,11,9,5,13,0,0,0,0,15,17,2,3,2,1,1,0,0,0,0,0,10,540241,-493,20,-2,2,-8,0,0,-2,-1,1
KR_7755793832,16500,14217,271,266,7,3,3,7,8,3,0,0,0,0,13,107,3,1,0,0,1,0,0,0,0,0,10,540222,2283,5,4,-4,5,0,0,-94,2,0
KR_7755805339,16196,15517,260,248,8,5,5,9,14,4,0,0,0,0,17,15,2,4,0,0,1,0,0,0,0,0,10,540086,679,12,3,-4,10,0,0,2,-2,0
KR_7755809053,16374,16074,255,256,8,8,8,8,5,8,0,1,0,0,16,30,2,3,2,0,1,0,0,1,0,0,10,540222,300,-1,0,0,-3,-1,0,-14,-1,2
KR_7755810974,14642,13935,316,308,1,0,0,1,2,0,0,1,0,0,15,12,2,5,0,0,1,0,0,1,0,0,10,540253,707,8,1,-1,2,-1,0,3,-3,0
KR_7755816587,14324,13169,270,246,4,1,1,4,3,1,0,0,0,0,17,18,1,1,1,1,1,0,0,0,0,0,10,540240,1155,24,3,-3,2,0,0,-1,0,0
KR_7755819030,17112,17576,237,266,11,10,10,11,11,15,0,0,0,0,13,15,3,3,0,2,1,0,0,0,0,0,10,540264,-464,-29,1,-1,-4,0,0,-2,0,-2
KR_7755819743,14699,16020,256,267,4,7,7,4,4,13,0,0,0,0,16,56,5,4,0,1,0,1,0,0,0,0,10,540082,-1321,-11,-3,3,-9,0,0,-40,1,-1
KR_7755823017,15205,13416,286,252,4,2,2,4,1,3,0,1,0,0,9,18,3,4,0,0,1,0,0,1,0,0,10,540231,1789,34,2,-2,-2,-1,0,-9,-1,0
KR_7755824660,16193,14156,277,260,6,3,3,6,9,2,1,0,0,0,30,19,3,3,1,1,0,1,1,0,0,0,10,540228,2037,17,3,-3,7,1,0,11,0,0
KR_7755825823,16856,14000,266,244,10,3,3,10,9,1,0,0,0,0,16,31,5,6,2,0,1,0,0,0,0,0,10,540252,2856,22,7,-7,8,0,0,-15,-1,2
KR_7755828288,16524,14579,278,261,9,5,5,9,6,4,0,0,0,0,17,17,0,5,0,0,0,1,0,0,0,0,10,540253,1945,17,4,-4,2,0,0,0,-5,0
KR_7755842076,15826,14421,289,303,5,2,2,5,6,1,1,0,0,0,62,18,2,4,0,1,1,0,1,0,0,0,10,540253,1405,-14,3,-3,5,1,0,44,-2,-1
KR_7755842250,14446,15191,256,261,4,6,6,4,4,4,0,0,0,0,16,18,5,4,0,1,0,1,0,0,0,0,10,540215,-745,-5,-2,2,0,0,0,-2,1,-1
KR_7755842691,15449,14269,280,276,5,2,2,5,7,3,0,0,0,0,15,19,2,1,0,0,1,0,0,0,0,0,10,540255,1180,4,3,-3,4,0,0,-4,1,0
KR_7755845629,15038,13486,276,224,5,4,5,5,2,1,0,1,0,0,17,16,4,5,1,0,0,1,0,1,0,0,10,540251,1552,52,1,0,1,-1,0,1,-1,1
KR_7755850512,16549,15485,243,229,9,7,7,9,12,7,0,0,0,0,38,32,2,4,0,0,0,1,0,0,0,0,10,540219,1064,14,2,-2,5,0,0,6,-2,0
KR_7755856876,15798,15406,249,281,6,5,5,6,6,3,0,0,0,0,35,33,3,4,1,2,0,1,0,0,0,0,10,540229,392,-32,1,-1,3,0,0,2,-1,-1
KR_7755864132,16132,13847,263,195,8,5,5,8,12,5,0,1,0,0,19,14,2,3,0,0,0,1,0,1,0,0,10,540215,2285,68,3,-3,7,-1,0,5,-1,0
KR_7755870790,15586,15711,278,284,5,5,5,5,5,6,0,0,0,0,18,18,4,6,1,1,0,1,0,0,0,0,10,540239,-125,-6,0,0,-1,0,0,0,-2,0
KR_7755871284,17048,14459,278,245,8,4,5,8,11,6,0,1,0,0,17,30,4,2,3,0,1,0,0,1,0,0,10,540242,2589,33,4,-3,5,-1,0,-13,2,3
KR_7755873216,16280,14741,285,254,6,4,4,6,11,6,0,1,0,0,19,14,4,4,1,1,1,0,0,1,0,0,10,540270,1539,31,2,-2,5,-1,0,5,0,0
KR_7755882517,15120,14934,243,294,6,3,3,6,9,2,1,0,0,0,15,14,2,6,0,0,1,0,1,0,0,0,10,540232,186,-51,3,-3,7,1,0,1,-4,0
KR_7755883745,15512,13176,278,254,5,1,1,5,6,1,0,1,0,0,31,20,2,1,0,0,1,0,0,1,0,0,10,540247,2336,24,4,-4,5,-1,0,11,1,0
KR_7755884491,14270,14286,303,287,2,2,2,2,1,2,0,1,0,0,17,17,1,3,0,0,1,0,0,1,0,0,10,540237,-16,16,0,0,-1,-1,0,0,-2,0
KR_7755886611,12473,18221,221,297,1,11,11,1,0,13,0,0,0,0,13,18,3,1,1,3,0,1,0,0,0,0,10,540208,-5748,-76,-10,10,-13,0,0,-5,2,-2
KR_7755892321,16636,15027,255,290,8,3,3,8,12,3,0,0,0,0,123,17,5,5,1,1,1,0,0,0,0,0,10,540249,1609,-35,5,-5,9,0,0,106,0,0
KR_7755899029,14194,14648,246,277,4,3,3,4,3,3,0,1,0,0,14,9,1,4,1,2,1,0,0,1,0,0,10,540236,-454,-31,1,-1,0,-1,0,5,-3,-1
KR_7755899091,15845,16732,274,270,6,7,7,6,5,9,0,1,0,0,16,18,2,3,1,1,0,1,0,1,0,0,10,540232,-887,4,-1,1,-4,-1,0,-2,-1,0
KR_7755901896,15315,17348,283,254,5,12,12,5,5,11,0,0,0,0,22,15,2,3,0,1,0,1,0,0,0,0,10,540184,-2033,29,-7,7,-6,0,0,7,-1,-1
KR_7755910621,15175,14817,260,289,4,3,3,4,8,3,0,0,0,0,18,31,0,7,0,0,1,0,0,0,0,0,10,540243,358,-29,1,-1,5,0,0,-13,-7,0
KR_7755916316,16221,14305,276,277,7,3,3,7,5,4,0,0,0,0,18,16,6,3,1,1,1,0,0,0,0,0,10,540234,1916,-1,4,-4,1,0,0,2,3,0
KR_7755920927,16198,13924,271,273,6,2,2,6,6,1,0,0,0,0,17,16,3,2,0,1,0,1,0,0,0,0,10,540173,2274,-2,4,-4,5,0,0,1,1,-1
KR_7755928478,15251,14392,259,255,5,3,3,5,7,3,0,1,0,0,41,18,2,4,0,1,0,1,0,1,0,0,10,540304,859,4,2,-2,4,-1,0,23,-2,-1
KR_7755931091,14463,15051,286,269,3,5,5,3,4,3,0,0,0,0,36,15,5,2,0,0,1,0,0,0,0,0,10,540219,-588,17,-2,2,1,0,0,21,3,0
KR_7755934075,13994,14864,288,301,2,3,3,2,2,2,1,0,0,0,17,15,1,4,0,1,1,0,1,0,0,0,10,540209,-870,-13,-1,1,0,1,0,2,-3,-1
KR_7755937721,13615,14266,238,291,3,2,2,3,4,1,1,0,0,0,17,12,1,6,0,0,0,1,1,0,0,0,10,540209,-651,-53,1,-1,3,1,0,5,-5,0
KR_7755940944,16648,14610,282,237,8,5,5,8,6,4,0,0,0,0,13,18,2,3,1,0,1,0,0,0,0,0,10,540175,2038,45,3,-3,2,0,0,-5,-1,1
KR_7755941048,15118,15541,248,261,5,6,6,5,5,8,0,0,0,0,28,19,4,2,1,0,0,1,0,0,0,0,10,540233,-423,-13,-1,1,-3,0,0,9,2,1
KR_7755944909,15812,13747,272,244,6,2,2,6,8,1,0,0,0,0,13,35,5,2,0,1,1,0,0,0,0,0,10,540250,2065,28,4,-4,7,0,0,-22,3,-1
KR_7755947279,15647,14847,245,261,7,4,4,7,11,7,0,1,0,0,16,15,4,5,1,2,1,0,0,1,0,0,10,540208,800,-16,3,-3,4,-1,0,1,-1,-1
KR_7755959970,14477,15095,263,254,5,4,4,5,2,4,1,0,0,0,21,41,1,9,0,1,1,0,1,0,0,0,10,540248,-618,9,1,-1,-2,1,0,-20,-8,-1
KR_7755961767,16911,14446,257,231,10,4,4,10,15,8,0,0,0,0,16,19,3,3,0,1,0,1,0,0,0,0,10,540083,2465,26,6,-6,7,0,0,-3,0,-1
KR_7755963190,14151,14436,242,270,4,3,3,4,4,3,0,0,0,0,16,37,5,5,0,1,0,1,0,0,0,0,10,540250,-285,-28,1,-1,1,0,0,-21,0,-1
KR_7755964718,14856,15583,223,278,5,7,7,5,8,3,0,1,0,0,31,180,2,5,1,1,1,0,0,1,0,0,10,540129,-727,-55,-2,2,5,-1,0,-149,-3,0
KR_7755981137,2551,2615,1,4,0,0,0,0,0,0,0,0,0,0,2,2,0,0,0,0,0,0,0,0,0,0,3,101654,-64,-3,0,0,0,0,0,0,0,0
KR_7755991585,13853,16812,229,260,4,10,10,4,6,16,0,0,0,0,16,16,3,6,0,1,0,1,0,0,0,0,10,540211,-2959,-31,-6,6,-10,0,0,0,-3,-1
KR_7756008517,15475,15440,233,239,6,7,7,6,6,11,0,0,0,0,19,31,1,3,0,0,0,1,0,0,0,0,10,540231,35,-6,-1,1,-5,0,0,-12,-2,0
KR_7756012771,2531,2552,0,1,0,0,0,0,0,0,0,0,0,0,1,1,0,0,0,0,0,0,0,0,0,0,3,102762,-21,-1,0,0,0,0,0,0,0,0
KR_7756019766,12701,16416,238,280,1,7,7,1,0,10,0,0,0,0,187,18,3,6,0,1,1,0,0,0,0,0,10,540086,-3715,-42,-6,6,-10,0,0,169,-3,-1
KR_7756030055,16170,16086,224,257,10,8,8,10,8,5,0,0,0,0,17,15,0,4,0,1,0,1,0,0,0,0,10,540234,84,-33,2,-2,3,0,0,2,-4,-1
KR_7756032191,16419,15634,196,201,13,9,9,13,18,12,1,0,0,0,21,19,3,4,0,1,1,0,1,0,0,0,10,540237,785,-5,4,-4,6,1,0,2,-1,-1
KR_7756039486,16091,13340,276,269,7,1,1,7,7,0,0,1,0,0,18,22,4,5,2,1,1,0,0,1,0,0,10,540251,2751,7,6,-6,7,-1,0,-4,-1,1
KR_7756040155,16374,15797,251,256,8,6,6,8,9,7,0,0,0,0,41,14,5,4,1,2,1,0,0,0,0,0,10,540228,577,-5,2,-2,2,0,0,27,1,-1
KR_7756040768,14877,14391,267,285,5,3,3,5,5,3,0,1,0,0,16,15,4,6,0,0,0,1,0,1,0,0,10,540198,486,-18,2,-2,2,-1,0,1,-2,0
KR_7756056859,16025,14957,269,272,6,5,5,6,13,3,1,0,0,0,13,29,7,4,0,0,0,1,1,0,0,0,10,540231,1068,-3,1,-1,10,1,0,-16,3,0
KR_7756065177,17171,16859,256,253,10,10,10,10,11,11,0,0,0,0,18,33,4,4,0,1,0,1,0,0,0,0,10,540235,312,3,0,0,0,0,0,-15,0,-1
KR_7756070719,17082,20495,218,260,11,17,17,11,14,25,0,1,0,0,16,26,0,6,0,0,0,1,0,1,0,0,10,540252,-3413,-42,-6,6,-11,-1,0,-10,-6,0
KR_7756075441,15621,14943,264,265,6,6,6,6,8,7,1,0,0,0,15,18,3,4,0,0,1,0,1,0,0,0,10,540251,678,-1,0,0,1,1,0,-3,-1,0
KR_7756083115,12862,17122,243,278,1,9,9,1,1,9,0,1,0,0,18,20,1,4,0,3,0,1,0,1,0,0,10,540207,-4260,-35,-8,8,-8,-1,0,-2,-3,-3
KR_7756086105,13811,15136,237,276,3,4,4,3,4,4,0,0,0,0,19,14,2,4,0,2,0,1,0,0,0,0,10,540116,-1325,-39,-1,1,0,0,0,5,-2,-2
KR_7756088997,14202,17380,261,266,3,12,12,3,3,16,0,0,0,0,15,20,3,4,0,0,1,0,0,0,0,0,10,540175,-3178,-5,-9,9,-13,0,0,-5,-1,0
KR_7756106511,16509,15786,256,246,8,7,7,8,14,6,1,0,0,0,19,20,4,3,0,0,0,1,1,0,0,0,10,540258,723,10,1,-1,8,1,0,-1,1,0
KR_7756112693,16107,15200,276,248,7,7,7,7,7,7,1,0,0,0,26,36,4,1,0,0,0,1,1,0,0,0,10,540205,907,28,0,0,0,1,0,-10,3,0
KR_7756125486,15626,14795,258,294,5,3,3,5,8,5,0,0,0,0,19,43,5,8,1,0,0,1,0,0,0,0,10,540280,831,-36,2,-2,3,0,0,-24,-3,1
KR_7756130584,15132,15997,258,273,6,7,7,6,6,8,0,0,0,0,18,17,6,5,0,0,1,0,0,0,0,0,10,540209,-865,-15,-1,1,-2,0,0,1,1,0
KR_7756134941,16552,19045,209,259,10,13,13,10,12,14,0,0,0,0,104,28,4,2,0,1,0,1,0,0,0,0,10,540197,-2493,-50,-3,3,-2,0,0,76,2,-1
KR_7756138321,13899,16343,246,256,3,8,8,3,2,11,0,1,0,0,34,21,6,5,0,1,1,0,0,1,0,0,10,540224,-2444,-10,-5,5,-9,-1,0,13,1,-1
KR_7756150489,17423,13463,256,222,11,4,4,11,14,1,0,0,0,0,18,13,2,4,0,0,1,0,0,0,0,0,10,540241,3960,34,7,-7,13,0,0,5,-2,0
KR_7756153335,15258,15574,274,255,6,7,7,6,3,5,0,0,0,0,17,21,3,1,0,0,0,1,0,0,0,0,10,540259,-316,19,-1,1,-2,0,0,-4,2,0
KR_7756164993,12293,15791,231,244,1,8,8,1,0,7,0,0,0,0,25,18,3,1,0,0,0,1,0,0,0,0,10,540276,-3498,-13,-7,7,-7,0,0,7,2,0
KR_7756171135,12913,15380,262,254,0,8,8,0,0,6,0,0,0,0,35,16,2,4,0,0,0,1,0,0,0,0,10,540208,-2467,8,-8,8,-6,0,0,19,-2,0
KR_7756174836,14953,16578,278,270,5,8,8,5,4,10,0,0,0,0,16,11,2,5,1,0,1,0,0,0,0,0,10,540289,-1625,8,-3,3,-6,0,0,5,-3,1
KR_7756182463,16127,14134,263,258,7,4,4,7,9,2,0,0,0,0,16,35,3,3,0,0,0,1,0,0,0,0,10,540223,1993,5,3,-3,7,0,0,-19,0,0
KR_7756191285,14554,15728,260,241,3,9,9,3,4,7,0,0,0,0,28,19,3,2,0,0,0,1,0,0,0,0,10,540211,-1174,19,-6,6,-3,0,0,9,1,0
KR_7756212772,15874,14267,285,240,7,3,3,7,2,5,0,0,0,0,38,16,4,3,1,1,1,0,0,0,0,0,10,540201,1607,45,4,-4,-3,0,0,22,1,0
KR_7756215324,13382,15516,255,270,1,6,6,1,1,6,0,0,0,0,32,18,4,1,1,1,0,1,0,0,0,0,10,540242,-2134,-15,-5,5,-5,0,0,14,3,0
KR_7756222364,17604,14327,286,267,8,4,4,8,13,3,0,1,0,0,35,24,7,4,2,0,1,0,0,1,0,0,10,540176,3277,19,4,-4,10,-1,0,11,3,2
KR_7756230661,15374,15116,255,212,6,8,8,6,5,7,0,0,0,0,14,16,2,2,1,0,1,0,0,0,0,0,10,540232,258,43,-2,2,-2,0,0,-2,0,1
KR_7756237726,13326,16306,248,252,2,9,9,2,2,8,0,1,0,0,102,108,4,4,0,0,0,1,0,1,0,0,10,540209,-2980,-4,-7,7,-6,-1,0,-6,0,0
KR_7756245793,14882,14125,301,282,3,1,1,3,3,2,0,1,0,0,16,45,7,4,2,0,1,0,0,1,0,0,10,540273,757,19,2,-2,1,-1,0,-29,3,2
KR_7756259883,16609,15165,268,288,9,4,4,9,8,0,0,0,0,0,19,37,2,6,1,2,1,0,0,0,0,0,10,540212,1444,-20,5,-5,8,0,0,-18,-4,-1
KR_7756264844,16897,15379,257,277,10,5,5,10,16,3,0,0,0,0,10,16,3,4,0,0,0,1,0,0,0,0,10,540200,1518,-20,5,-5,13,0,0,-6,-1,0
KR_7756285422,13590,18078,251,297,3,12,12,3,1,12,0,0,0,0,23,14,5,2,0,1,0,1,0,0,0,0,10,540265,-4488,-46,-9,9,-11,0,0,9,3,-1
KR_7756286540,13901,13594,284,278,1,1,1,1,2,1,0,0,0,0,17,16,5,3,0,0,1,0,0,0,0,0,10,540236,307,6,0,0,1,0,0,1,2,0
KR_7756291590,16643,14788,258,271,9,3,3,9,8,1,0,0,0,0,22,15,4,3,1,1,1,0,0,0,0,0,10,540307,1855,-13,6,-6,7,0,0,7,1,0
KR_7756302451,15466,15270,237,234,8,7,7,8,7,9,0,0,0,0,12,13,3,4,0,0,1,0,0,0,0,0,10,540220,196,3,1,-1,-2,0,0,-1,-1,0
KR_7756327396,16854,14545,262,235,8,6,6,8,9,4,0,1,0,0,88,11,3,3,1,0,1,0,0,1,0,0,10,540246,2309,27,2,-2,5,-1,0,77,0,1
KR_7756330173,14905,15700,290,270,4,6,6,4,2,10,0,0,0,0,138,17,3,2,0,0,1,0,0,0,0,0,10,540244,-795,20,-2,2,-8,0,0,121,1,0
KR_7756346160,15916,16948,259,246,7,12,12,7,6,9,0,1,0,0,12,16,0,1,1,0,0,1,0,1,0,0,10,540216,-1032,13,-5,5,-3,-1,0,-4,-1,1
KR_7756355702,13730,14616,222,256,4,3,3,4,3,2,0,0,0,0,17,19,2,1,0,0,1,0,0,0,0,0,10,540205,-886,-34,1,-1,1,0,0,-2,1,0
KR_7756355890,15358,16614,257,241,6,10,10,6,5,11,0,1,0,0,9,19,6,2,0,1,0,1,0,1,0,0,10,540295,-1256,16,-4,4,-6,-1,0,-10,4,-1
KR_7756365857,14115,15833,307,300,1,5,5,1,1,7,0,0,0,0,12,19,6,1,0,0,1,0,0,0,0,0,10,540242,-1718,7,-4,4,-6,0,0,-7,5,0
KR_7756374592,16290,15987,226,240,10,6,6,10,20,10,0,1,0,0,13,25,3,2,1,1,1,0,0,1,0,0,10,540183,303,-14,4,-4,10,-1,0,-12,1,0
KR_7756377766,17655,15233,228,261,12,4,4,12,16,4,0,0,0,0,15,15,3,6,2,1,1,0,0,0,0,0,10,540223,2422,-33,8,-8,12,0,0,0,-3,1
KR_7756382231,13633,15455,258,264,2,6,6,2,3,7,0,0,0,0,13,14,4,3,2,0,0,1,0,0,0,0,10,540276,-1822,-6,-4,4,-4,0,0,-1,1,2
KR_7756404512,15344,15362,236,270,6,5,5,6,7,7,0,0,0,0,21,17,2,2,1,0,1,0,0,0,0,0,10,540233,-18,-34,1,-1,0,0,0,4,0,1
KR_7756414512,13888,18068,236,276,3,11,11,3,3,14,0,0,0,0,13,21,1,1,0,1,1,0,0,0,0,0,10,540206,-4180,-40,-8,8,-11,0,0,-8,0,-1
KR_7756424751,14781,16286,272,263,5,9,9,5,7,14,1,0,0,0,39,13,1,7,0,0,0,1,1,0,0,0,10,540245,-1505,9,-4,4,-7,1,0,26,-6,0
KR_7756447069,3000,3012,13,14,0,0,0,0,0,0,0,0,0,0,5,2,0,0,0,0,0,0,0,0,0,0,4,123433,-12,-1,0,0,0,0,0,3,0,0
KR_7756451206,14919,14780,277,304,4,3,3,4,3,1,1,0,0,0,18,19,4,4,1,1,1,0,1,0,0,0,10,540280,139,-27,1,-1,2,1,0,-1,0,0
KR_7756460002,16537,15899,260,256,8,6,6,8,8,7,0,0,0,0,110,16,4,1,0,0,1,0,0,0,0,0,10,540247,638,4,2,-2,1,0,0,94,3,0
KR_7756475892,13720,13480,275,273,1,1,1,1,1,2,1,0,0,0,16,44,19,4,1,2,0,1,1,0,0,0,10,540262,240,2,0,0,-1,1,0,-28,15,-1
KR_7756477999,14211,18765,211,276,5,12,12,5,6,11,0,1,0,0,32,26,3,3,0,3,0,1,0,1,0,0,10,540244,-4554,-65,-7,7,-5,-1,0,6,0,-3
KR_7756478238,15441,15110,270,265,5,5,5,5,7,5,0,0,0,0,17,27,4,5,1,0,0,1,0,0,0,0,10,540220,331,5,0,0,2,0,0,-10,-1,1
KR_7756485019,16626,15255,250,239,10,8,8,10,24,9,0,0,0,0,26,13,2,5,0,0,0,1,0,0,0,0,10,540110,1371,11,2,-2,15,0,0,13,-3,0
KR_7756496349,15492,14741,247,216,7,6,7,7,7,6,0,0,0,0,18,15,2,2,1,1,1,0,0,0,0,0,10,540241,751,31,1,0,1,0,0,3,0,0
KR_7756513454,16255,16044,276,278,7,6,6,7,7,5,0,1,0,0,13,17,4,1,0,2,1,0,0,1,0,0,10,540257,211,-2,1,-1,2,-1,0,-4,3,-2
KR_7756517665,14472,14954,297,267,2,5,5,2,0,9,0,0,0,0,16,13,1,5,1,0,0,1,0,0,0,0,10,540180,-482,30,-3,3,-9,0,0,3,-4,1
KR_7756521762,14520,14912,247,258,4,4,4,4,6,5,0,1,0,0,33,16,2,2,0,2,0,1,0,1,0,0,10,540266,-392,-11,0,0,1,-1,0,17,0,-2
KR_7756550866,16884,16199,256,275,9,7,7,9,13,15,0,1,0,0,24,85,4,2,0,1,0,1,0,1,0,0,10,540196,685,-19,2,-2,-2,-1,0,-61,2,-1
KR_7756560159,14616,14867,271,257,3,4,4,3,3,10,1,0,0,0,14,18,7,1,1,2,1,0,1,0,0,0,10,540241,-251,14,-1,1,-7,1,0,-4,6,-1
KR_7756562594,15032,14511,261,267,5,3,3,5,7,4,1,0,0,0,13,37,3,3,0,0,0,1,1,0,0,0,10,540200,521,-6,2,-2,3,1,0,-24,0,0
KR_7756563400,17099,14016,295,286,7,2,2,7,9,2,0,0,0,0,14,16,5,2,0,0,1,0,0,0,0,0,10,540200,3083,9,5,-5,7,0,0,-2,3,0
KR_7756583049,17911,15516,271,247,9,6,6,9,13,14,0,1,0,0,18,18,2,4,0,0,0,1,0,1,0,0,10,540158,2395,24,3,-3,-1,-1,0,0,-2,0
KR_7756588783,16655,14618,267,273,9,4,4,9,9,3,0,1,0,0,15,11,2,2,1,0,1,0,0,1,0,0,10,540202,2037,-6,5,-5,6,-1,0,4,0,1
KR_7756604602,2699,2709,6,6,0,0,0,0,0,0,0,0,0,0,1,2,0,0,0,0,0,0,0,0,0,0,3,107658,-10,0,0,0,0,0,0,-1,0,0
KR_7756605085,15403,13925,291,260,5,3,3,5,2,3,0,1,0,0,15,13,5,3,1,1,1,0,0,1,0,0,10,540122,1478,31,2,-2,-1,-1,0,2,2,0
KR_7756617462,16465,15351,245,247,9,5,5,9,10,6,0,0,0,0,11,209,2,2,1,0,1,0,0,0,0,0,10,540214,1114,-2,4,-4,4,0,0,-198,0,1
KR_7756625927,15685,13972,289,244,5,4,4,5,5,3,0,0,0,0,12,16,3,0,2,0,0,1,0,0,0,0,10,540209,1713,45,1,-1,2,0,0,-4,3,2
KR_7756627170,15253,14891,254,227,5,7,7,5,5,9,0,0,0,0,15,18,5,2,1,0,0,1,0,0,0,0,10,540180,362,27,-2,2,-4,0,0,-3,3,1
KR_7756628298,14921,14174,266,241,5,4,4,5,4,5,0,0,0,0,13,19,3,3,1,0,1,0,0,0,0,0,10,540266,747,25,1,-1,-1,0,0,-6,0,1
KR_7756638076,15393,14213,281,258,5,3,3,5,4,3,0,0,0,0,19,32,6,3,2,1,1,0,0,0,0,0,10,540186,1180,23,2,-2,1,0,0,-13,3,1
KR_7756644920,14368,15194,286,290,3,5,5,3,2,6,0,1,0,0,11,16,3,4,0,0,0,1,0,1,0,0,10,540261,-826,-4,-2,2,-4,-1,0,-5,-1,0
KR_7756650272,14608,14001,284,296,3,1,1,3,3,0,0,0,0,0,17,16,6,3,0,0,1,0,0,0,0,0,10,540252,607,-12,2,-2,3,0,0,1,3,0
KR_7756655536,14589,14998,241,260,4,5,5,4,7,8,0,0,0,0,11,32,3,1,0,0,0,1,0,0,0,0,10,540183,-409,-19,-1,1,-1,0,0,-21,2,0
KR_7756662526,14439,14881,267,287,3,3,3,4,4,1,1,0,0,0,20,19,7,3,1,0,1,0,1,0,0,0,10,540208,-442,-20,0,-1,3,1,0,1,4,1
KR_7756671932,15027,17466,230,246,6,13,13,6,5,16,0,1,0,0,33,104,1,3,1,0,0,1,0,1,0,0,10,540239,-2439,-16,-7,7,-11,-1,0,-71,-2,1
KR_7756684264,13248,16704,276,257,1,9,9,1,0,16,1,0,0,0,12,16,2,2,1,0,0,1,1,0,0,0,10,540232,-3456,19,-8,8,-16,1,0,-4,0,1
KR_7756687729,15639,18030,240,231,6,11,11,6,7,17,0,0,0,0,21,16,1,0,0,2,0,1,0,0,0,0,10,540233,-2391,9,-5,5,-10,0,0,5,1,-2
KR_7756701083,15466,16391,293,269,5,9,9,5,5,6,0,0,0,0,12,33,3,0,0,0,1,0,0,0,0,0,10,540222,-925,24,-4,4,-1,0,0,-21,3,0
KR_7756705568,15999,14009,289,247,5,3,3,5,6,3,0,0,0,0,20,11,1,3,1,0,1,0,0,0,0,0,10,540162,1990,42,2,-2,3,0,0,9,-2,1
KR_7756709707,15089,15071,217,247,7,6,6,7,9,4,0,0,0,0,13,14,1,0,2,1,0,1,0,0,0,0,10,540186,18,-30,1,-1,5,0,0,-1,1,1
KR_7756713631,15482,17912,252,269,6,11,11,6,6,14,0,0,0,0,37,19,2,3,0,0,0,1,0,0,0,0,10,540118,-2430,-17,-5,5,-8,0,0,18,-1,0
KR_7756719695,15174,17355,235,288,6,8,9,6,8,9,0,0,0,0,116,16,3,1,0,2,0,1,0,0,0,0,10,540244,-2181,-53,-2,3,-1,0,0,100,2,-2
KR_7756730524,15391,13165,265,230,5,3,3,5,6,0,0,1,0,0,28,34,2,2,1,1,0,1,0,1,0,0,10,540290,2226,35,2,-2,6,-1,0,-6,0,0
KR_7756734630,13319,15987,260,264,1,6,6,1,2,10,0,0,0,0,12,22,4,1,0,3,0,1,0,0,0,0,10,540151,-2668,-4,-5,5,-8,0,0,-10,3,-3
KR_7756753264,16732,13678,282,244,7,2,2,7,8,2,0,0,0,0,16,35,4,2,0,0,1,0,0,0,0,0,10,540225,3054,38,5,-5,6,0,0,-19,2,0
KR_7756758656,16412,13628,231,242,9,3,3,9,13,2,0,0,0,0,38,17,3,5,1,0,1,0,0,0,0,0,10,540252,2784,-11,6,-6,11,0,0,21,-2,1
KR_7756770002,16182,15132,257,234,8,7,7,8,7,5,0,1,0,0,13,23,3,2,0,0,1,0,0,1,0,0,10,540195,1050,23,1,-1,2,-1,0,-10,1,0
KR_7756772625,15586,14176,267,309,6,1,1,6,7,2,0,0,0,0,20,13,3,6,0,1,1,0,0,0,0,0,10,540223,1410,-42,5,-5,5,0,0,7,-3,-1
KR_7756772721,15274,13694,262,284,5,2,2,5,9,0,0,1,0,0,38,13,3,14,0,0,0,1,0,1,0,0,10,540243,1580,-22,3,-3,9,-1,0,25,-11,0
KR_7756782800,14876,15720,261,273,6,5,5,6,3,6,0,1,0,0,17,16,0,3,0,0,1,0,0,1,0,0,10,540203,-844,-12,1,-1,-3,-1,0,1,-3,0
KR_7756791584,13150,17160,189,256,4,12,12,4,8,15,0,0,0,0,19,11,1,2,0,4,1,0,0,0,0,0,10,540155,-4010,-67,-8,8,-7,0,0,8,-1,-4
KR_7756798121,13689,16100,230,280,3,7,8,3,3,6,0,0,0,0,29,14,3,1,2,1,0,1,0,0,0,0,10,540246,-2411,-50,-4,5,-3,0,0,15,2,1
KR_7756798622,17326,14020,269,273,11,2,2,11,10,2,1,0,0,0,14,11,1,0,0,0,1,0,1,0,0,0,10,540223,3306,-4,9,-9,8,1,0,3,1,0
KR_7756799390,15978,14459,266,258,8,4,4,8,9,2,0,0,0,0,18,15,0,3,1,0,1,0,0,0,0,0,10,540287,1519,8,4,-4,7,0,0,3,-3,1
KR_7756802112,15129,15451,246,286,5,5,5,5,8,4,1,0,0,0,40,15,1,4,0,3,1,0,1,0,0,0,10,540212,-322,-40,0,0,4,1,0,25,-3,-3
KR_7756818491,12752,14089,253,282,0,2,2,0,0,2,0,0,0,0,34,20,4,2,0,1,0,1,0,0,0,0,10,540227,-1337,-29,-2,2,-2,0,0,14,2,-1
KR_7756823705,14334,16286,296,289,3,6,6,3,3,9,1,0,0,0,17,17,2,5,0,0,0,1,1,0,0,0,10,540217,-1952,7,-3,3,-6,1,0,0,-3,0
KR_7756833325,15462,15954,232,271,6,7,7,6,9,6,0,0,0,0,38,24,2,5,0,1,0,1,0,0,0,0,10,540236,-492,-39,-1,1,3,0,0,14,-3,-1
KR_7756834879,14548,17248,215,277,6,8,8,6,6,8,0,1,0,0,20,15,2,6,0,4,1,0,0,1,0,0,10,540198,-2700,-62,-2,2,-2,-1,0,5,-4,-4
KR_7756836947,14710,15131,248,249,4,7,7,4,7,8,0,1,0,0,29,93,6,2,0,0,0,1,0,1,0,0,10,540256,-421,-1,-3,3,-1,-1,0,-64,4,0
KR_7756841286,13379,13986,252,252,1,4,4,1,1,6,0,1,0,0,108,17,3,2,0,0,0,1,0,1,0,0,10,540227,-607,0,-3,3,-5,-1,0,91,1,0
KR_7756846086,14865,15304,231,245,6,5,5,7,3,9,0,0,0,0,10,10,2,1,2,0,1,0,0,0,0,0,10,540245,-439,-14,1,-2,-6,0,0,0,1,2
KR_7756849992,15670,15285,290,290,5,6,6,5,4,0,0,0,0,0,23,102,7,6,0,0,1,0,0,0,0,0,10,540163,385,0,-1,1,4,0,0,-79,1,0
KR_7756857697,14703,15374,286,286,2,4,4,2,3,7,0,1,0,0,17,15,4,6,0,2,0,1,0,1,0,0,10,540090,-671,0,-2,2,-4,-1,0,2,-2,-2
KR_7756869721,15001,15629,259,254,5,7,7,5,6,7,0,0,0,0,15,14,3,2,0,0,0,1,0,0,0,0,10,540255,-628,5,-2,2,-1,0,0,1,1,0
KR_7756870777,14829,14119,269,278,4,2,2,4,2,4,0,1,0,0,15,47,1,5,2,0,0,1,0,1,0,0,10,540261,710,-9,2,-2,-2,-1,0,-32,-4,2
KR_7756875884,16359,13443,273,279,7,1,1,7,8,0,0,0,0,0,16,16,3,4,0,1,1,0,0,0,0,0,10,540273,2916,-6,6,-6,8,0,0,0,-1,-1
KR_7756877842,14614,14199,292,324,2,1,1,2,3,0,0,1,0,0,104,36,6,4,2,0,0,1,0,1,0,0,10,540253,415,-32,1,-1,3,-1,0,68,2,2
KR_7756882929,15600,13882,272,267,6,3,3,6,7,5,0,0,0,0,32,15,1,4,2,0,0,1,0,0,0,0,10,540219,1718,5,3,-3,2,0,0,17,-3,2
KR_7756885784,16326,15088,268,249,8,6,6,8,4,7,0,0,0,0,20,16,3,6,1,0,0,1,0,0,0,0,10,540177,1238,19,2,-2,-3,0,0,4,-3,1
KR_7756886995,16724,12892,278,248,8,1,1,8,7,2,0,0,0,0,18,34,7,4,0,0,1,0,0,0,0,0,10,540250,3832,30,7,-7,5,0,0,-16,3,0
KR_7756892274,13329,13293,296,247,0,2,2,0,0,3,0,1,0,0,14,14,5,1,1,0,0,1,0,1,0,0,10,540225,36,49,-2,2,-3,-1,0,0,4,1
KR_7756894660,15419,14831,257,246,5,7,7,5,4,3,1,0,0,0,17,13,3,4,2,1,0,1,1,0,0,0,10,540240,588,11,-2,2,1,1,0,4,-1,1
KR_7756894823,17989,16081,273,269,11,7,7,11,17,9,0,0,0,0,13,15,5,6,1,1,0,1,0,0,0,0,10,540270,1908,4,4,-4,8,0,0,-2,-1,0
KR_7756896977,15049,13913,280,250,5,2,2,5,4,4,1,0,0,0,16,35,5,3,0,0,1,0,1,0,0,0,10,540210,1136,30,3,-3,0,1,0,-19,2,0
KR_7756898379,15364,14924,261,245,6,5,5,6,4,6,0,0,0,0,33,173,0,3,0,0,0,1,0,0,0,0,10,540226,440,16,1,-1,-2,0,0,-140,-3,0
KR_7756905702,16356,14819,292,259,7,5,5,7,6,5,0,1,0,0,16,20,6,3,2,1,1,0,0,1,0,0,10,540250,1537,33,2,-2,1,-1,0,-4,3,1
KR_7756910300,17072,16371,264,254,9,8,8,9,8,11,0,0,0,0,15,38,6,2,1,0,0,1,0,0,0,0,10,540217,701,10,1,-1,-3,0,0,-23,4,1
KR_7756910770,14573,15558,265,284,4,5,5,4,4,5,1,0,0,0,20,22,3,2,0,0,0,1,1,0,0,0,10,540229,-985,-19,-1,1,-1,1,0,-2,1,0
KR_7756914144,15078,15666,268,264,5,6,6,5,4,6,1,0,0,0,15,102,2,1,0,0,0,1,1,0,0,0,10,540224,-588,4,-1,1,-2,1,0,-87,1,0
KR_7756916737,16342,16051,249,254,9,6,6,9,9,8,0,0,0,0,21,37,5,3,3,1,1,0,0,0,0,0,10,540222,291,-5,3,-3,1,0,0,-16,2,2
KR_7756918989,6181,7891,88,128,0,2,2,0,0,1,0,0,0,0,2,5,1,0,0,0,0,1,0,0,0,0,6,280898,-1710,-40,-2,2,-1,0,0,-3,1,0
KR_7756920262,14439,16677,230,268,5,10,10,5,6,9,0,0,0,0,44,17,4,3,0,0,1,0,0,0,0,0,10,540274,-2238,-38,-5,5,-3,0,0,27,1,0
KR_7756920514,14859,13146,252,265,6,1,1,6,5,1,0,1,0,0,22,19,0,4,0,0,1,0,0,1,0,0,10,540219,1713,-13,5,-5,4,-1,0,3,-4,0
KR_7756927873,14552,14506,269,289,4,2,2,4,4,2,0,0,0,0,17,41,2,3,0,1,1,0,0,0,0,0,10,540229,46,-20,2,-2,2,0,0,-24,-1,-1
KR_7756928083,15270,15939,205,259,6,8,8,6,9,7,0,1,0,0,32,15,1,4,0,2,0,1,0,1,0,0,10,540183,-669,-54,-2,2,2,-1,0,17,-3,-2
KR_7756931864,14254,14410,236,226,5,6,6,5,4,5,1,0,0,0,10,24,1,4,0,0,1,0,1,0,0,0,10,540218,-156,10,-1,1,-1,1,0,-14,-3,0
KR_7756933807,17365,12652,251,208,10,2,2,10,11,2,0,1,0,0,12,17,5,0,3,0,1,0,0,1,0,0,10,540230,4713,43,8,-8,9,-1,0,-5,5,3
KR_7756937819,15409,14457,276,250,5,4,5,5,2,3,1,0,0,0,15,19,6,1,1,0,1,0,1,0,0,0,10,540197,952,26,1,0,-1,1,0,-4,5,1
KR_7756939891,15537,15536,252,269,7,6,6,7,7,5,0,1,0,0,94,15,1,4,0,0,0,1,0,1,0,0,10,540183,1,-17,1,-1,2,-1,0,79,-3,0
KR_7756940054,14756,14182,278,283,4,2,2,4,1,2,0,1,0,0,16,19,3,0,1,0,1,0,0,1,0,0,10,540202,574,-5,2,-2,-1,-1,0,-3,3,1
KR_7756941654,13698,16100,245,241,3,8,8,3,3,12,0,0,0,0,30,11,0,1,1,0,0,1,0,0,0,0,10,540221,-2402,4,-5,5,-9,0,0,19,-1,1
KR_7756950131,14598,13763,281,265,2,2,2,2,3,2,0,0,0,0,17,18,3,2,2,0,1,0,0,0,0,0,10,540197,835,16,0,0,1,0,0,-1,1,2
KR_7756953244,16637,13742,268,269,9,2,2,9,13,3,1,0,0,0,11,21,1,2,0,0,0,1,1,0,0,0,10,540213,2895,-1,7,-7,10,1,0,-10,-1,0
KR_7756956456,15270,13137,251,253,5,1,1,5,6,0,0,0,0,0,18,14,1,4,1,0,0,1,0,0,0,0,10,540236,2133,-2,4,-4,6,0,0,4,-3,1
KR_7756957239,14913,15457,265,275,5,4,4,6,5,4,0,0,0,0,17,13,2,3,0,0,0,1,0,0,0,0,10,540210,-544,-10,1,-2,1,0,0,4,-1,0
KR_7756962167,15111,14318,255,251,5,3,3,5,5,2,0,0,0,0,17,38,1,2,0,2,0,1,0,0,0,0,10,540192,793,4,2,-2,3,0,0,-21,-1,-2
KR_7756966525,16928,14091,235,214,10,6,6,10,16,3,1,0,0,0,10,12,1,2,2,0,1,0,1,0,0,0,10,540225,2837,21,4,-4,13,1,0,-2,-1,2
KR_7756969452,15939,17174,244,240,8,11,11,8,7,13,0,0,0,0,13,23,5,3,0,1,1,0,0,0,0,0,10,540260,-1235,4,-3,3,-6,0,0,-10,2,-1
KR_7756975040,15780,16415,236,233,8,9,9,8,5,13,0,1,0,0,16,19,3,6,0,0,0,1,0,1,0,0,10,540225,-635,3,-1,1,-8,-1,0,-3,-3,0
KR_7756975210,14170,14903,281,263,2,4,4,2,2,6,0,1,0,0,41,22,4,5,0,0,1,0,0,1,0,0,10,540229,-733,18,-2,2,-4,-1,0,19,-1,0
KR_7756979434,15159,13814,271,258,5,3,3,6,6,1,0,1,0,0,20,14,3,3,0,1,1,0,0,1,0,0,10,540231,1345,13,2,-3,5,-1,0,6,0,-1
KR_7756988941,16262,16631,278,262,7,9,9,7,9,7,0,1,0,0,17,19,6,4,0,1,1,0,0,1,0,0,10,540244,-369,16,-2,2,2,-1,0,-2,2,-1
KR_7756989225,14521,14723,255,272,3,4,4,3,4,7,0,0,0,0,19,18,2,2,3,0,0,1,0,0,0,0,10,540223,-202,-17,-1,1,-3,0,0,1,0,3
KR_7756989891,15473,14391,246,262,6,5,5,6,8,2,0,0,0,0,15,14,3,4,0,0,1,0,0,0,0,0,10,540235,1082,-16,1,-1,6,0,0,1,-1,0
KR_7756993433,17457,16875,250,261,11,8,9,11,10,7,0,1,0,0,15,14,2,2,0,2,0,1,0,1,0,0,10,540273,582,-11,3,-2,3,-1,0,1,0,-2
KR_7757001272,18553,15025,244,189,17,7,7,17,14,9,0,0,0,0,28,24,1,1,4,0,1,0,0,0,0,0,10,540256,3528,55,10,-10,5,0,0,4,0,4
KR_7757001435,16724,16087,247,271,9,6,6,9,9,5,0,1,0,0,32,9,2,3,0,1,0,1,0,1,0,0,10,540233,637,-24,3,-3,4,-1,0,23,-1,-1
KR_7757001978,16264,16550,228,286,8,8,8,8,7,7,0,0,0,0,15,17,2,2,0,0,1,0,0,0,0,0,10,540293,-286,-58,0,0,0,0,0,-2,0,0
KR_7757008920,17447,16844,259,262,11,9,9,11,8,8,0,0,0,0,17,20,4,4,0,1,1,0,0,0,0,0,10,540247,603,-3,2,-2,0,0,0,-3,0,-1
KR_7757025327,15093,15042,252,226,4,6,7,4,5,10,0,0,0,0,77,19,3,1,1,0,0,1,0,0,0,0,10,540214,51,26,-2,3,-5,0,0,58,2,1
KR_7757050211,13592,16494,235,280,3,8,8,3,1,5,0,1,0,0,13,16,5,3,0,1,1,0,0,1,0,0,10,540250,-2902,-45,-5,5,-4,-1,0,-3,2,-1
KR_7757061599,15412,16485,228,270,8,7,7,8,13,6,1,0,0,0,107,11,2,7,0,1,1,0,1,0,0,0,10,540229,-1073,-42,1,-1,7,1,0,96,-5,-1
KR_7757066250,16845,13735,251,266,10,2,2,11,21,3,0,0,0,0,30,14,5,4,0,0,1,0,0,0,0,0,10,540268,3110,-15,8,-9,18,0,0,16,1,0
KR_7757072661,15075,16613,241,261,6,7,7,6,13,20,0,0,0,0,15,17,0,4,1,0,0,1,0,0,0,0,10,540206,-1538,-20,-1,1,-7,0,0,-2,-4,1
KR_7757080446,17567,15661,248,232,11,9,9,11,10,8,0,0,0,0,13,15,6,3,0,1,0,1,0,0,0,0,10,540215,1906,16,2,-2,2,0,0,-2,3,-1
KR_7757085558,15155,14643,253,249,5,4,4,5,6,5,0,0,0,0,17,55,5,1,0,1,0,1,0,0,0,0,10,540252,512,4,1,-1,1,0,0,-38,4,-1
KR_7757094002,16615,16427,272,272,8,7,7,8,6,6,0,0,0,0,17,14,5,4,0,3,1,0,0,0,0,0,10,540197,188,0,1,-1,0,0,0,3,1,-3
KR_7757096303,15773,16769,245,235,7,11,11,7,10,10,0,1,0,0,15,17,3,3,0,0,0,1,0,1,0,0,10,540217,-996,10,-4,4,0,-1,0,-2,0,0
KR_7757133667,15606,16238,208,262,9,7,7,9,9,9,0,0,0,0,15,16,2,3,0,0,1,0,0,0,0,0,10,540244,-632,-54,2,-2,0,0,0,-1,-1,0
KR_7757181862,15161,13891,259,273,6,2,2,6,8,2,0,1,0,0,47,14,1,5,0,1,1,0,0,1,0,0,10,540255,1270,-14,4,-4,6,-1,0,33,-4,-1
KR_7757196448,16767,14342,235,273,11,4,4,11,19,3,0,0,0,0,50,50,2,1,1,0,1,0,0,0,0,0,10,540099,2425,-38,7,-7,16,0,0,0,1,1
KR_7757224873,15440,14732,285,264,5,3,3,5,6,4,0,0,0,0,13,15,3,3,0,0,1,0,0,0,0,0,10,540243,708,21,2,-2,2,0,0,-2,0,0
KR_7757262289,16020,15518,244,253,9,7,7,9,9,5,0,1,0,0,18,17,2,4,1,1,0,1,0,1,0,0,10,540216,502,-9,2,-2,4,-1,0,1,-2,0
KR_7757277422,17659,14327,264,233,12,5,5,12,12,3,0,0,0,0,16,16,5,2,4,0,1,0,0,0,0,0,10,540122,3332,31,7,-7,9,0,0,0,3,4
KR_7757290418,18028,14513,268,253,12,3,3,12,21,2,0,0,0,0,12,37,6,5,2,0,1,0,0,0,0,0,10,540260,3515,15,9,-9,19,0,0,-25,1,2
KR_7757294295,16686,14581,291,244,8,3,3,8,6,3,0,0,0,0,13,22,2,2,1,0,1,0,0,0,0,0,10,540268,2105,47,5,-5,3,0,0,-9,0,1
KR_7757295988,14503,16074,260,304,4,6,6,4,3,4,0,1,0,0,20,17,1,4,0,0,0,1,0,1,0,0,10,540201,-1571,-44,-2,2,-1,-1,0,3,-3,0
KR_7757301703,15304,14319,254,256,6,2,2,6,7,2,0,0,0,0,15,42,2,3,1,2,1,0,0,0,0,0,10,540192,985,-2,4,-4,5,0,0,-27,-1,-1
KR_7757306435,16098,15405,228,235,9,6,6,9,11,8,0,0,0,0,17,15,2,2,1,1,0,1,0,0,0,0,10,540215,693,-7,3,-3,3,0,0,2,0,0
KR_7757307835,16772,14119,273,285,8,1,1,8,12,0,1,0,0,0,56,15,4,3,0,1,0,1,1,0,0,0,10,540248,2653,-12,7,-7,12,1,0,41,1,-1
KR_7757318818,15570,14795,247,239,8,5,5,8,9,3,0,0,0,0,41,15,2,3,1,1,1,0,0,0,0,0,10,540200,775,8,3,-3,6,0,0,26,-1,0
KR_7757319063,16881,15642,262,269,8,6,6,8,12,3,0,0,0,0,17,19,1,3,2,0,0,1,0,0,0,0,10,540208,1239,-7,2,-2,9,0,0,-2,-2,2
KR_7757322820,17128,16194,276,237,9,7,7,9,12,11,0,0,0,0,15,16,3,1,0,1,1,0,0,0,0,0,10,540217,934,39,2,-2,1,0,0,-1,2,-1
KR_7757325593,14869,16604,240,288,5,8,8,5,4,6,0,1,0,0,14,17,3,4,1,1,0,1,0,1,0,0,10,540230,-1735,-48,-3,3,-2,-1,0,-3,-1,0
KR_7757339184,14099,15556,267,306,2,5,5,2,2,4,0,1,0,0,118,28,1,1,0,1,0,1,0,1,0,0,10,540203,-1457,-39,-3,3,-2,-1,0,90,0,-1
KR_7757339819,16141,13891,281,254,6,4,4,6,8,1,0,0,0,0,21,14,0,2,1,0,0,1,0,0,0,0,10,540226,2250,27,2,-2,7,0,0,7,-2,1
KR_7757341495,15258,13850,260,226,5,4,4,5,4,4,1,0,0,0,13,14,2,3,3,0,1,0,1,0,0,0,10,540211,1408,34,1,-1,0,1,0,-1,-1,3
KR_7757352292,15525,14037,295,282,4,2,2,4,7,2,0,1,0,0,15,15,1,4,1,0,0,1,0,1,0,0,10,540218,1488,13,2,-2,5,-1,0,0,-3,1
KR_7757354838,14093,16408,259,247,3,9,9,3,1,7,0,1,0,0,11,16,4,1,0,2,0,1,0,1,0,0,10,540187,-2315,12,-6,6,-6,-1,0,-5,3,-2
KR_7757359454,13965,14799,244,275,3,5,5,3,5,2,0,0,0,0,17,19,2,2,0,0,0,1,0,0,0,0,10,540231,-834,-31,-2,2,3,0,0,-2,0,0
KR_7757360979,15841,13058,292,263,6,1,1,6,3,0,0,1,0,0,17,15,2,4,1,0,1,0,0,1,0,0,10,540251,2783,29,5,-5,3,-1,0,2,-2,1
KR_7757368738,15422,15350,242,251,7,6,6,7,4,7,0,0,0,0,30,16,0,3,1,0,0,1,0,0,0,0,10,540117,72,-9,1,-1,-3,0,0,14,-3,1
KR_7757369332,13585,16922,265,294,1,8,8,1,2,12,0,1,0,0,14,15,3,6,0,0,0,1,0,1,0,0,10,540252,-3337,-29,-7,7,-10,-1,0,-1,-3,0
KR_7757371978,13684,15015,266,277,1,4,4,2,2,5,0,1,0,0,34,20,4,1,1,1,0,1,0,1,0,0,10,540227,-1331,-11,-3,2,-3,-1,0,14,3,0
KR_7757384056,13552,15765,291,287,0,5,5,0,0,5,0,0,0,0,38,30,5,4,1,0,0,1,0,0,0,0,10,540154,-2213,4,-5,5,-5,0,0,8,1,1
KR_7757390823,15401,16455,254,245,5,9,9,5,3,11,1,0,0,0,13,35,3,4,2,0,0,1,1,0,0,0,10,540219,-1054,9,-4,4,-8,1,0,-22,-1,2
KR_7757391399,15756,13776,303,282,4,2,2,4,5,1,0,1,0,0,36,13,4,2,2,0,1,0,0,1,0,0,10,540239,1980,21,2,-2,4,-1,0,23,2,2
KR_7757396368,16261,14556,229,251,9,5,5,9,16,5,0,0,0,0,34,17,6,2,1,0,0,1,0,0,0,0,10,540272,1705,-22,4,-4,11,0,0,17,4,1
KR_7757397492,14990,14263,286,264,4,3,3,4,4,3,0,0,0,0,19,17,3,6,0,0,0,1,0,0,0,0,10,540212,727,22,1,-1,1,0,0,2,-3,0
KR_7757402534,17181,15279,262,249,11,7,7,11,7,5,0,1,0,0,17,14,3,3,4,1,1,0,0,1,0,0,10,540234,1902,13,4,-4,2,-1,0,3,0,3
KR_7757405146,14987,15376,291,288,4,3,3,4,6,5,1,0,0,0,115,33,4,4,0,3,1,0,1,0,0,0,10,540186,-389,3,1,-1,1,1,0,82,0,-3
KR_7757406902,15322,16766,233,278,5,8,8,5,5,7,0,1,0,0,26,55,2,6,1,3,0,1,0,1,0,0,10,540220,-1444,-45,-3,3,-2,-1,0,-29,-4,-2
KR_7757408028,15315,14137,279,261,5,3,3,5,4,4,0,1,0,0,16,21,1,2,1,0,1,0,0,1,0,0,10,540230,1178,18,2,-2,0,-1,0,-5,-1,1
KR_7757413566,14034,14253,252,269,3,3,3,3,4,6,0,0,0,0,26,19,5,2,0,0,0,1,0,0,0,0,10,540215,-219,-17,0,0,-2,0,0,7,3,0
KR_7757419938,14967,15989,285,263,4,6,6,4,4,7,0,0,0,0,16,39,6,4,0,1,0,1,0,0,0,0,10,540240,-1022,22,-2,2,-3,0,0,-23,2,-1
KR_7757436927,16906,14934,240,230,12,5,5,13,11,3,0,0,0,0,18,14,1,6,0,1,1,0,0,0,0,0,10,540220,1972,10,7,-8,8,0,0,4,-5,-1
KR_7757438219,17212,16565,270,236,9,9,9,9,9,9,0,0,0,0,20,16,1,7,3,0,1,0,0,0,0,0,10,540197,647,34,0,0,0,0,0,4,-6,3
KR_7757442497,15298,16635,248,264,6,9,9,6,6,4,0,0,0,0,29,37,4,3,0,3,0,1,0,0,0,0,10,540217,-1337,-16,-3,3,2,0,0,-8,1,-3
KR_7757443265,16181,15898,272,270,8,7,7,8,7,4,0,0,0,0,14,13,3,2,0,0,0,1,0,0,0,0,10,540232,283,2,1,-1,3,0,0,1,1,0
KR_7757445567,15577,16774,245,265,6,9,9,6,5,10,0,1,0,0,12,28,3,3,1,2,1,0,0,1,0,0,10,540109,-1197,-20,-3,3,-5,-1,0,-16,0,-1
KR_7757446744,16359,15020,257,240,8,5,5,8,7,4,0,0,0,0,18,18,4,3,0,0,1,0,0,0,0,0,10,540131,1339,17,3,-3,3,0,0,0,1,0
KR_7757448164,14922,15260,248,260,5,6,6,5,4,7,0,1,0,0,14,16,3,1,0,1,0,1,0,1,0,0,10,540299,-338,-12,-1,1,-3,-1,0,-2,2,-1
KR_7757448597,17427,13191,286,233,10,3,3,10,6,0,1,0,0,0,16,16,4,5,3,0,1,0,1,0,0,0,10,540247,4236,53,7,-7,6,1,0,0,-1,3
KR_7757453858,15186,18348,271,263,5,12,12,5,5,15,1,0,0,0,18,16,2,5,0,1,1,0,1,0,0,0,10,540172,-3162,8,-7,7,-10,1,0,2,-3,-1
KR_7757455346,16622,17222,239,252,8,10,10,8,17,21,0,1,0,0,16,11,1,3,0,0,0,1,0,1,0,0,10,540209,-600,-13,-2,2,-4,-1,0,5,-2,0
KR_7757465296,15032,15162,243,232,5,6,6,5,5,7,0,0,0,0,13,17,3,0,1,0,1,0,0,0,0,0,10,540243,-130,11,-1,1,-2,0,0,-4,3,1
KR_7757478185,17536,14760,282,255,10,4,4,10,12,6,0,0,0,0,45,111,3,3,1,0,1,0,0,0,0,0,10,540276,2776,27,6,-6,6,0,0,-66,0,1
KR_7757478228,15472,15158,243,260,7,5,5,7,12,4,0,0,0,0,19,17,4,2,1,0,1,0,0,0,0,0,10,540260,314,-17,2,-2,8,0,0,2,2,1
KR_7757483428,14819,15400,261,289,4,5,5,4,9,4,0,0,0,0,37,124,3,1,0,0,0,1,0,0,0,0,10,540254,-581,-28,-1,1,5,0,0,-87,2,0
KR_7757493175,2608,2531,4,0,0,0,0,0,0,0,0,0,0,0,1,0,0,0,0,0,0,0,0,0,0,0,3,102824,77,4,0,0,0,0,0,1,0,0
KR_7757493539,16342,17373,257,263,8,9,9,8,6,14,1,0,0,0,16,14,3,3,0,0,1,0,1,0,0,0,10,540176,-1031,-6,-1,1,-8,1,0,2,0,0
KR_7757494607,15901,14918,283,264,6,5,5,6,15,2,0,0,0,0,10,14,5,3,0,1,1,0,0,0,0,0,10,540198,983,19,1,-1,13,0,0,-4,2,-1
KR_7757497446,15767,15688,259,244,7,8,8,7,3,6,0,1,0,0,18,35,1,3,2,1,1,0,0,1,0,0,10,540218,79,15,-1,1,-3,-1,0,-17,-2,1
KR_7757503462,13336,14985,264,231,1,7,7,2,1,5,0,0,0,0,13,18,6,0,1,0,0,1,0,0,0,0,10,540222,-1649,33,-6,5,-4,0,0,-5,6,1
KR_7757504475,17388,14227,269,269,9,2,2,9,16,4,0,0,0,0,16,36,2,4,0,0,1,0,0,0,0,0,10,540278,3161,0,7,-7,12,0,0,-20,-2,0
KR_7757510986,16745,15378,259,245,10,6,6,10,5,7,0,0,0,0,14,14,6,0,2,1,1,0,0,0,0,0,10,540267,1367,14,4,-4,-2,0,0,0,6,1
KR_7757516317,15479,15780,241,276,6,7,7,6,5,11,0,1,0,0,17,18,4,4,0,1,0,1,0,1,0,0,10,540237,-301,-35,-1,1,-6,-1,0,-1,0,-1
KR_7757518128,16702,16555,242,251,11,10,10,11,15,7,1,0,0,0,16,11,3,2,0,0,0,1,1,0,0,0,10,540220,147,-9,1,-1,8,1,0,5,1,0
KR_7757521116,15660,15632,268,278,5,5,5,5,9,2,0,0,0,0,16,16,3,5,0,3,0,1,0,0,0,0,10,540228,28,-10,0,0,7,0,0,0,-2,-3
KR_7757526745,14278,15336,235,270,4,7,7,4,5,4,0,1,0,0,18,114,3,4,0,0,0,1,0,1,0,0,10,540225,-1058,-35,-3,3,1,-1,0,-96,-1,0
KR_7757539704,14853,15366,276,271,4,5,5,4,3,9,0,0,0,0,14,59,2,4,1,0,0,1,0,0,0,0,10,540250,-513,5,-1,1,-6,0,0,-45,-2,1
KR_7757540359,15804,16551,260,245,7,8,8,7,10,12,0,1,0,0,14,20,5,3,0,1,0,1,0,1,0,0,10,540174,-747,15,-1,1,-2,-1,0,-6,2,-1
KR_7757553148,15283,13047,263,250,7,2,2,7,6,0,0,1,0,0,10,31,0,6,1,0,1,0,0,1,0,0,10,540265,2236,13,5,-5,6,-1,0,-21,-6,1
KR_7757564241,16009,13704,276,270,7,2,2,7,6,2,0,1,0,0,18,17,0,7,0,0,0,1,0,1,0,0,10,540197,2305,6,5,-5,4,-1,0,1,-7,0
KR_7757567195,15033,16128,254,267,5,7,7,5,5,11,0,1,0,0,14,19,6,5,1,3,0,1,0,1,0,0,10,540111,-1095,-13,-2,2,-6,-1,0,-5,1,-2
KR_7757568426,15789,14137,320,245,5,5,5,5,5,5,0,0,0,0,15,13,1,3,0,0,0,1,0,0,0,0,10,540220,1652,75,0,0,0,0,0,2,-2,0
KR_7757569153,15460,15510,223,246,7,8,8,7,7,6,0,1,0,0,15,14,3,1,2,1,0,1,0,1,0,0,10,540258,-50,-23,-1,1,1,-1,0,1,2,1
KR_7757572554,15512,14519,252,303,6,2,3,6,6,0,0,0,0,0,28,15,0,1,0,0,0,1,0,0,0,0,10,540260,993,-51,4,-3,6,0,0,13,-1,0
KR_7757575459,15331,17810,249,240,6,11,11,6,9,17,0,0,0,0,15,18,3,1,0,2,0,1,0,0,0,0,10,540254,-2479,9,-5,5,-8,0,0,-3,2,-2
KR_7757581010,14141,14081,270,274,3,3,3,3,3,3,0,0,0,0,15,15,4,4,0,0,1,0,0,0,0,0,10,540242,60,-4,0,0,0,0,0,0,0,0
KR_7757581734,13802,16634,253,296,2,7,7,2,2,9,0,0,0,0,17,16,4,7,0,2,0,1,0,0,0,0,10,540276,-2832,-43,-5,5,-7,0,0,1,-3,-2
KR_7757584043,15862,15654,264,270,5,6,6,5,11,6,0,0,0,0,49,16,5,7,0,1,0,1,0,0,0,0,10,540199,208,-6,-1,1,5,0,0,33,-2,-1
KR_7757591360,14720,14513,277,282,3,3,3,3,5,2,0,0,0,0,26,13,2,4,1,1,0,1,0,0,0,0,10,540267,207,-5,0,0,3,0,0,13,-2,0
KR_7757600921,15878,15545,245,224,7,8,9,8,7,8,0,0,0,0,15,23,3,2,1,0,1,0,0,0,0,0,10,540232,333,21,-1,1,-1,0,0,-8,1,1
KR_7757602862,15198,16366,277,275,5,7,7,5,2,7,0,0,0,0,11,15,3,3,0,2,1,0,0,0,0,0,10,540108,-1168,2,-2,2,-5,0,0,-4,0,-2
KR_7757604193,14807,15940,228,273,7,5,5,7,5,8,0,0,0,0,16,14,4,3,1,1,1,0,0,0,0,0,10,540243,-1133,-45,2,-2,-3,0,0,2,1,0
KR_7757609738,14188,14111,243,285,4,3,3,4,3,2,0,1,0,0,19,36,1,1,0,0,0,1,0,1,0,0,10,540108,77,-42,1,-1,1,-1,0,-17,0,0
KR_7757613167,16258,13686,252,251,7,2,3,7,9,3,0,0,0,0,115,21,1,1,1,0,1,0,0,0,0,0,10,540209,2572,1,5,-4,6,0,0,94,0,1
KR_7757617091,15912,14750,272,230,9,6,6,9,6,5,0,0,0,0,15,28,6,2,0,0,0,1,0,0,0,0,10,540204,1162,42,3,-3,1,0,0,-13,4,0
KR_7757619044,13437,15854,271,289,2,6,6,2,0,3,1,0,0,0,33,14,1,2,0,0,0,1,1,0,0,0,10,540252,-2417,-18,-4,4,-3,1,0,19,-1,0
KR_7757620000,16931,14538,267,253,10,4,4,10,9,4,0,0,0,0,39,102,1,4,1,0,1,0,0,0,0,0,10,540250,2393,14,6,-6,5,0,0,-63,-3,1
KR_7757624592,14085,13663,280,260,2,2,2,2,1,1,0,0,0,0,16,16,2,4,0,0,1,0,0,0,0,0,10,540248,422,20,0,0,0,0,0,0,-2,0
KR_7757640068,17044,14763,271,217,10,7,7,10,11,8,0,0,0,0,17,33,2,1,1,0,0,1,0,0,0,0,10,540221,2281,54,3,-3,3,0,0,-16,1,1
KR_7757647292,14750,14849,260,264,4,4,4,4,4,7,0,1,0,0,15,18,3,3,2,1,1,0,0,1,0,0,10,540178,-99,-4,0,0,-3,-1,0,-3,0,1
KR_7757653120,14822,14561,291,285,3,3,3,3,1,3,0,1,0,0,141,16,4,3,0,0,0,1,0,1,0,0,10,540248,261,6,0,0,-2,-1,0,125,1,0
KR_7757655032,13998,16060,250,249,3,8,8,4,6,11,0,0,0,0,15,23,2,3,0,0,0,1,0,0,0,0,10,540229,-2062,1,-5,4,-5,0,0,-8,-1,0
KR_7757656348,15634,15070,276,229,6,7,7,6,4,8,0,1,0,0,112,15,0,5,2,0,0,1,0,1,0,0,10,540256,564,47,-1,1,-4,-1,0,97,-5,2
KR_7757658661,13887,15808,285,305,2,5,5,2,1,5,0,1,0,0,14,12,3,3,0,1,1,0,0,1,0,0,10,540224,-1921,-20,-3,3,-4,-1,0,2,0,-1
KR_7757666930,15486,15238,294,284,5,4,4,5,5,6,0,0,0,0,10,35,2,0,1,1,1,0,0,0,0,0,10,540238,248,10,1,-1,-1,0,0,-25,2,0
KR_7757680212,17762,14902,291,236,10,6,6,10,10,8,1,0,0,0,12,35,6,1,3,0,1,0,1,0,0,0,10,540100,2860,55,4,-4,2,1,0,-23,5,3
KR_7757681286,15180,15280,283,294,4,3,3,4,6,5,0,1,0,0,17,15,3,4,0,1,1,0,0,1,0,0,10,540253,-100,-11,1,-1,1,-1,0,2,-1,-1
KR_7757687453,15285,15307,233,272,6,5,5,6,10,5,0,0,0,0,14,36,3,1,0,1,1,0,0,0,0,0,10,540245,-22,-39,1,-1,5,0,0,-22,2,-1
KR_7757688285,16508,14128,267,270,8,3,3,9,10,1,0,0,0,0,15,17,4,4,0,0,1,0,0,0,0,0,10,540215,2380,-3,5,-6,9,0,0,-2,0,0
KR_7757691135,15651,14406,267,257,7,3,3,7,6,5,1,0,0,0,15,25,6,3,1,0,1,0,1,0,0,0,10,540234,1245,10,4,-4,1,1,0,-10,3,1
KR_7757691902,15675,13563,264,246,6,2,2,6,8,4,0,0,0,0,19,16,5,3,0,0,0,1,0,0,0,0,10,540205,2112,18,4,-4,4,0,0,3,2,0
KR_7757692444,16424,14832,313,306,5,3,3,5,6,6,0,1,0,0,17,17,3,5,1,0,0,1,0,1,0,0,10,540235,1592,7,2,-2,0,-1,0,0,-2,1
KR_7757694997,16526,14843,290,228,7,6,6,7,5,7,0,0,0,0,15,15,3,5,0,0,0,1,0,0,0,0,10,540240,1683,62,1,-1,-2,0,0,0,-2,0
KR_7757708719,16236,14835,250,276,9,4,4,9,7,2,1,0,0,0,11,15,2,4,0,0,0,1,1,0,0,0,10,540234,1401,-26,5,-5,5,1,0,-4,-2,0
KR_7757719983,16740,14394,279,278,9,3,3,9,6,4,1,0,0,0,15,12,2,1,3,0,1,0,1,0,0,0,10,540274,2346,1,6,-6,2,1,0,3,1,3
KR_7757722017,14943,15644,263,277,5,5,5,5,7,14,1,0,0,0,16,12,0,3,0,0,1,0,1,0,0,0,10,540211,-701,-14,0,0,-7,1,0,4,-3,0
KR_7757725586,14563,14622,295,292,2,3,3,2,3,4,0,1,0,0,110,18,3,1,0,0,0,1,0,1,0,0,10,540236,-59,3,-1,1,-1,-1,0,92,2,0
KR_7757731241,15331,14733,282,276,4,3,3,5,6,3,0,1,0,0,16,26,2,0,1,2,0,1,0,1,0,0,10,540229,598,6,1,-2,3,-1,0,-10,2,-1
KR_7757749244,17011,14132,265,223,10,5,5,10,10,2,0,0,0,0,29,36,3,3,1,0,1,0,0,0,0,0,10,540249,2879,42,5,-5,8,0,0,-7,0,1
KR_7757756647,14042,14640,275,281,2,4,4,2,4,5,0,1,0,0,17,17,2,4,0,0,0,1,0,1,0,0,10,540184,-598,-6,-2,2,-1,-1,0,0,-2,0
KR_7757764463,15156,17653,263,253,5,13,13,6,4,14,0,0,0,0,15,20,0,2,1,1,0,1,0,0,0,0,10,540257,-2497,10,-8,7,-10,0,0,-5,-2,0
KR_7757771452,14729,14974,259,261,4,5,5,4,4,9,0,1,0,0,14,18,4,1,0,1,0,1,0,1,0,0,10,540281,-245,-2,-1,1,-5,-1,0,-4,3,-1
KR_7757779232,14131,13837,244,250,5,3,3,5,1,3,0,0,0,0,16,18,2,3,0,0,1,0,0,0,0,0,10,540205,294,-6,2,-2,-2,0,0,-2,-1,0
KR_7757784809,15459,17440,268,243,6,12,12,6,4,20,0,0,0,0,14,24,1,3,1,1,0,1,0,0,0,0,10,540073,-1981,25,-6,6,-16,0,0,-10,-2,0
KR_7757787061,14336,15078,273,269,3,4,4,3,1,6,0,0,0,0,24,35,3,5,1,1,1,0,0,0,0,0,10,540253,-742,4,-1,1,-5,0,0,-11,-2,0
KR_7757795694,15673,15559,263,284,7,5,5,7,5,2,1,0,0,0,14,33,5,5,1,0,1,0,1,0,0,0,10,540277,114,-21,2,-2,3,1,0,-19,0,1
KR_7757822313,16993,15137,248,214,11,7,7,11,7,5,0,0,0,0,17,98,2,3,2,0,0,1,0,0,0,0,10,540271,1856,34,4,-4,2,0,0,-81,-1,2
KR_7757824840,15841,14153,260,259,6,4,4,6,9,2,0,1,0,0,13,19,3,3,0,1,0,1,0,1,0,0,10,540246,1688,1,2,-2,7,-1,0,-6,0,-1
KR_7757845632,16349,14425,316,242,6,4,4,7,7,7,0,0,0,0,36,13,1,4,0,0,1,0,0,0,0,0,10,540194,1924,74,2,-3,0,0,0,23,-3,0
KR_7757849288,15261,14864,261,267,5,5,5,5,8,2,0,1,0,0,15,29,2,3,0,0,1,0,0,1,0,0,10,540257,397,-6,0,0,6,-1,0,-14,-1,0
KR_7757852096,13728,17026,238,263,3,9,10,3,4,15,0,0,0,0,15,16,3,6,0,1,0,1,0,0,0,0,10,540249,-3298,-25,-6,7,-11,0,0,-1,-3,-1
KR_7757879321,13512,14636,287,308,1,2,2,1,1,0,0,1,0,0,15,18,4,3,0,0,1,0,0,1,0,0,10,540224,-1124,-21,-1,1,1,-1,0,-3,1,0
KR_7757887092,16822,14914,301,269,7,5,5,7,11,9,0,1,0,0,15,13,1,3,0,0,0,1,0,1,0,0,10,540247,1908,32,2,-2,2,-1,0,2,-2,0
KR_7757889304,16365,15606,295,269,6,6,6,6,5,3,0,1,0,0,16,21,6,2,1,1,1,0,0,1,0,0,10,540217,759,26,0,0,2,-1,0,-5,4,0
KR_7757902474,14093,17060,233,264,4,9,9,4,3,13,0,0,0,0,32,28,5,4,1,1,0,1,0,0,0,0,10,540195,-2967,-31,-5,5,-10,0,0,4,1,0
KR_7757904165,15210,16734,269,250,4,10,10,4,5,8,0,0,0,0,112,48,0,0,1,1,0,1,0,0,0,0,10,540258,-1524,19,-6,6,-3,0,0,64,0,0
KR_7757914432,16092,14371,279,252,7,5,5,7,8,3,0,1,0,0,19,18,3,6,1,0,1,0,0,1,0,0,10,540278,1721,27,2,-2,5,-1,0,1,-3,1
KR_7757916914,14374,14736,239,218,5,7,7,5,3,10,0,0,0,0,53,33,3,3,0,0,0,1,0,0,0,0,10,540221,-362,21,-2,2,-7,0,0,20,0,0
KR_7757938348,13349,15104,238,263,2,6,6,2,3,6,0,1,0,0,17,20,3,0,1,0,1,0,0,1,0,0,10,540239,-1755,-25,-4,4,-3,-1,0,-3,3,1
KR_7757941879,15330,15227,232,273,7,5,6,7,8,7,0,0,0,0,25,15,0,6,0,0,1,0,0,0,0,0,10,540205,103,-41,2,-1,1,0,0,10,-6,0
KR_7757943182,15876,15356,280,286,5,4,4,5,11,6,0,1,0,0,17,17,3,3,0,0,0,1,0,1,0,0,10,540274,520,-6,1,-1,5,-1,0,0,0,0
KR_7757950731,14673,16700,250,261,4,8,8,4,6,8,0,1,0,0,15,14,1,2,1,1,1,0,0,1,0,0,10,540248,-2027,-11,-4,4,-2,-1,0,1,-1,0
KR_7757964818,14699,14882,271,282,5,3,3,5,2,5,1,0,0,0,14,17,4,5,1,1,1,0,1,0,0,0,10,540211,-183,-11,2,-2,-3,1,0,-3,-1,0
KR_7757981764,2518,2545,0,2,0,0,0,0,0,0,0,0,0,0,2,10,0,0,0,0,0,0,0,0,0,0,3,101051,-27,-2,0,0,0,0,0,-8,0,0
KR_7757983131,16050,13905,244,243,8,3,3,8,12,3,0,0,0,0,34,125,5,2,1,0,1,0,0,0,0,0,10,540213,2145,1,5,-5,9,0,0,-91,3,1
KR_7757997085,15321,15743,266,279,6,6,6,6,7,6,0,1,0,0,19,19,5,5,0,1,0,1,0,1,0,0,10,540217,-422,-13,0,0,1,-1,0,0,0,-1
KR_7757999867,18219,13425,284,243,11,3,4,11,10,2,0,0,0,0,36,20,3,3,4,0,0,1,0,0,0,0,10,540165,4794,41,8,-7,8,0,0,16,0,4
KR_7758014312,15111,14834,294,280,3,3,3,3,2,3,0,1,0,0,237,40,3,1,1,1,0,1,0,1,0,0,10,540260,277,14,0,0,-1,-1,0,197,2,0
KR_7758024414,17072,14513,282,259,8,4,4,8,5,4,0,1,0,0,20,27,2,7,1,0,1,0,0,1,0,0,10,540233,2559,23,4,-4,1,-1,0,-7,-5,1
KR_7758032117,15527,15353,241,295,7,4,4,7,10,3,0,0,0,0,15,14,4,4,0,1,0,1,0,0,0,0,10,540225,174,-54,3,-3,7,0,0,1,0,-1
KR_7758045482,14749,15572,255,281,5,5,5,5,10,6,0,1,0,0,25,26,0,3,1,1,1,0,0,1,0,0,10,540245,-823,-26,0,0,4,-1,0,-1,-3,0
KR_7758048907,2540,2510,1,0,0,0,0,0,0,0,0,0,0,0,2,2,1,0,0,0,0,0,0,0,0,0,3,100934,30,1,0,0,0,0,0,0,1,0
KR_7758051877,15917,13944,226,253,11,2,2,11,14,3,0,0,0,0,15,59,5,1,1,1,1,0,0,0,0,0,10,540231,1973,-27,9,-9,11,0,0,-44,4,0
KR_7758054042,14207,15936,278,266,3,9,9,3,2,5,0,1,0,0,113,40,4,1,0,0,1,0,0,1,0,0,10,540170,-1729,12,-6,6,-3,-1,0,73,3,0
KR_7758057901,17183,15726,248,228,9,7,7,9,22,9,0,0,0,0,13,24,4,5,1,0,0,1,0,0,0,0,10,540260,1457,20,2,-2,13,0,0,-11,-1,1
KR_7758070261,17660,13667,264,250,9,1,3,9,14,1,0,0,0,0,18,15,1,3,4,1,1,0,0,0,0,0,10,540201,3993,14,8,-6,13,0,0,3,-2,3
KR_7758079157,16230,15610,285,295,6,5,5,6,7,6,0,0,0,0,17,17,3,3,0,0,0,1,0,0,0,0,10,540254,620,-10,1,-1,1,0,0,0,0,0
KR_7758080194,14603,14115,291,264,2,2,2,2,3,6,0,1,0,0,12,16,1,4,2,0,1,0,0,1,0,0,10,540202,488,27,0,0,-3,-1,0,-4,-3,2
KR_7758126751,18387,15039,249,192,14,7,7,14,18,8,0,0,0,0,22,14,5,2,0,0,1,0,0,0,0,0,10,540124,3348,57,7,-7,10,0,0,8,3,0
KR_7758130253,15703,14605,266,278,6,3,3,6,9,3,0,0,0,0,119,36,2,3,0,1,0,1,0,0,0,0,10,540255,1098,-12,3,-3,6,0,0,83,-1,-1
KR_7758130821,15253,15274,252,287,5,3,3,5,9,3,0,1,0,0,13,14,3,1,1,2,1,0,0,1,0,0,10,540238,-21,-35,2,-2,6,-1,0,-1,2,-1
KR_7758132945,14687,14251,281,241,3,5,5,3,3,3,1,0,0,0,12,18,4,3,1,0,0,1,1,0,0,0,10,540250,436,40,-2,2,0,1,0,-6,1,1
KR_7758138848,15512,15193,292,293,4,4,4,4,4,4,0,1,0,0,13,14,3,2,0,1,1,0,0,1,0,0,10,540224,319,-1,0,0,0,-1,0,-1,1,-1
KR_7758156486,15750,16739,236,258,7,8,8,7,7,12,0,1,0,0,20,16,3,3,1,3,0,1,0,1,0,0,10,540211,-989,-22,-1,1,-5,-1,0,4,0,-2
KR_7758175004,16835,15636,243,228,10,9,9,10,5,6,0,0,0,0,16,18,2,6,3,0,1,0,0,0,0,0,10,540259,1199,15,1,-1,-1,0,0,-2,-4,3
KR_7758176058,15865,15512,307,274,5,6,6,5,6,6,1,0,0,0,15,23,4,5,0,0,0,1,1,0,0,0,10,540120,353,33,-1,1,0,1,0,-8,-1,0
KR_7758186293,13722,15213,262,241,2,7,7,2,2,13,0,0,0,0,16,24,5,2,1,0,0,1,0,0,0,0,10,540195,-1491,21,-5,5,-11,0,0,-8,3,1
KR_7758193372,13795,14680,228,270,4,4,4,4,5,3,0,0,0,0,32,18,2,4,0,1,0,1,0,0,0,0,10,540216,-885,-42,0,0,2,0,0,14,-2,-1
KR_7758195128,14544,13597,274,280,3,1,1,3,4,1,0,1,0,0,19,16,3,5,0,0,1,0,0,1,0,0,10,540285,947,-6,2,-2,3,-1,0,3,-2,0
KR_7758197515,16448,15144,259,256,8,6,6,8,7,7,0,0,0,0,43,28,4,5,1,0,1,0,0,0,0,0,10,540230,1304,3,2,-2,0,0,0,15,-1,1
KR_7758201500,14612,18834,207,268,7,12,12,7,6,9,0,0,0,0,17,28,1,1,0,2,0,1,0,0,0,0,10,540171,-4222,-61,-5,5,-3,0,0,-11,0,-2
KR_7758220275,16737,15847,277,262,8,6,6,8,10,9,0,0,0,0,27,21,3,2,1,0,0,1,0,0,0,0,10,540219,890,15,2,-2,1,0,0,6,1,1
KR_7758229441,13489,15120,256,269,1,4,4,1,0,4,0,1,0,0,20,38,2,4,0,0,1,0,0,1,0,0,10,540056,-1631,-13,-3,3,-4,-1,0,-18,-2,0
KR_7758241125,17202,14452,273,226,9,5,5,9,7,6,0,1,0,0,15,15,3,1,2,0,1,0,0,1,0,0,10,540258,2750,47,4,-4,1,-1,0,0,2,2
KR_7758242944,15514,14826,274,296,6,2,2,6,7,2,1,0,0,0,16,16,4,4,1,1,1,0,1,0,0,0,10,540212,688,-22,4,-4,5,1,0,0,0,0
KR_7758263078,16305,15254,264,275,8,5,5,8,8,4,1,0,0,0,19,15,2,6,0,0,0,1,1,0,0,0,10,540102,1051,-11,3,-3,4,1,0,4,-4,0
KR_7758264476,15275,14191,270,263,5,3,3,5,4,3,0,0,0,0,48,15,2,3,2,1,0,1,0,0,0,0,10,540260,1084,7,2,-2,1,0,0,33,-1,1
KR_7758265983,14356,14504,288,280,2,3,3,2,0,3,0,1,0,0,18,100,2,1,1,0,1,0,0,1,0,0,10,540246,-148,8,-1,1,-3,-1,0,-82,1,1
KR_7758273113,15131,16586,269,256,6,9,9,6,5,8,1,0,0,0,21,13,3,4,1,3,0,1,1,0,0,0,10,540224,-1455,13,-3,3,-3,1,0,8,-1,-2
KR_7758274270,15057,14890,285,275,4,4,4,4,6,6,0,1,0,0,21,17,2,4,0,0,1,0,0,1,0,0,10,540181,167,10,0,0,0,-1,0,4,-2,0
KR_7758275797,17563,16142,262,242,11,7,7,11,10,11,0,0,0,0,34,20,2,1,0,1,1,0,0,0,0,0,10,540257,1421,20,4,-4,-1,0,0,14,1,-1
KR_7758276760,15381,14796,272,274,5,3,3,5,9,4,1,0,0,0,19,17,3,2,0,0,1,0,1,0,0,0,10,540271,585,-2,2,-2,5,1,0,2,1,0
KR_7758293979,14350,13803,246,219,5,5,5,5,3,7,0,0,0,0,13,10,0,0,1,1,0,1,0,0,0,0,10,540103,547,27,0,0,-4,0,0,3,0,0
KR_7758294672,17390,13993,243,264,11,2,2,11,19,3,1,0,0,0,17,14,2,3,0,0,1,0,1,0,0,0,10,540198,3397,-21,9,-9,16,1,0,3,-1,0
KR_7758312895,16306,17003,235,249,9,11,11,9,10,16,1,0,0,0,15,14,2,3,0,0,0,1,1,0,0,0,10,540236,-697,-14,-2,2,-6,1,0,1,-1,0
KR_7758327819,14300,17255,289,282,2,8,8,2,4,11,0,0,0,0,17,16,2,4,0,1,1,0,0,0,0,0,10,540225,-2955,7,-6,6,-7,0,0,1,-2,-1
KR_7758333047,15092,15430,229,268,5,6,6,5,6,7,0,0,0,0,24,32,3,8,2,0,0,1,0,0,0,0,10,540218,-338,-39,-1,1,-1,0,0,-8,-5,2
KR_7758336949,14573,14300,233,248,5,4,4,5,7,6,0,0,0,0,18,16,1,1,1,0,1,0,0,0,0,0,10,540249,273,-15,1,-1,1,0,0,2,0,1
KR_7758340951,15081,17056,281,266,3,9,9,3,7,13,0,0,0,0,16,16,6,3,0,0,0,1,0,0,0,0,10,540217,-1975,15,-6,6,-6,0,0,0,3,0
KR_7758342574,15638,14373,303,277,4,3,3,4,7,2,0,1,0,0,17,15,2,3,0,0,0,1,0,1,0,0,10,540254,1265,26,1,-1,5,-1,0,2,-1,0
KR_7758354141,17146,15129,268,272,8,5,5,8,13,2,0,0,0,0,14,35,4,4,1,2,0,1,0,0,0,0,10,540175,2017,-4,3,-3,11,0,0,-21,0,-1
KR_7758355660,14706,15439,282,289,3,5,5,3,2,4,0,0,0,0,14,20,7,1,1,1,0,1,0,0,0,0,10,540227,-733,-7,-2,2,-2,0,0,-6,6,0
KR_7758356040,15566,15085,264,258,6,6,6,6,6,3,0,1,0,0,121,17,1,1,1,1,0,1,0,1,0,0,10,540215,481,6,0,0,3,-1,0,104,0,0
KR_7758362442,11970,18437,183,308,1,13,13,1,1,6,0,0,0,0,22,223,3,0,0,3,0,1,0,0,0,0,10,540214,-6467,-125,-12,12,-5,0,0,-201,3,-3
KR_7758363347,15236,15456,250,260,6,5,5,6,9,13,1,0,0,0,18,16,0,4,1,0,1,0,1,0,0,0,10,540237,-220,-10,1,-1,-4,1,0,2,-4,1
KR_7758368394,14551,13017,250,219,4,2,2,4,6,2,0,0,0,0,16,25,5,1,2,1,1,0,0,0,0,0,10,540221,1534,31,2,-2,4,0,0,-9,4,1
KR_7758374172,15590,15439,274,231,5,8,8,5,8,13,0,1,0,0,16,19,2,1,1,0,0,1,0,1,0,0,10,540179,151,43,-3,3,-5,-1,0,-3,1,1
KR_7758383356,13756,16642,250,283,3,7,7,3,3,6,0,0,0,0,13,18,4,3,0,1,1,0,0,0,0,0,10,540097,-2886,-33,-4,4,-3,0,0,-5,1,-1
KR_7758394854,16423,15803,305,285,6,4,4,6,6,6,0,0,0,0,15,39,6,5,0,1,1,0,0,0,0,0,10,540278,620,20,2,-2,0,0,0,-24,1,-1
KR_7758398904,15361,15585,275,261,5,6,6,5,5,9,0,0,0,0,16,33,3,4,0,0,0,1,0,0,0,0,10,540243,-224,14,-1,1,-4,0,0,-17,-1,0
KR_7758400317,14849,16012,246,291,4,5,5,4,7,5,0,0,0,0,16,35,2,3,1,1,1,0,0,0,0,0,10,540204,-1163,-45,-1,1,2,0,0,-19,-1,0
KR_7758403584,16384,16245,257,274,8,7,7,8,11,8,0,0,0,0,28,16,2,2,0,0,0,1,0,0,0,0,10,540212,139,-17,1,-1,3,0,0,12,0,0
KR_7758404254,14554,14079,270,235,4,4,4,4,3,4,0,1,0,0,275,13,2,5,1,1,0,1,0,1,0,0,10,540253,475,35,0,0,-1,-1,0,262,-3,0
KR_7758407861,18381,13170,235,203,13,3,3,13,14,3,1,0,0,0,12,13,2,0,5,0,1,0,1,0,1,0,10,540210,5211,32,10,-10,11,1,0,-1,2,5
KR_7758411400,15832,14665,228,215,9,7,7,9,14,8,0,0,0,0,22,14,0,3,0,1,0,1,0,0,0,0,10,540244,1167,13,2,-2,6,0,0,8,-3,-1
KR_7758418412,14596,14669,250,267,4,4,4,4,8,5,0,1,0,0,19,16,2,3,0,0,1,0,0,1,0,0,10,540264,-73,-17,0,0,3,-1,0,3,-1,0
KR_7758422375,18124,14090,289,238,10,4,4,10,8,4,0,0,0,0,16,14,2,3,2,1,1,0,0,0,0,0,10,540209,4034,51,6,-6,4,0,0,2,-1,1
KR_7758422573,15624,16112,222,276,7,6,6,7,10,7,0,0,0,0,37,15,3,2,0,2,0,1,0,0,0,0,10,540205,-488,-54,1,-1,3,0,0,22,1,-2
KR_7758423732,16288,15052,251,251,7,5,5,7,9,5,0,0,0,0,23,29,5,1,1,1,0,1,0,0,0,0,10,540236,1236,0,2,-2,4,0,0,-6,4,0
KR_7758426684,14186,14342,286,262,2,4,4,2,1,6,0,1,0,0,16,37,5,2,0,0,0,1,0,1,0,0,10,540248,-156,24,-2,2,-5,-1,0,-21,3,0
KR_7758432547,14885,14127,251,232,6,4,4,6,5,4,0,0,0,0,24,17,2,6,0,0,1,0,0,0,0,0,10,540235,758,19,2,-2,1,0,0,7,-4,0
KR_7758437393,13755,14762,256,276,2,3,3,2,5,6,0,0,0,0,39,17,2,4,0,0,1,0,0,0,0,0,10,540244,-1007,-20,-1,1,-1,0,0,22,-2,0
KR_7758438003,15348,13407,288,274,4,2,2,4,6,0,1,0,0,0,16,17,2,2,2,0,1,0,1,0,0,0,10,540235,1941,14,2,-2,6,1,0,-1,0,2
KR_7758439946,16300,16455,257,261,7,8,8,7,7,9,0,0,0,0,19,15,3,6,2,2,0,1,0,0,0,0,10,540033,-155,-4,-1,1,-2,0,0,4,-3,0
KR_7758450360,12795,15670,236,275,1,7,7,1,0,3,0,1,0,0,53,20,7,3,0,1,0,1,0,1,0,0,10,540219,-2875,-39,-6,6,-3,-1,0,33,4,-1
KR_7758453111,14857,13899,306,276,3,1,1,4,2,1,0,1,0,0,17,17,1,4,1,0,1,0,0,1,0,0,10,540221,958,30,2,-3,1,-1,0,0,-3,1
KR_7758454244,13923,17678,265,304,2,7,7,3,3,11,0,0,0,0,15,34,1,1,0,0,0,1,0,0,0,0,10,540081,-3755,-39,-5,4,-8,0,0,-19,0,0
KR_7758464484,14818,15068,251,232,6,6,7,6,3,8,0,0,0,0,14,34,3,2,0,2,1,0,0,0,0,0,10,540229,-250,19,0,1,-5,0,0,-20,1,-2
KR_7758479616,15218,13961,291,266,4,2,2,4,9,3,0,1,0,0,18,15,6,5,1,0,1,0,0,1,0,0,10,540236,1257,25,2,-2,6,-1,0,3,1,1
KR_7758485933,14774,14422,228,259,6,2,2,7,5,2,0,0,0,0,17,15,2,5,0,0,1,0,0,0,0,0,10,540224,352,-31,4,-5,3,0,0,2,-3,0
KR_7758487241,15282,14122,281,264,5,3,3,5,4,2,0,1,0,0,34,19,3,3,0,0,1,0,0,1,0,0,10,540222,1160,17,2,-2,2,-1,0,15,0,0
KR_7758493448,15323,15789,274,272,5,6,6,5,4,11,0,1,0,0,16,39,6,4,0,0,1,0,0,1,0,0,10,540121,-466,2,-1,1,-7,-1,0,-23,2,0
KR_7758498773,15082,15170,267,277,4,4,4,4,4,5,0,0,0,0,15,26,1,3,3,1,1,0,0,0,0,0,10,540197,-88,-10,0,0,-1,0,0,-11,-2,2
KR_7758498860,13505,16766,261,272,2,9,9,2,1,7,0,0,0,0,15,18,4,3,0,1,0,1,0,0,0,0,10,540224,-3261,-11,-7,7,-6,0,0,-3,1,-1
KR_7758499393,15955,17715,243,277,7,10,10,7,8,8,0,0,0,0,26,15,5,6,1,4,0,1,0,0,0,0,10,540211,-1760,-34,-3,3,0,0,0,11,-1,-3
KR_7758501769,14258,16912,281,259,2,10,10,3,3,15,0,1,0,0,17,16,3,4,0,0,0,1,0,1,0,0,10,540221,-2654,22,-8,7,-12,-1,0,1,-1,0
KR_7758511272,16803,14743,252,258,9,3,3,9,14,3,1,0,0,0,19,15,2,2,1,0,1,0,1,0,0,0,10,540234,2060,-6,6,-6,11,1,0,4,0,1
KR_7758514658,16073,17251,249,251,8,11,11,8,10,16,0,1,0,0,16,38,4,3,0,0,1,0,0,1,0,0,10,540258,-1178,-2,-3,3,-6,-1,0,-22,1,0
KR_7758517616,15948,17406,276,255,6,11,11,6,5,15,1,0,0,0,11,18,6,1,0,0,0,1,1,0,0,0,10,540237,-1458,21,-5,5,-10,1,0,-7,5,0
KR_7758518541,15471,15204,272,263,5,5,5,5,8,4,0,0,0,0,18,38,4,3,0,0,1,0,0,0,0,0,10,540220,267,9,0,0,4,0,0,-20,1,0
KR_7758519725,13628,15583,261,256,2,8,8,2,1,7,0,0,0,0,14,19,4,3,1,0,1,0,0,0,0,0,10,540280,-1955,5,-6,6,-6,0,0,-5,1,1
KR_7758530624,13918,15832,272,268,2,5,5,2,2,6,0,0,0,0,17,29,3,5,1,0,0,1,0,0,0,0,10,540267,-1914,4,-3,3,-4,0,0,-12,-2,1
KR_7758545577,15686,16685,205,269,8,8,8,8,9,10,0,1,0,0,15,16,4,2,1,1,1,0,0,1,0,0,10,540227,-999,-64,0,0,-1,-1,0,-1,2,0
KR_7758550602,15248,15204,243,209,7,8,8,7,5,8,0,0,0,0,13,50,4,1,0,1,0,1,0,0,0,0,10,540199,44,34,-1,1,-3,0,0,-37,3,-1
KR_7758555511,16121,16984,264,281,8,7,7,8,6,7,0,1,0,0,19,13,1,7,1,0,0,1,0,1,0,0,10,540254,-863,-17,1,-1,-1,-1,0,6,-6,1
KR_7758557440,13308,16079,262,281,1,6,6,1,1,9,0,0,0,0,17,20,2,1,0,1,1,0,0,0,0,0,10,540215,-2771,-19,-5,5,-8,0,0,-3,1,-1
KR_7758564012,14821,15486,245,245,4,5,5,5,4,6,0,0,0,0,18,19,3,3,2,3,1,0,0,0,0,0,10,540243,-665,0,-1,0,-2,0,0,-1,0,-1
KR_7758565728,14755,13579,294,243,4,2,2,4,1,3,0,0,0,0,19,36,2,6,0,0,1,0,0,0,0,0,10,540205,1176,51,2,-2,-2,0,0,-17,-4,0
KR_7758567024,14948,17013,254,262,5,10,10,5,9,8,0,0,0,0,20,13,2,6,0,3,0,1,0,0,0,0,10,540250,-2065,-8,-5,5,1,0,0,7,-4,-3
KR_7758571784,16624,14686,276,277,8,3,3,8,8,2,0,0,0,0,18,32,3,2,1,1,0,1,0,0,0,0,10,540196,1938,-1,5,-5,6,0,0,-14,1,0
KR_7758572451,16382,15375,267,252,9,6,6,9,5,7,0,0,0,0,12,15,4,3,0,1,0,1,0,0,0,0,10,540224,1007,15,3,-3,-2,0,0,-3,1,-1
KR_7758582068,14284,16523,236,285,4,8,9,4,4,5,0,1,0,0,12,22,2,3,1,1,0,1,0,1,0,0,10,540245,-2239,-49,-4,5,-1,-1,0,-10,-1,0
KR_7758589090,15164,13135,272,258,5,1,1,5,3,2,0,1,0,0,17,15,2,4,1,0,1,0,0,1,0,0,10,540226,2029,14,4,-4,1,-1,0,2,-2,1
KR_7758589989,13036,15921,249,262,1,8,8,1,1,5,0,0,0,0,26,24,4,2,0,1,0,1,0,0,0,0,10,540218,-2885,-13,-7,7,-4,0,0,2,2,-1
KR_7758591259,15125,16051,249,230,6,10,10,6,8,7,0,0,0,0,14,110,4,3,0,0,1,0,0,0,0,0,10,540272,-926,19,-4,4,1,0,0,-96,1,0
KR_7758604408,15570,14132,281,274,4,2,3,4,6,2,1,0,0,0,20,16,1,3,2,0,0,1,1,0,0,0,10,540228,1438,7,2,-1,4,1,0,4,-2,2
KR_7758604594,13062,14644,251,272,1,3,3,1,1,3,0,0,0,0,42,80,3,2,0,2,0,1,0,0,0,0,10,540244,-1582,-21,-2,2,-2,0,0,-38,1,-2
KR_7758612127,13666,17144,236,300,2,8,9,2,3,9,0,0,0,0,36,19,7,4,1,1,0,1,0,0,0,0,10,540195,-3478,-64,-6,7,-6,0,0,17,3,0
KR_7758614839,15385,15261,271,255,5,5,5,5,10,8,0,0,0,0,16,16,1,2,1,0,1,0,0,0,0,0,10,540264,124,16,0,0,2,0,0,0,-1,1
KR_7758618577,16877,13903,262,263,10,3,3,10,7,0,0,0,0,0,17,15,1,0,1,0,1,0,0,0,0,0,10,540282,2974,-1,7,-7,7,0,0,2,1,1
KR_7758624469,15422,16719,262,290,6,7,7,6,6,11,0,0,0,0,15,15,2,4,0,1,1,0,0,0,0,0,10,540254,-1297,-28,-1,1,-5,0,0,0,-2,-1
KR_7758625227,17436,16393,277,253,9,9,9,9,13,10,0,0,0,0,31,15,3,5,0,1,1,0,0,0,0,0,10,540250,1043,24,0,0,3,0,0,16,-2,-1
KR_7758629153,14088,15195,281,270,2,6,6,2,2,11,0,0,0,0,48,20,3,5,0,0,0,1,0,0,0,0,10,540205,-1107,11,-4,4,-9,0,0,28,-2,0
KR_7758633074,15268,15323,267,266,6,6,6,6,6,3,0,1,0,0,36,15,2,7,0,0,1,0,0,1,0,0,10,540253,-55,1,0,0,3,-1,0,21,-5,0
KR_7758634933,16415,14955,271,260,7,5,5,7,10,4,0,1,0,0,21,17,6,6,2,0,0,1,0,1,0,0,10,540235,1460,11,2,-2,6,-1,0,4,0,2
KR_7758639650,13879,17102,238,256,3,10,10,3,3,6,0,0,0,0,14,17,3,4,1,4,0,1,0,0,0,0,10,540193,-3223,-18,-7,7,-3,0,0,-3,-1,-3
KR_7758647891,15514,17514,217,252,8,12,12,8,4,8,0,0,0,0,49,35,3,4,0,2,0,1,0,0,0,0,10,540186,-2000,-35,-4,4,-4,0,0,14,-1,-2
KR_7758657832,15323,14092,286,268,4,3,3,4,4,3,0,1,0,0,16,21,6,5,0,0,0,1,0,1,0,0,10,540110,1231,18,1,-1,1,-1,0,-5,1,0
KR_7758664226,15599,16303,259,240,7,9,9,7,5,12,0,0,0,0,36,16,2,1,2,1,0,1,0,0,0,0,10,540240,-704,19,-2,2,-7,0,0,20,1,1
KR_7758666089,14422,16581,243,268,4,8,8,4,6,12,0,0,0,0,17,38,3,5,1,1,1,0,0,0,0,0,10,540219,-2159,-25,-4,4,-6,0,0,-21,-2,0
KR_7758692005,15825,16379,234,232,9,9,9,9,12,12,0,0,0,0,14,13,3,5,0,1,1,0,0,0,0,0,10,540205,-554,2,0,0,0,0,0,1,-2,-1
KR_7758743241,16945,14812,275,266,8,4,4,8,8,6,0,0,0,0,15,15,3,1,1,0,0,1,0,0,0,0,10,540175,2133,9,4,-4,2,0,0,0,2,1
KR_7758743586,15026,16888,243,270,5,8,8,5,10,11,0,1,0,0,17,37,5,6,2,1,1,0,0,1,0,0,10,540227,-1862,-27,-3,3,-1,-1,0,-20,-1,1
KR_7758752561,13283,16821,244,284,3,8,8,3,2,12,0,0,0,0,14,35,4,2,0,1,1,0,0,0,0,0,10,540094,-3538,-40,-5,5,-10,0,0,-21,2,-1
KR_7758754864,14763,16239,287,246,4,9,9,4,5,9,1,0,0,0,12,16,4,4,0,0,0,1,1,0,0,0,10,540209,-1476,41,-5,5,-4,1,0,-4,0,0
KR_7758763509,16289,16124,260,232,9,8,8,9,6,7,0,0,0,0,15,14,1,1,1,1,0,1,0,0,0,0,10,540118,165,28,1,-1,-1,0,0,1,0,0
KR_7758777989,13105,18358,212,287,3,13,13,3,2,9,0,0,0,0,22,174,0,2,0,1,0,1,0,0,0,0,10,540226,-5253,-75,-10,10,-7,0,0,-152,-2,-1
KR_7758778024,16541,15941,260,238,9,8,8,9,14,11,0,0,0,0,14,17,3,2,0,1,1,0,0,0,0,0,10,540260,600,22,1,-1,3,0,0,-3,1,-1
KR_7758807177,16209,15599,244,266,8,7,7,8,12,5,1,0,0,0,18,38,2,5,1,0,1,0,1,0,0,0,10,540166,610,-22,1,-1,7,1,0,-20,-3,1
KR_7758812058,2505,2515,0,0,0,0,0,0,0,0,0,0,0,0,2,1,0,0,0,0,0,0,0,0,0,0,3,100409,-10,0,0,0,0,0,0,1,0,0
KR_7758820094,14924,17166,265,243,4,10,10,4,4,14,0,0,0,0,66,12,3,2,0,1,1,0,0,0,0,0,10,540207,-2242,22,-6,6,-10,0,0,54,1,-1
KR_7758832505,18122,13935,266,196,9,5,5,9,11,5,0,0,0,0,12,16,5,2,2,0,1,0,0,0,0,0,10,540228,4187,70,4,-4,6,0,0,-4,3,2
KR_7758850824,14403,20436,223,294,6,14,14,6,6,20,0,1,0,0,10,13,1,1,0,2,0,1,0,1,0,0,10,540204,-6033,-71,-8,8,-14,-1,0,-3,0,-2
KR_7758851649,14968,15259,259,260,5,5,6,5,6,7,0,1,0,0,15,18,8,1,1,0,1,0,0,1,0,0,10,540191,-291,-1,0,1,-1,-1,0,-3,7,1
KR_7758869505,14361,14959,234,284,5,4,4,5,5,5,1,0,0,0,16,22,5,2,0,0,1,0,1,0,0,0,10,540225,-598,-50,1,-1,0,1,0,-6,3,0
KR_7758878233,14105,16718,226,281,4,8,8,4,6,9,0,0,0,0,18,22,5,6,0,0,1,0,0,0,0,0,10,540237,-2613,-55,-4,4,-3,0,0,-4,-1,0
KR_7758898017,15871,15088,270,247,8,8,8,8,3,4,0,1,0,0,13,17,2,1,0,0,0,1,0,1,0,0,10,540247,783,23,0,0,-1,-1,0,-4,1,0
KR_7758909737,15943,14344,296,260,6,4,4,6,8,4,0,0,0,0,14,13,2,2,1,0,1,0,0,0,0,0,10,540239,1599,36,2,-2,4,0,0,1,0,1
KR_7758912030,13754,13685,284,290,1,1,1,1,1,0,0,1,0,0,19,16,1,6,0,0,1,0,0,1,0,0,10,540202,69,-6,0,0,1,-1,0,3,-5,0
KR_7758920352,13848,16067,259,292,2,4,4,2,2,9,0,0,0,0,25,20,3,2,1,1,0,1,0,0,0,0,10,540170,-2219,-33,-2,2,-7,0,0,5,1,0
KR_7758954232,14530,13900,262,272,3,2,2,3,5,2,0,0,0,0,33,18,5,2,1,0,0,1,0,0,0,0,10,540198,630,-10,1,-1,3,0,0,15,3,1
KR_7758959139,16023,14473,272,285,6,3,3,6,8,2,1,0,0,0,18,14,3,7,1,0,0,1,1,0,0,0,10,540171,1550,-13,3,-3,6,1,0,4,-4,1
KR_7758964097,15605,17019,271,263,5,11,11,5,2,11,0,1,0,0,17,15,5,4,3,2,0,1,0,1,0,0,10,540265,-1414,8,-6,6,-9,-1,0,2,1,1
KR_7758981644,15943,14584,263,274,7,3,3,7,7,1,0,0,0,0,16,39,6,2,0,1,1,0,0,0,0,0,10,540253,1359,-11,4,-4,6,0,0,-23,4,-1
KR_7758986576,16416,16699,281,274,5,7,7,5,9,10,0,1,0,0,13,18,6,2,0,3,1,0,0,1,0,0,10,540234,-283,7,-2,2,-1,-1,0,-5,4,-3
KR_7758991534,16447,17157,240,266,8,9,9,8,14,11,0,0,0,0,20,17,2,5,1,1,0,1,0,0,0,0,10,540227,-710,-26,-1,1,3,0,0,3,-3,0
KR_7758991602,17300,13829,295,247,10,3,3,10,3,4,0,1,0,0,35,9,3,6,2,0,1,0,0,1,0,0,10,540231,3471,48,7,-7,-1,-1,0,26,-3,2
KR_7758996962,15123,15931,248,252,5,6,6,5,7,8,0,0,0,0,18,14,1,4,2,0,1,0,0,0,0,0,10,540234,-808,-4,-1,1,-1,0,0,4,-3,2
KR_7759010317,14510,14159,285,262,2,3,3,2,3,2,0,0,0,0,19,13,3,5,2,0,0,1,0,0,0,0,10,540225,351,23,-1,1,1,0,0,6,-2,2
KR_7759016634,15066,16238,249,269,5,9,9,5,5,7,0,1,0,0,38,11,1,4,0,0,0,1,0,1,0,0,10,540322,-1172,-20,-4,4,-2,-1,0,27,-3,0
KR_7759016939,13847,15755,263,268,2,6,6,2,2,5,0,0,0,0,18,15,4,5,0,1,0,1,0,0,0,0,10,540210,-1908,-5,-4,4,-3,0,0,3,-1,-1
KR_7759017914,15772,14350,271,252,5,4,4,5,7,5,0,1,0,0,18,44,4,4,2,0,1,0,0,1,0,0,10,540166,1422,19,1,-1,2,-1,0,-26,0,2
KR_7759027840,14196,17852,272,290,3,10,10,4,2,16,0,0,0,0,18,15,4,5,0,0,0,1,0,0,0,0,10,540228,-3656,-18,-7,6,-14,0,0,3,-1,0
KR_7759035946,14695,16081,258,257,5,8,8,5,6,5,0,0,0,0,17,25,2,2,0,0,0,1,0,0,0,0,10,540229,-1386,1,-3,3,1,0,0,-8,0,0
KR_7759039985,18268,15864,266,265,12,6,6,12,10,7,0,0,0,0,18,14,2,5,0,0,1,0,0,0,0,0,10,540250,2404,1,6,-6,3,0,0,4,-3,0
KR_7759053811,17561,13613,280,214,10,4,4,10,9,6,1,0,0,0,14,38,3,2,0,0,0,1,1,0,0,0,10,540215,3948,66,6,-6,3,1,0,-24,1,0
KR_7759055304,15430,15904,273,302,5,6,6,5,5,4,0,1,0,0,16,106,2,5,0,0,0,1,0,1,0,0,10,540130,-474,-29,-1,1,1,-1,0,-90,-3,0
KR_7759057411,15947,14381,242,274,8,4,4,8,12,1,0,1,0,0,15,12,1,1,0,0,0,1,0,1,0,0,10,540108,1566,-32,4,-4,11,-1,0,3,0,0
KR_7759070203,15300,16437,249,258,6,8,8,6,5,14,0,0,0,0,25,18,4,5,1,0,1,0,0,0,0,0,10,540228,-1137,-9,-2,2,-9,0,0,7,-1,1
KR_7759071692,2567,2546,1,0,0,0,0,0,0,0,0,0,0,0,3,3,0,0,0,0,0,0,0,0,0,0,3,103999,21,1,0,0,0,0,0,0,0,0
KR_7759072763,14575,13819,283,266,3,2,2,3,2,1,0,0,0,0,16,15,3,1,0,0,1,0,0,0,0,0,10,540287,756,17,1,-1,1,0,0,1,2,0
KR_7759082982,14804,14462,277,286,4,2,2,4,3,2,0,0,0,0,16,17,3,3,0,0,1,0,0,0,0,0,10,540255,342,-9,2,-2,1,0,0,-1,0,0
KR_7759090804,15326,13260,287,284,5,1,1,5,4,0,1,0,0,0,12,16,2,1,0,0,0,1,1,0,0,0,10,540199,2066,3,4,-4,4,1,0,-4,1,0
KR_7759093149,17031,15351,254,278,10,4,4,10,12,4,0,0,0,0,18,15,5,0,2,2,1,0,0,0,0,0,10,540212,1680,-24,6,-6,8,0,0,3,5,0
KR_7759097660,15335,16817,267,265,5,7,7,5,3,11,0,1,0,0,14,18,2,2,1,1,0,1,0,1,0,0,10,540192,-1482,2,-2,2,-8,-1,0,-4,0,0
KR_7759100042,14872,15311,251,221,5,7,7,5,5,10,0,0,0,0,19,16,1,1,1,0,0,1,0,0,0,0,10,540101,-439,30,-2,2,-5,0,0,3,0,1
KR_7759100349,19052,17152,261,287,13,8,8,13,16,11,0,1,0,0,10,16,4,1,0,0,0,1,0,1,0,0,10,540206,1900,-26,5,-5,5,-1,0,-6,3,0
KR_7759104152,17391,14429,296,252,8,4,4,8,9,3,0,1,0,0,21,23,5,4,0,0,1,0,0,1,0,0,10,540257,2962,44,4,-4,6,-1,0,-2,1,0
KR_7759125511,16018,15712,244,255,6,8,8,6,9,10,0,0,0,0,11,33,4,1,0,0,0,1,0,0,0,0,10,540280,306,-11,-2,2,-1,0,0,-22,3,0
KR_7759135446,15860,16416,237,291,8,7,7,8,7,7,0,0,0,0,15,89,2,0,0,2,0,1,0,0,0,0,10,540146,-556,-54,1,-1,0,0,0,-74,2,-2
KR_7759138496,16074,17449,254,266,8,11,11,8,11,16,0,1,0,0,15,16,4,3,1,1,0,1,0,1,0,0,10,540167,-1375,-12,-3,3,-5,-1,0,-1,1,0
KR_7759143548,13509,13741,237,223,3,3,3,3,3,4,0,1,0,0,25,35,2,2,1,0,1,0,0,1,0,0,10,540253,-232,14,0,0,-1,-1,0,-10,0,1
KR_7759145048,13578,15113,276,308,1,4,4,1,1,1,0,1,0,0,15,11,3,2,1,1,0,1,0,1,0,0,10,540251,-1535,-32,-3,3,0,-1,0,4,1,0
KR_7759154827,16569,15640,291,247,6,7,7,6,7,10,0,0,0,0,18,16,4,0,3,1,1,0,0,0,0,0,10,540195,929,44,-1,1,-3,0,0,2,4,2
KR_7759156813,14720,14608,277,266,3,4,4,3,3,4,0,0,0,0,17,35,3,2,0,1,1,0,0,0,0,0,10,540235,112,11,-1,1,-1,0,0,-18,1,-1
KR_7759164936,15908,13668,264,247,7,2,2,7,7,3,0,0,0,0,13,15,3,0,1,0,1,0,0,0,0,0,10,540183,2240,17,5,-5,4,0,0,-2,3,1
KR_7759174187,13836,17075,257,247,3,10,11,3,1,8,0,0,0,0,14,17,1,2,0,3,0,1,0,0,0,0,10,540167,-3239,10,-7,8,-7,0,0,-3,-1,-3
KR_7759177659,15566,15043,282,264,5,5,5,5,5,5,0,1,0,0,16,17,3,4,0,0,0,1,0,1,0,0,10,540202,523,18,0,0,0,-1,0,-1,-1,0
KR_7759185210,15919,14911,268,249,7,5,5,7,8,4,1,0,0,0,14,20,6,2,0,0,0,1,1,0,0,0,10,540262,1008,19,2,-2,4,1,0,-6,4,0
KR_7759185450,13587,16712,235,274,3,9,9,3,2,3,0,1,0,0,15,18,5,2,0,3,0,1,0,1,0,0,10,540217,-3125,-39,-6,6,-1,-1,0,-3,3,-3
KR_7759193408,13430,18599,240,290,2,14,14,2,3,10,0,1,0,0,33,17,4,3,0,3,0,1,0,1,0,0,10,540219,-5169,-50,-12,12,-7,-1,0,16,1,-3
KR_7759194510,16459,15813,244,238,11,6,6,11,6,12,0,0,0,0,16,19,3,2,1,1,1,0,0,0,0,0,10,540256,646,6,5,-5,-6,0,0,-3,1,0
KR_7759195971,14990,14589,250,260,6,5,5,6,5,3,0,0,0,0,15,12,1,3,1,0,0,1,0,0,0,0,10,540173,401,-10,1,-1,2,0,0,3,-2,1
KR_7759202746,17646,15888,275,266,10,6,6,10,11,7,0,0,0,0,14,12,3,1,2,2,1,0,0,0,0,0,10,540260,1758,9,4,-4,4,0,0,2,2,0
KR_7759211318,14578,14252,272,269,3,3,3,3,6,4,0,1,0,0,17,47,1,4,0,0,0,1,0,1,0,0,10,540222,326,3,0,0,2,-1,0,-30,-3,0
KR_7759213187,14471,18247,269,275,3,13,13,3,4,18,0,0,0,0,14,13,2,5,2,1,0,1,0,0,0,0,10,540209,-3776,-6,-10,10,-14,0,0,1,-3,1
KR_7759215598,17059,16065,227,250,12,9,9,12,11,8,0,0,0,0,13,20,3,2,1,0,0,1,0,0,0,0,10,540248,994,-23,3,-3,3,0,0,-7,1,1
KR_7759220302,13203,13893,221,236,3,4,4,3,1,2,0,1,0,0,14,14,3,4,0,1,0,1,0,1,0,0,10,540213,-690,-15,-1,1,-1,-1,0,0,-1,-1
KR_7759220793,14258,15713,214,244,4,9,9,4,5,12,0,1,0,0,15,16,3,2,0,0,0,1,0,1,0,0,10,540238,-1455,-30,-5,5,-7,-1,0,-1,1,0
KR_7759226763,18387,16326,269,246,12,9,9,12,10,8,0,1,0,0,11,16,2,1,3,1,1,0,0,1,0,0,10,540282,2061,23,3,-3,2,-1,0,-5,1,2
KR_7759227022,15025,13983,261,252,5,3,3,5,6,4,0,0,0,0,15,18,5,6,2,0,1,0,0,0,0,0,10,540113,1042,9,2,-2,2,0,0,-3,-1,2
KR_7759238484,14164,17244,244,281,4,8,8,4,4,11,0,1,0,0,18,35,1,7,0,1,0,1,0,1,0,0,10,540227,-3080,-37,-4,4,-7,-1,0,-17,-6,-1
KR_7759244636,15993,16753,220,258,10,9,9,10,12,9,0,0,0,0,32,13,3,5,0,0,1,0,0,0,0,0,10,540163,-760,-38,1,-1,3,0,0,19,-2,0
KR_7759251577,16318,16185,242,252,8,8,8,8,11,7,0,0,0,0,15,13,4,3,0,2,0,1,0,0,0,0,10,540278,133,-10,0,0,4,0,0,2,1,-2
KR_7759254653,14797,15030,288,285,3,4,4,3,3,4,0,1,0,0,15,12,2,1,0,0,0,1,0,1,0,0,10,540264,-233,3,-1,1,-1,-1,0,3,1,0
KR_7759255377,15111,14970,253,229,6,6,6,6,3,6,1,0,0,0,16,30,3,3,1,0,1,0,1,0,0,0,10,540197,141,24,0,0,-3,1,0,-14,0,1
KR_7759262815,15159,16115,277,280,5,8,8,5,5,7,0,1,0,0,14,16,2,3,0,1,1,0,0,1,0,0,10,540245,-956,-3,-3,3,-2,-1,0,-2,-1,-1
KR_7759266159,15477,15101,236,265,6,5,5,6,17,6,1,0,0,0,13,13,0,4,1,1,0,1,1,0,0,0,10,540259,376,-29,1,-1,11,1,0,0,-4,0
KR_7759267898,14333,15582,250,282,4,6,7,4,5,5,0,1,0,0,17,23,1,2,0,0,0,1,0,1,0,0,10,540199,-1249,-32,-2,3,0,-1,0,-6,-1,0
KR_7759273469,15227,16174,233,273,6,8,8,6,8,6,0,0,0,0,14,15,6,2,1,0,0,1,0,0,0,0,10,540114,-947,-40,-2,2,2,0,0,-1,4,1
KR_7759274164,14504,16128,245,290,5,5,5,5,7,9,1,0,0,0,50,14,2,5,0,2,1,0,1,0,0,0,10,540242,-1624,-45,0,0,-2,1,0,36,-3,-2
KR_7759276836,15874,14758,242,221,7,5,5,7,10,5,0,0,0,0,30,15,5,1,0,1,1,0,0,0,0,0,10,540188,1116,21,2,-2,5,0,0,15,4,-1
KR_7759280476,15040,16337,263,277,5,6,6,7,5,7,0,0,0,0,54,16,6,2,1,2,1,0,0,0,0,0,10,540252,-1297,-14,-1,-1,-2,0,0,38,4,-1
KR_7759282082,17706,17037,226,258,13,9,9,13,12,5,1,0,0,0,16,15,1,4,0,0,1,0,1,0,0,0,10,540214,669,-32,4,-4,7,1,0,1,-3,0
KR_7759285598,15005,13440,238,268,7,1,1,7,10,0,0,0,0,0,50,111,6,3,0,0,1,0,0,0,0,0,10,540224,1565,-30,6,-6,10,0,0,-61,3,0
KR_7759286454,13902,14909,310,293,1,3,3,1,0,6,1,0,0,0,13,109,2,0,0,1,0,1,1,0,0,0,10,540212,-1007,17,-2,2,-6,1,0,-96,2,-1
KR_7759296791,15864,16172,257,245,6,6,6,6,7,16,1,0,0,0,14,14,3,4,2,1,1,0,1,0,0,0,10,540235,-308,12,0,0,-9,1,0,0,-1,1
KR_7759297759,16775,13440,327,275,5,1,1,5,7,1,0,0,0,0,20,12,5,5,3,0,1,0,0,0,0,0,10,540209,3335,52,4,-4,6,0,0,8,0,3
KR_7759306922,16345,17428,241,254,8,10,10,8,10,13,0,1,0,0,16,16,2,4,0,1,0,1,0,1,0,0,10,540269,-1083,-13,-2,2,-3,-1,0,0,-2,-1
KR_7759315677,14883,12848,271,242,5,1,1,5,4,0,0,0,0,0,76,33,2,2,0,0,1,0,0,0,0,0,10,540211,2035,29,4,-4,4,0,0,43,0,0
KR_7759318762,14662,13907,279,215,3,5,6,3,3,4,1,0,0,0,15,20,6,2,2,0,0,1,1,0,0,0,10,540218,755,64,-2,3,-1,1,0,-5,4,2
KR_7759322782,17924,16701,226,270,14,8,8,14,16,7,0,0,0,0,19,16,1,4,1,2,0,1,0,0,0,0,10,540203,1223,-44,6,-6,9,0,0,3,-3,-1
KR_7759329716,16117,15637,282,269,5,6,6,5,7,7,1,0,0,0,17,116,8,6,0,1,0,1,1,0,0,0,10,540277,480,13,-1,1,0,1,0,-99,2,-1
KR_7759330476,15181,14358,296,265,4,3,3,5,3,2,0,0,0,0,35,16,2,1,1,1,1,0,0,0,0,0,10,540209,823,31,1,-2,1,0,0,19,1,0
KR_7759338702,14487,15080,275,259,3,5,5,3,3,8,0,1,0,0,14,18,2,3,1,0,1,0,0,1,0,0,10,540115,-593,16,-2,2,-5,-1,0,-4,-1,1
KR_7759342088,17238,14970,272,257,8,5,5,8,10,5,0,0,0,0,11,97,1,1,0,0,0,1,0,0,0,0,10,540206,2268,15,3,-3,5,0,0,-86,0,0
KR_7759344475,14629,17859,236,223,4,12,12,4,9,14,0,0,0,0,16,15,2,3,1,3,0,1,0,0,0,0,10,540119,-3230,13,-8,8,-5,0,0,1,-1,-2
KR_7759357917,16377,15378,275,233,7,6,6,7,5,12,0,0,0,0,15,46,4,3,1,0,0,1,0,0,0,0,10,540229,999,42,1,-1,-7,0,0,-31,1,1
KR_7759363507,16562,13433,257,267,9,1,1,9,10,0,1,0,0,0,20,21,4,3,2,0,1,0,1,0,0,0,10,540097,3129,-10,8,-8,10,1,0,-1,1,2
KR_7759366080,16506,15453,254,268,7,6,6,7,11,7,1,0,0,0,15,16,5,3,0,0,1,0,1,0,0,0,10,540206,1053,-14,1,-1,4,1,0,-1,2,0
KR_7759373094,17220,17656,225,289,11,10,10,11,23,14,0,0,0,0,45,19,4,4,0,1,1,0,0,0,0,0,10,540237,-436,-64,1,-1,9,0,0,26,0,-1
KR_7759404875,17988,17002,265,247,11,9,9,11,19,9,1,0,0,0,27,14,2,4,3,0,0,1,1,0,0,0,10,540235,986,18,2,-2,10,1,0,13,-2,3
KR_7759410347,14168,15813,228,275,4,6,6,4,4,4,0,0,0,0,13,13,0,2,0,2,0,1,0,0,0,0,10,540206,-1645,-47,-2,2,0,0,0,0,-2,-2
KR_7759412924,15363,13796,257,239,6,3,3,6,5,3,0,0,0,0,42,18,4,3,0,1,1,0,0,0,0,0,10,540195,1567,18,3,-3,2,0,0,24,1,-1
KR_7759414896,15121,16625,259,274,4,8,8,4,6,8,0,0,0,0,13,26,3,2,1,0,1,0,0,0,0,0,10,540259,-1504,-15,-4,4,-2,0,0,-13,1,1
KR_7759423188,15844,14878,269,282,5,4,4,6,5,3,0,0,0,0,15,15,5,2,2,0,1,0,0,0,0,0,10,540297,966,-13,1,-2,2,0,0,0,3,2
KR_7759428856,15563,17017,210,234,7,11,11,7,9,14,0,0,0,0,16,17,0,5,1,0,0,1,0,0,0,0,10,540194,-1454,-24,-4,4,-5,0,0,-1,-5,1
KR_7759429913,15580,14934,271,255,6,5,5,6,6,4,1,0,0,0,15,38,7,2,0,1,1,0,1,0,0,0,10,540224,646,16,1,-1,2,1,0,-23,5,-1
KR_7759440954,13247,15398,245,273,2,5,5,2,4,8,1,0,0,0,19,17,4,3,0,2,1,0,1,0,0,0,10,540259,-2151,-28,-3,3,-4,1,0,2,1,-2
KR_7759445162,14657,16974,245,266,4,9,9,4,5,11,0,1,0,0,14,15,4,4,0,3,0,1,0,1,0,0,10,540201,-2317,-21,-5,5,-6,-1,0,-1,0,-3
KR_7759446435,16205,16949,266,241,7,11,11,8,8,9,0,0,0,0,21,17,3,7,0,0,1,0,0,0,0,0,10,540184,-744,25,-4,3,-1,0,0,4,-4,0
KR_7759474191,15519,15079,261,284,6,4,5,6,8,5,0,0,0,0,15,14,5,3,1,1,0,1,0,0,0,0,10,540230,440,-23,2,-1,3,0,0,1,2,0
KR_7759475489,16057,17130,249,247,7,10,10,7,9,17,0,1,0,0,34,13,3,2,4,0,0,1,0,1,0,0,10,540238,-1073,2,-3,3,-8,-1,0,21,1,4
KR_7759478670,16533,13992,249,254,9,3,3,9,10,2,0,0,0,0,22,16,5,2,3,1,1,0,0,0,0,0,10,540223,2541,-5,6,-6,8,0,0,6,3,2
KR_7759480023,15172,15662,286,281,4,4,4,4,5,7,0,0,0,0,18,18,2,4,0,0,0,1,0,0,0,0,10,540220,-490,5,0,0,-2,0,0,0,-2,0
KR_7759481097,17946,16186,250,256,12,6,6,12,18,10,0,0,0,0,103,21,6,1,2,1,0,1,0,0,0,0,10,540271,1760,-6,6,-6,8,0,0,82,5,1
KR_7759487345,15312,13132,262,237,6,2,2,7,10,1,0,0,0,0,17,17,3,5,0,0,0,1,0,0,0,0,10,540260,2180,25,4,-5,9,0,0,0,-2,0
KR_7759488730,14849,16742,276,271,5,8,8,5,2,9,0,0,0,0,18,16,3,4,0,0,1,0,0,0,0,0,10,540202,-1893,5,-3,3,-7,0,0,2,-1,0
KR_7759499758,13783,15978,287,266,1,8,8,1,2,6,0,0,0,0,13,16,5,1,0,0,0,1,0,0,0,0,10,540232,-2195,21,-7,7,-4,0,0,-3,4,0
KR_7759519002,15854,14830,306,269,5,3,3,5,2,3,0,1,0,0,16,17,1,4,1,0,1,0,0,1,0,0,10,540238,1024,37,2,-2,-1,-1,0,-1,-3,1
KR_7759525980,16937,14474,284,272,8,3,3,8,6,1,1,0,0,0,18,17,3,4,4,1,1,0,1,0,0,0,10,540140,2463,12,5,-5,5,1,0,1,-1,3
KR_7759527060,17024,14680,256,241,9,4,4,9,16,4,0,0,0,0,16,17,4,1,1,1,1,0,0,0,0,0,10,540191,2344,15,5,-5,12,0,0,-1,3,0
KR_7759527283,15411,17361,273,258,4,11,11,4,5,9,0,1,0,0,13,17,2,6,0,0,1,0,0,1,0,0,10,540198,-1950,15,-7,7,-4,-1,0,-4,-4,0
KR_7759533616,15978,16114,241,257,7,8,8,7,12,9,0,1,0,0,115,17,0,4,0,0,1,0,0,1,0,0,10,540184,-136,-16,-1,1,3,-1,0,98,-4,0
KR_7759535138,16259,13755,264,263,8,2,2,8,7,3,0,0,0,0,30,16,4,5,1,0,1,0,0,0,0,0,10,540191,2504,1,6,-6,4,0,0,14,-1,1
KR_7759538872,15356,16067,289,254,4,7,7,4,2,9,0,0,0,0,34,17,6,2,0,1,0,1,0,0,0,0,10,540237,-711,35,-3,3,-7,0,0,17,4,-1
KR_7759545900,15901,14134,287,252,5,3,3,5,6,4,0,0,0,0,23,13,2,2,1,0,1,0,0,0,0,0,10,540297,1767,35,2,-2,2,0,0,10,0,1
KR_7759556845,14038,15115,245,250,4,6,6,4,0,5,0,0,0,0,25,16,4,2,0,1,1,0,0,0,0,0,10,540234,-1077,-5,-2,2,-5,0,0,9,2,-1
KR_7759558519,13274,15145,247,319,2,3,3,2,4,1,0,1,0,0,35,19,5,4,0,0,1,0,0,1,0,0,10,540283,-1871,-72,-1,1,3,-1,0,16,1,0
KR_7759568295,16704,15407,273,272,9,5,6,9,11,6,1,0,0,0,33,14,2,0,1,1,0,1,1,0,0,0,10,540187,1297,1,4,-3,5,1,0,19,2,0
KR_7759574206,16088,16241,274,263,5,6,6,5,4,6,0,1,0,0,15,16,5,0,1,1,0,1,0,1,0,0,10,540253,-153,11,-1,1,-2,-1,0,-1,5,0
KR_7759584206,19427,13250,277,259,16,1,1,16,12,0,1,0,0,0,19,36,5,3,3,0,1,0,1,0,0,0,10,540199,6177,18,15,-15,12,1,0,-17,2,3
KR_7759584769,14401,15561,275,266,3,5,5,3,3,9,0,0,0,0,15,18,4,3,0,0,1,0,0,0,0,0,10,540219,-1160,9,-2,2,-6,0,0,-3,1,0
KR_7759601667,17886,14796,282,225,10,5,5,10,7,10,0,0,0,0,210,14,3,4,1,0,1,0,0,0,0,0,10,540240,3090,57,5,-5,-3,0,0,196,-1,1
KR_7759603347,15779,16286,217,245,8,9,9,8,7,7,0,1,0,0,9,14,1,1,0,1,0,1,0,1,0,0,10,540202,-507,-28,-1,1,0,-1,0,-5,0,-1
KR_7759611018,18046,14104,281,168,10,6,6,10,6,8,0,0,0,0,112,17,3,2,4,0,0,1,0,0,0,0,10,540186,3942,113,4,-4,-2,0,0,95,1,4
KR_7759618301,14654,14939,279,298,4,3,3,4,7,2,0,1,0,0,15,109,6,4,0,1,1,0,0,1,0,0,10,540323,-285,-19,1,-1,5,-1,0,-94,2,-1
KR_7759629874,16729,15075,262,280,9,5,5,9,7,6,0,0,0,0,36,17,5,7,0,0,0,1,0,0,0,0,10,540260,1654,-18,4,-4,1,0,0,19,-2,0
KR_7759630969,15949,14386,249,258,7,4,4,8,8,3,0,0,0,0,14,18,4,3,2,0,0,1,0,0,0,0,10,540236,1563,-9,3,-4,5,0,0,-4,1,2
KR_7759640850,17980,14768,258,244,12,4,4,12,16,7,0,0,0,0,17,18,3,6,0,0,0,1,0,0,0,0,10,540322,3212,14,8,-8,9,0,0,-1,-3,0
KR_7759643144,17046,13339,266,250,9,2,2,9,9,1,0,1,0,0,117,14,2,4,1,0,0,1,0,1,0,0,10,540226,3707,16,7,-7,8,-1,0,103,-2,1
KR_7759648435,15804,15901,293,290,4,5,5,4,3,6,0,0,0,0,20,18,5,2,0,2,0,1,0,0,0,0,10,540118,-97,3,-1,1,-3,0,0,2,3,-2
KR_7759662577,16267,15628,265,295,7,4,4,7,9,2,0,0,0,0,107,13,3,6,2,0,1,0,0,0,0,0,10,540248,639,-30,3,-3,7,0,0,94,-3,2
KR_7759675288,14912,15688,269,279,4,5,5,4,7,5,0,0,0,0,12,36,4,5,0,1,1,0,0,0,0,0,10,540237,-776,-10,-1,1,2,0,0,-24,-1,-1
KR_7759680242,15729,14961,269,273,6,4,4,6,11,9,0,0,0,0,17,16,3,1,1,0,0,1,0,0,0,0,10,540237,768,-4,2,-2,2,0,0,1,2,1
KR_7759697773,15709,15225,283,257,5,6,6,5,9,4,0,0,0,0,26,14,2,2,0,0,0,1,0,0,0,0,10,540173,484,26,-1,1,5,0,0,12,0,0
KR_7759701234,16685,21319,226,277,10,18,18,11,11,24,0,0,0,0,14,12,0,2,0,2,0,1,0,0,0,0,10,540234,-4634,-51,-8,7,-13,0,0,2,-2,-2
KR_7759708206,12762,16899,230,272,2,9,9,2,2,6,0,0,0,0,16,12,0,3,0,0,1,0,0,0,0,0,10,540132,-4137,-42,-7,7,-4,0,0,4,-3,0
KR_7759714444,14304,14850,269,247,2,5,5,2,4,3,0,0,0,0,13,39,5,2,0,2,0,1,0,0,0,0,10,540257,-546,22,-3,3,1,0,0,-26,3,-2
KR_7759719360,17734,14900,220,226,14,5,5,14,14,8,0,0,0,0,110,16,1,2,0,2,1,0,0,0,0,0,10,540255,2834,-6,9,-9,6,0,0,94,-1,-2
KR_7759723323,13861,16573,253,258,3,8,8,3,3,13,0,0,0,0,10,16,4,2,1,3,0,1,0,0,0,0,10,540172,-2712,-5,-5,5,-10,0,0,-6,2,-2
KR_7759739146,18366,15350,243,230,14,7,7,14,11,6,0,0,0,0,18,16,6,5,3,0,1,0,0,0,0,0,10,540236,3016,13,7,-7,5,0,0,2,1,3
KR_7759742725,15150,14860,215,244,7,6,7,7,10,6,0,0,0,0,18,50,1,1,0,1,0,1,0,0,0,0,10,540119,290,-29,1,0,4,0,0,-32,0,-1
KR_7759750892,15540,13754,260,259,6,2,2,6,9,1,0,0,0,0,16,10,2,1,0,0,1,0,0,0,0,0,10,540235,1786,1,4,-4,8,0,0,6,1,0
KR_7759751079,18612,16720,231,244,14,9,9,14,28,20,0,0,0,0,18,18,3,2,0,0,1,0,0,0,0,0,10,540227,1892,-13,5,-5,8,0,0,0,1,0
KR_7759763858,16878,15151,235,212,12,6,6,12,6,5,0,0,0,0,33,13,0,2,1,1,1,0,0,0,0,0,10,540256,1727,23,6,-6,1,0,0,20,-2,0
KR_7759793289,15526,16112,263,249,6,8,8,6,7,9,0,0,0,0,19,24,1,2,0,0,0,1,0,0,0,0,10,540222,-586,14,-2,2,-2,0,0,-5,-1,0
KR_7759795884,16003,14217,272,234,7,5,5,7,5,3,0,0,0,0,44,14,1,1,0,0,1,0,0,0,0,0,10,540214,1786,38,2,-2,2,0,0,30,0,0
KR_7759803978,16173,15932,264,274,7,6,6,7,8,3,0,0,0,0,18,113,2,3,2,0,1,0,0,0,0,0,10,540204,241,-10,1,-1,5,0,0,-95,-1,2
KR_7759811626,17303,14714,253,269,11,4,4,11,14,2,0,0,0,0,15,13,6,1,0,1,1,0,0,0,0,0,10,540254,2589,-16,7,-7,12,0,0,2,5,-1
KR_7759820577,16870,13699,280,246,8,3,3,8,4,1,1,0,0,0,15,16,6,3,1,0,0,1,1,0,0,0,10,540206,3171,34,5,-5,3,1,0,-1,3,1
KR_7759823557,14275,15373,228,228,6,6,6,6,3,8,1,0,0,0,12,13,2,0,1,0,0,1,1,0,0,0,10,540225,-1098,0,0,0,-5,1,0,-1,2,1
KR_7759836476,14766,16928,242,279,6,9,9,6,4,10,1,0,0,0,13,113,4,3,0,0,1,0,1,0,0,0,10,540106,-2162,-37,-3,3,-6,1,0,-100,1,0
KR_7759840303,15296,16863,292,294,4,9,9,4,2,6,0,0,0,0,15,16,0,3,0,1,0,1,0,0,0,0,10,540226,-1567,-2,-5,5,-4,0,0,-1,-3,-1
KR_7759854591,16784,15309,270,256,11,6,6,11,7,7,0,0,0,0,16,10,2,4,0,0,1,0,0,0,0,0,10,540123,1475,14,5,-5,0,0,0,6,-2,0
KR_7759863285,17304,16317,236,260,10,7,7,10,15,9,0,0,0,0,33,21,4,2,1,1,1,0,0,0,0,0,10,540165,987,-24,3,-3,6,0,0,12,2,0
KR_7759869166,16313,14337,253,254,7,3,3,7,8,5,0,0,0,0,33,17,1,4,2,0,1,0,0,0,0,0,10,540261,1976,-1,4,-4,3,0,0,16,-3,2
KR_7759877148,16447,17022,226,262,8,8,9,8,15,19,0,0,0,0,53,35,3,5,0,0,1,0,0,0,0,0,10,540226,-575,-36,0,1,-4,0,0,18,-2,0
KR_7759879948,13805,14245,291,270,0,2,2,0,0,2,0,0,0,0,40,21,5,3,1,1,0,1,0,0,0,0,10,540250,-440,21,-2,2,-2,0,0,19,2,0
KR_7759894258,15055,16200,268,253,6,7,7,6,5,12,0,0,0,0,13,15,1,2,0,1,1,0,0,0,0,0,10,540207,-1145,15,-1,1,-7,0,0,-2,-1,-1
KR_7759895455,15902,14853,267,257,7,4,4,7,5,5,0,1,0,0,19,19,6,5,2,1,1,0,0,1,0,0,10,540233,1049,10,3,-3,0,-1,0,0,1,1
KR_7759897309,14971,18322,218,259,6,12,12,6,7,15,0,0,0,0,19,19,2,0,0,1,0,1,0,0,0,0,10,540225,-3351,-41,-6,6,-8,0,0,0,2,-1
KR_7759904157,16586,14329,262,262,9,4,4,9,9,2,0,0,0,0,15,16,3,4,3,0,1,0,0,0,0,0,10,540244,2257,0,5,-5,7,0,0,-1,-1,3
KR_7759906380,16051,15289,255,244,8,6,6,8,8,5,0,0,0,0,95,20,4,4,2,0,1,0,0,0,0,0,10,540241,762,11,2,-2,3,0,0,75,0,2
KR_7759909201,16934,14319,276,251,9,4,4,9,8,4,0,0,0,0,16,113,4,1,2,0,0,1,0,0,0,0,10,540206,2615,25,5,-5,4,0,0,-97,3,2
KR_7759916590,15714,13764,235,280,8,1,1,8,10,1,0,0,0,0,20,17,2,3,2,2,1,0,0,0,0,0,10,540213,1950,-45,7,-7,9,0,0,3,-1,0
KR_7759933649,14128,17869,233,264,3,12,12,3,4,11,0,0,0,0,14,16,2,1,0,1,0,1,0,0,0,0,10,540236,-3741,-31,-9,9,-7,0,0,-2,1,-1
KR_7759937102,13894,15494,282,272,1,6,6,1,2,3,0,0,0,0,16,21,4,1,0,2,0,1,0,0,0,0,10,540167,-1600,10,-5,5,-1,0,0,-5,3,-2
KR_7759942089,14798,17531,279,312,3,8,8,3,3,13,0,0,0,0,16,103,2,3,0,1,0,1,0,0,0,0,10,540107,-2733,-33,-5,5,-10,0,0,-87,-1,-1
KR_7759947986,16821,15137,260,265,10,5,5,10,11,5,1,0,0,0,16,15,1,0,0,0,1,0,1,0,0,0,10,540236,1684,-5,5,-5,6,1,0,1,1,0
KR_7759949610,13343,16720,184,237,5,12,12,5,7,8,0,0,0,0,12,15,4,2,1,0,0,1,0,0,0,0,10,540255,-3377,-53,-7,7,-1,0,0,-3,2,1
KR_7759957988,14968,16268,265,288,4,6,6,4,5,8,0,1,0,0,17,16,0,5,0,1,0,1,0,1,0,0,10,540265,-1300,-23,-2,2,-3,-1,0,1,-5,-1
KR_7759965403,16937,17565,223,245,10,11,11,10,14,16,0,0,0,0,13,14,2,0,1,1,1,0,0,0,0,0,10,540247,-628,-22,-1,1,-2,0,0,-1,2,0
KR_7759966348,14352,16396,251,268,3,7,7,4,2,9,0,0,0,0,17,104,2,3,1,2,0,1,0,0,0,0,10,540247,-2044,-17,-4,3,-7,0,0,-87,-1,-1
KR_7759967917,14545,17534,245,274,3,11,11,3,2,7,0,1,0,0,16,106,2,3,1,0,0,1,0,1,0,0,10,540194,-2989,-29,-8,8,-5,-1,0,-90,-1,1
KR_7759968592,14137,16757,272,291,3,6,6,3,1,11,0,0,0,0,16,152,5,1,1,0,1,0,0,0,0,0,10,540239,-2620,-19,-3,3,-10,0,0,-136,4,1
KR_7759976764,13489,15631,243,244,2,8,8,2,3,16,0,1,0,0,16,17,3,4,0,0,0,1,0,1,0,0,10,540240,-2142,-1,-6,6,-13,-1,0,-1,-1,0
KR_7759998637,14333,16385,255,313,4,4,4,4,3,4,0,1,0,0,17,110,3,6,0,2,1,0,0,1,0,0,10,540243,-2052,-58,0,0,-1,-1,0,-93,-3,-2
KR_7760008934,14001,15518,238,265,4,7,7,4,3,7,0,0,0,0,36,15,3,1,0,0,0,1,0,0,0,0,10,540243,-1517,-27,-3,3,-4,0,0,21,2,0
KR_7760010580,14608,16011,245,257,3,8,8,4,7,8,0,0,0,0,31,52,2,2,1,0,0,1,0,0,0,0,10,540236,-1403,-12,-5,4,-1,0,0,-21,0,1
KR_7760025234,16059,17353,215,232,10,13,13,10,10,7,0,1,0,0,59,15,0,3,2,4,1,0,0,1,0,0,10,540250,-1294,-17,-3,3,3,-1,0,44,-3,-2
KR_7760030262,14281,14570,265,254,3,5,5,3,1,4,0,0,0,0,17,18,4,2,2,0,1,0,0,0,0,0,10,540254,-289,11,-2,2,-3,0,0,-1,2,2
KR_7760032628,17732,17841,252,259,10,12,12,10,16,13,0,1,0,0,23,17,3,4,1,2,1,0,0,1,0,0,10,540237,-109,-7,-2,2,3,-1,0,6,-1,-1
KR_7760039837,15837,15898,275,264,7,5,5,7,8,6,1,0,0,0,37,37,6,4,0,2,1,0,1,0,0,0,10,540255,-61,11,2,-2,2,1,0,0,2,-2
KR_7760040027,16664,16299,271,240,7,8,8,7,8,13,0,1,0,0,16,18,5,4,5,2,0,1,0,1,0,0,10,540259,365,31,-1,1,-5,-1,0,-2,1,3
KR_7760040412,14680,14364,265,261,4,4,4,4,4,2,0,0,0,0,12,17,2,2,1,0,1,0,0,0,0,0,10,540256,316,4,0,0,2,0,0,-5,0,1
KR_7760045703,15524,15745,290,280,5,5,5,5,3,8,0,0,0,0,18,51,8,1,0,1,0,1,0,0,0,0,10,540266,-221,10,0,0,-5,0,0,-33,7,-1
KR_7760051165,14347,16963,252,257,4,9,9,4,7,12,0,0,0,0,16,18,2,3,0,0,1,0,0,0,0,0,10,540195,-2616,-5,-5,5,-5,0,0,-2,-1,0
KR_7760053754,15901,17423,258,270,8,9,9,8,6,9,0,0,0,0,14,32,2,2,1,1,0,1,0,0,0,0,10,540247,-1522,-12,-1,1,-3,0,0,-18,0,0
KR_7760056466,15869,14873,282,295,5,2,2,5,9,2,1,0,0,0,20,17,0,1,0,3,1,0,1,0,0,0,10,540200,996,-13,3,-3,7,1,0,3,-1,-3
KR_7760066636,13850,15345,277,275,1,4,4,1,3,7,0,0,0,0,19,113,0,5,0,1,0,1,0,0,0,0,10,540270,-1495,2,-3,3,-4,0,0,-94,-5,-1
KR_7760074186,13495,15091,240,278,2,4,4,2,3,4,0,0,0,0,15,13,1,5,0,1,0,1,0,0,0,0,10,540259,-1596,-38,-2,2,-1,0,0,2,-4,-1
KR_7760075455,17074,15241,297,239,8,7,7,8,6,7,0,0,0,0,15,14,1,3,2,0,1,0,0,0,0,0,10,540204,1833,58,1,-1,-1,0,0,1,-2,2
KR_7760079694,16094,14664,267,229,7,6,6,7,8,3,0,0,0,0,14,14,3,2,0,0,1,0,0,0,0,0,10,540250,1430,38,1,-1,5,0,0,0,1,0
KR_7760080552,14881,15685,281,211,4,9,9,4,5,8,0,1,0,0,175,12,0,4,0,0,0,1,0,1,0,0,10,540223,-804,70,-5,5,-3,-1,0,163,-4,0
KR_7760086430,17513,13584,262,290,11,0,1,11,13,0,0,0,0,0,16,17,4,5,1,1,1,0,0,0,0,0,10,540239,3929,-28,11,-10,13,0,0,-1,-1,0
KR_7760091172,17108,15673,251,239,10,9,9,11,13,3,0,0,0,0,15,125,4,2,0,1,1,0,0,0,0,0,10,540228,1435,12,1,-2,10,0,0,-110,2,-1
KR_7760104344,13506,15473,219,271,3,5,5,3,5,8,0,1,0,0,14,20,3,5,0,1,0,1,0,1,0,0,10,540197,-1967,-52,-2,2,-3,-1,0,-6,-2,-1
KR_7760109229,16969,14187,294,280,7,2,2,7,10,4,0,0,0,0,40,14,3,5,1,1,0,1,0,0,0,0,10,540206,2782,14,5,-5,6,0,0,26,-2,0
KR_7760109468,15575,16504,250,276,6,8,8,6,5,12,0,1,0,0,17,14,1,9,1,0,1,0,0,1,0,0,10,540214,-929,-26,-2,2,-7,-1,0,3,-8,1
KR_7760109918,15369,15597,282,280,5,5,5,5,10,6,0,0,0,0,13,15,2,5,0,0,0,1,0,0,0,0,10,540274,-228,2,0,0,4,0,0,-2,-3,0
KR_7760112381,14982,14717,269,261,5,4,4,5,3,4,0,1,0,0,32,15,0,6,1,2,1,0,0,1,0,0,10,540221,265,8,1,-1,-1,-1,0,17,-6,-1
KR_7760115304,15244,13876,268,261,4,2,2,4,4,1,1,0,0,0,42,13,2,2,3,0,1,0,1,0,0,0,10,540193,1368,7,2,-2,3,1,0,29,0,3
KR_7760116184,16855,14802,293,259,6,5,5,6,8,5,0,1,0,0,121,16,4,2,1,0,0,1,0,1,0,0,10,540272,2053,34,1,-1,3,-1,0,105,2,1
KR_7760119941,15164,15634,288,282,4,5,5,4,2,6,0,0,0,0,23,35,4,3,0,1,1,0,0,0,0,0,10,540178,-470,6,-1,1,-4,0,0,-12,1,-1
KR_7760123618,13737,15854,220,277,4,6,6,4,4,6,0,0,0,0,14,44,4,4,0,0,0,1,0,0,0,0,10,540238,-2117,-57,-2,2,-2,0,0,-30,0,0
KR_7760130475,15982,14595,276,267,6,3,3,6,8,4,0,0,0,0,17,15,0,0,1,0,0,1,0,0,0,0,10,540233,1387,9,3,-3,4,0,0,2,0,1
KR_7760132492,17725,17622,285,265,11,10,10,11,10,10,0,0,0,0,18,18,4,7,0,0,1,0,0,0,0,0,10,540235,103,20,1,-1,0,0,0,0,-3,0
KR_7760134021,14207,14862,256,280,3,3,3,3,5,2,0,1,0,0,13,34,1,2,1,1,0,1,0,1,0,0,10,540274,-655,-24,0,0,3,-1,0,-21,-1,0
KR_7760137114,15378,15847,249,244,7,6,6,7,3,8,0,0,0,0,16,21,3,4,1,3,1,0,0,0,0,0,10,540188,-469,5,1,-1,-5,0,0,-5,-1,-2
KR_7760140565,16011,15230,295,291,5,5,5,5,9,4,1,0,0,0,33,15,4,6,2,0,1,0,1,0,0,0,10,540229,781,4,0,0,5,1,0,18,-2,2
KR_7760149745,15632,16272,260,249,7,7,7,7,5,14,0,1,0,0,20,21,4,4,0,1,1,0,0,1,0,0,10,540267,-640,11,0,0,-9,-1,0,-1,0,-1
KR_7760151512,16425,15497,246,234,9,6,6,9,8,9,1,0,0,0,36,15,2,2,2,1,0,1,1,0,0,0,10,540225,928,12,3,-3,-1,1,0,21,0,1
KR_7760154735,15995,15374,287,295,6,4,4,6,5,6,0,0,0,0,19,19,8,3,1,0,1,0,0,0,0,0,10,540190,621,-8,2,-2,-1,0,0,0,5,1
KR_7760160566,16612,14120,297,253,7,2,2,7,10,4,0,1,0,0,20,17,4,2,0,0,1,0,0,1,0,0,10,540222,2492,44,5,-5,6,-1,0,3,2,0
KR_7760165338,14810,13891,293,250,3,3,3,3,2,3,0,0,0,0,19,33,3,3,0,0,0,1,0,0,0,0,10,540242,919,43,0,0,-1,0,0,-14,0,0
KR_7760170322,15507,13177,271,249,6,2,3,6,10,1,0,0,0,0,121,13,2,7,0,0,1,0,0,0,0,0,10,540238,2330,22,4,-3,9,0,0,108,-5,0
KR_7760170816,14538,16290,264,251,5,8,8,5,6,7,0,0,0,0,15,15,4,6,0,0,1,0,0,0,0,0,10,540248,-1752,13,-3,3,-1,0,0,0,-2,0
KR_7760173552,14775,17132,240,282,5,9,9,5,2,9,0,0,0,0,106,17,1,1,0,1,0,1,0,0,0,0,10,540199,-2357,-42,-4,4,-7,0,0,89,0,-1
KR_7760174229,15378,14715,283,274,5,3,3,5,4,4,0,0,0,0,36,16,4,7,1,0,1,0,0,0,0,0,10,540214,663,9,2,-2,0,0,0,20,-3,1
KR_7760177908,15106,14804,238,247,6,5,5,6,5,8,0,1,0,0,15,26,6,2,0,1,1,0,0,1,0,0,10,540222,302,-9,1,-1,-3,-1,0,-11,4,-1
KR_7760178259,15150,14492,294,262,3,4,4,3,2,4,0,1,0,0,15,12,1,2,0,0,0,1,0,1,0,0,10,540215,658,32,-1,1,-2,-1,0,3,-1,0
KR_7760180727,15808,15420,276,281,7,4,4,7,6,3,1,0,0,0,14,20,2,6,0,2,1,0,1,0,0,0,10,540231,388,-5,3,-3,3,1,0,-6,-4,-2
KR_7760182573,17065,15295,256,286,10,3,3,10,14,2,0,0,0,0,19,13,5,0,1,1,1,0,0,0,0,0,10,540241,1770,-30,7,-7,12,0,0,6,5,0
KR_7760185987,14650,15285,225,275,6,4,4,6,6,4,1,0,0,0,34,34,3,2,0,1,1,0,1,0,0,0,10,540258,-635,-50,2,-2,2,1,0,0,1,-1
KR_7760192183,14556,15193,276,272,3,6,6,3,6,4,0,0,0,0,25,11,2,3,0,0,0,1,0,0,0,0,10,540191,-637,4,-3,3,2,0,0,14,-1,0
KR_7760203002,13735,14026,245,265,3,3,4,3,3,3,0,0,0,0,12,35,20,2,0,0,1,0,0,0,0,0,10,540205,-291,-20,0,1,0,0,0,-23,18,0
KR_7760203695,15168,15380,250,285,6,4,4,6,9,8,0,0,0,0,16,21,1,5,0,0,0,1,0,0,0,0,10,540233,-212,-35,2,-2,1,0,0,-5,-4,0
KR_7760211313,13650,17861,227,276,4,11,11,4,2,8,0,0,0,0,38,107,1,2,0,1,0,1,0,0,0,0,10,540225,-4211,-49,-7,7,-6,0,0,-69,-1,-1
KR_7760212444,15846,15451,264,242,7,7,7,7,8,12,0,0,0,0,13,17,1,1,2,0,1,0,0,0,0,0,10,540199,395,22,0,0,-4,0,0,-4,0,2
KR_7760216327,14241,16943,252,288,4,8,8,4,2,8,0,0,0,0,116,28,3,3,0,2,0,1,0,0,0,0,10,540187,-2702,-36,-4,4,-6,0,0,88,0,-2
KR_7760226143,16253,15724,276,251,6,7,7,6,7,8,0,0,0,0,20,29,7,4,0,0,0,1,0,0,0,0,10,540219,529,25,-1,1,-1,0,0,-9,3,0
KR_7760226389,15265,14587,297,296,4,2,2,5,5,3,0,0,0,0,15,14,2,5,0,1,1,0,0,0,0,0,10,540177,678,1,2,-3,2,0,0,1,-3,-1
KR_7760226974,16943,14566,251,256,10,5,5,10,7,4,0,0,0,0,16,101,0,2,3,0,0,1,0,0,0,0,10,540195,2377,-5,5,-5,3,0,0,-85,-2,3
KR_7760230833,16458,17740,247,256,7,11,11,7,9,9,0,1,0,0,14,20,5,0,1,2,0,1,0,1,0,0,10,540262,-1282,-9,-4,4,0,-1,0,-6,5,-1
KR_7760234841,18706,13256,268,250,13,1,1,13,16,1,0,1,0,0,20,35,2,2,3,0,1,0,0,1,0,0,10,540210,5450,18,12,-12,15,-1,0,-15,0,3
KR_7760240200,13013,16462,201,222,2,12,12,2,3,9,0,0,0,0,20,9,2,3,0,2,0,1,0,0,0,0,10,540214,-3449,-21,-10,10,-6,0,0,11,-1,-2
KR_7760242420,14996,14994,267,279,4,5,5,4,4,4,0,1,0,0,19,40,3,1,0,0,0,1,0,1,0,0,10,540251,2,-12,-1,1,0,-1,0,-21,2,0
KR_7760253493,15747,15440,262,260,6,6,6,6,4,9,0,0,0,0,31,18,3,7,2,0,1,0,0,0,0,0,10,540250,307,2,0,0,-5,0,0,13,-4,2
KR_7760253837,16667,15211,269,248,8,5,5,8,7,7,0,0,0,0,20,16,4,4,1,0,1,0,0,0,0,0,10,540194,1456,21,3,-3,0,0,0,4,0,1
KR_7760259000,14620,16279,236,252,5,7,7,5,5,7,0,0,0,0,144,12,1,5,1,1,0,1,0,0,0,0,10,540212,-1659,-16,-2,2,-2,0,0,132,-4,0
KR_7760260239,15442,15627,222,271,8,6,6,8,7,7,0,0,0,0,17,15,2,2,0,1,1,0,0,0,0,0,10,540210,-185,-49,2,-2,0,0,0,2,0,-1
KR_7760261968,16572,16055,263,282,8,5,5,8,11,8,0,0,0,0,104,40,2,4,0,1,0,1,0,0,0,0,10,540231,517,-19,3,-3,3,0,0,64,-2,-1
KR_7760262795,16473,14248,259,258,10,3,3,10,9,3,0,0,0,0,35,15,1,0,1,1,1,0,0,0,0,0,10,540258,2225,1,7,-7,6,0,0,20,1,0
KR_7760263201,16240,14801,266,284,7,2,2,7,7,3,0,0,0,0,16,19,2,4,2,0,0,1,0,0,0,0,10,540212,1439,-18,5,-5,4,0,0,-3,-2,2
KR_7760267444,14693,13882,280,278,4,2,2,4,4,0,0,0,0,0,110,17,5,4,0,1,1,0,0,0,0,0,10,540203,811,2,2,-2,4,0,0,93,1,-1
KR_7760268807,14261,14756,271,286,3,3,3,3,3,5,0,0,0,0,27,103,5,2,0,0,1,0,0,0,0,0,10,540286,-495,-15,0,0,-2,0,0,-76,3,0
KR_7760271018,15139,14352,295,290,4,2,2,4,5,1,0,0,0,0,18,16,3,1,1,0,1,0,0,0,0,0,10,540246,787,5,2,-2,4,0,0,2,2,1
KR_7760282318,14397,15460,242,271,5,5,5,5,2,6,0,0,0,0,22,14,1,3,2,1,1,0,0,0,0,0,10,540241,-1063,-29,0,0,-4,0,0,8,-2,1
KR_7760287171,15453,16667,259,261,5,8,8,5,6,14,0,0,0,0,20,13,0,4,1,1,1,0,0,0,0,0,10,540245,-1214,-2,-3,3,-8,0,0,7,-4,0
KR_7760288702,16713,14588,263,271,10,4,4,10,13,2,1,0,0,0,13,15,4,2,0,1,1,0,1,0,0,0,10,540250,2125,-8,6,-6,11,1,0,-2,2,-1
KR_7760293088,16903,17313,234,259,9,10,10,9,13,8,0,0,0,0,18,17,0,2,0,2,1,0,0,0,0,0,10,540232,-410,-25,-1,1,5,0,0,1,-2,-2
KR_7760296754,17263,15403,266,224,8,8,8,8,10,8,0,0,0,0,17,16,6,2,1,0,0,1,0,0,0,0,10,540212,1860,42,0,0,2,0,0,1,4,1
KR_7760302105,16231,13851,282,297,7,1,1,7,9,2,0,0,0,0,17,16,6,4,1,0,1,0,0,0,0,0,10,540214,2380,-15,6,-6,7,0,0,1,2,1
KR_7760302962,14513,18415,245,252,5,13,13,5,3,18,1,0,0,0,154,143,1,4,0,1,0,1,1,0,0,0,10,540226,-3902,-7,-8,8,-15,1,0,11,-3,-1
KR_7760306714,16512,15456,294,275,6,6,6,6,6,9,0,0,0,0,31,15,3,3,2,1,0,1,0,0,0,0,10,540276,1056,19,0,0,-3,0,0,16,0,1
KR_7760315765,17759,14134,240,218,15,4,4,15,8,5,0,0,0,0,14,12,0,0,0,0,1,0,0,0,0,0,10,540247,3625,22,11,-11,3,0,0,2,0,0
KR_7760323534,14810,16928,252,262,6,9,9,6,5,14,0,1,0,0,11,19,1,3,2,2,1,0,0,1,0,0,10,540196,-2118,-10,-3,3,-9,-1,0,-8,-2,0
KR_7760324917,16332,14523,310,292,6,2,2,6,8,4,1,0,0,0,19,17,7,3,0,0,0,1,1,0,0,0,10,540219,1809,18,4,-4,4,1,0,2,4,0
KR_7760335968,15784,13543,266,262,6,2,2,6,7,1,0,1,0,0,14,16,2,3,0,0,0,1,0,1,0,0,10,540236,2241,4,4,-4,6,-1,0,-2,-1,0
KR_7760339521,15021,13909,271,226,4,4,4,4,5,6,0,0,0,0,26,14,0,5,3,0,0,1,0,0,0,0,10,540177,1112,45,0,0,-1,0,0,12,-5,3
KR_7760344100,14865,17148,248,264,6,9,9,6,4,9,0,0,0,0,34,19,6,2,0,2,0,1,0,0,0,0,10,540214,-2283,-16,-3,3,-5,0,0,15,4,-2
KR_7760348835,15429,13841,274,234,5,4,4,5,3,3,0,0,0,0,30,10,4,3,1,0,0,1,0,0,0,0,10,540170,1588,40,1,-1,0,0,0,20,1,1
KR_7760383138,16557,15952,298,273,6,7,7,6,6,4,1,0,0,0,19,26,4,5,0,2,0,1,1,0,0,0,10,540195,605,25,-1,1,2,1,0,-7,-1,-2
KR_7760386398,18568,17679,302,289,10,9,9,10,19,8,0,1,0,0,15,35,5,0,1,1,1,0,0,1,0,0,10,540199,889,13,1,-1,11,-1,0,-20,5,0
KR_7760398920,17648,14562,265,238,11,4,4,11,8,2,0,0,0,0,18,12,3,1,1,1,1,0,0,0,0,0,10,540102,3086,27,7,-7,6,0,0,6,2,0
KR_7760417556,15009,15905,264,228,5,8,9,5,8,8,0,0,0,0,13,17,2,2,0,0,1,0,0,0,0,0,10,540210,-896,36,-3,4,0,0,0,-4,0,0
KR_7760429360,14316,14889,275,259,3,5,5,3,3,6,0,1,0,0,13,17,3,4,0,0,1,0,0,1,0,0,10,540197,-573,16,-2,2,-3,-1,0,-4,-1,0
KR_7760432879,14253,14680,230,262,4,4,4,4,5,7,0,0,0,0,14,14,5,3,0,0,0,1,0,0,0,0,10,540187,-427,-32,0,0,-2,0,0,0,2,0
KR_7760455143,15476,14425,248,274,6,3,3,6,9,5,0,1,0,0,13,19,2,2,0,0,1,0,0,1,0,0,10,540219,1051,-26,3,-3,4,-1,0,-6,0,0
KR_7760468292,16004,16133,236,209,8,9,9,8,9,13,1,0,0,0,17,31,1,2,1,1,0,1,1,0,0,0,10,540269,-129,27,-1,1,-4,1,0,-14,-1,0
KR_7760471666,16823,13681,264,257,10,2,2,10,12,2,0,0,0,0,23,221,2,1,2,0,1,0,0,0,0,0,10,540198,3142,7,8,-8,10,0,0,-198,1,2
KR_7760476882,16389,15374,252,243,8,7,7,8,11,5,0,1,0,0,15,13,4,2,2,3,0,1,0,1,0,0,10,540220,1015,9,1,-1,6,-1,0,2,2,-1
KR_7760490680,16763,17216,260,269,8,10,10,8,11,16,0,1,0,0,16,27,5,4,0,0,0,1,0,1,0,0,10,540271,-453,-9,-2,2,-5,-1,0,-11,1,0
KR_7760496565,2719,2619,6,2,0,0,0,0,0,0,0,0,0,0,1,3,0,0,0,0,0,0,0,0,0,0,3,107240,100,4,0,0,0,0,0,-2,0,0
KR_7760503427,14548,17204,197,263,6,14,14,7,9,7,0,0,0,0,9,16,4,1,1,2,0,1,0,0,0,0,10,540253,-2656,-66,-8,7,2,0,0,-7,3,-1
KR_7760524859,16383,13174,305,256,6,1,1,6,6,2,1,0,0,0,17,18,8,3,1,0,1,0,1,0,0,0,10,540214,3209,49,5,-5,4,1,0,-1,5,1
KR_7760547337,14899,16142,251,252,5,8,8,5,5,4,0,0,0,0,13,30,1,3,1,2,1,0,0,0,0,0,10,540216,-1243,-1,-3,3,1,0,0,-17,-2,-1
KR_7760552961,15242,14250,229,246,8,3,3,8,9,3,0,0,0,0,32,12,2,1,0,1,0,1,0,0,0,0,10,540205,992,-17,5,-5,6,0,0,20,1,-1
KR_7760553721,15079,15843,239,243,6,7,7,6,12,11,0,1,0,0,14,13,2,3,0,1,0,1,0,1,0,0,10,540236,-764,-4,-1,1,1,-1,0,1,-1,-1
KR_7760578589,14769,15037,278,237,4,6,6,4,3,6,0,0,0,0,16,19,2,3,0,0,0,1,0,0,0,0,10,540274,-268,41,-2,2,-3,0,0,-3,-1,0
KR_7760579814,14606,15841,204,285,6,6,6,6,6,4,0,0,0,0,13,19,3,2,0,0,1,0,0,0,0,0,10,540215,-1235,-81,0,0,2,0,0,-6,1,0
KR_7760600313,15588,14754,299,270,4,4,4,4,4,3,0,1,0,0,16,9,2,3,2,0,0,1,0,1,0,0,10,540223,834,29,0,0,1,-1,0,7,-1,2
KR_7760611734,14358,16371,265,248,3,7,7,3,2,13,1,0,0,0,16,17,2,7,1,0,0,1,1,0,0,0,10,540250,-2013,17,-4,4,-11,1,0,-1,-5,1
KR_7760619832,15949,15692,260,220,5,10,10,5,9,8,0,0,0,0,15,15,3,2,2,1,0,1,0,0,0,0,10,540119,257,40,-5,5,1,0,0,0,1,1
KR_7760623538,15842,15581,279,260,6,5,5,6,9,8,0,0,0,0,15,13,2,3,2,1,1,0,0,0,0,0,10,540153,261,19,1,-1,1,0,0,2,-1,1
KR_7760630951,12863,16019,234,264,1,6,6,1,1,6,0,1,0,0,11,14,2,2,0,2,0,1,0,1,0,0,10,540247,-3156,-30,-5,5,-5,-1,0,-3,0,-2
KR_7760647887,14972,14144,253,220,5,4,4,5,4,8,1,0,0,0,59,14,3,3,1,0,1,0,1,0,0,0,10,540299,828,33,1,-1,-4,1,0,45,0,1
KR_7760648808,14229,16081,272,265,2,8,8,2,2,7,0,0,0,0,13,14,3,3,1,0,0,1,0,0,0,0,10,540264,-1852,7,-6,6,-5,0,0,-1,0,1
KR_7760658890,14165,16785,242,269,3,8,8,3,3,8,0,1,0,0,14,24,1,3,0,2,0,1,0,1,0,0,10,540165,-2620,-27,-5,5,-5,-1,0,-10,-2,-2
KR_7760681670,13611,17207,224,277,3,8,8,4,5,10,0,1,0,0,18,44,5,1,0,0,1,0,0,1,0,0,10,540257,-3596,-53,-5,4,-5,-1,0,-26,4,0
KR_7760685507,15243,14768,253,250,5,5,5,5,9,3,0,0,0,0,12,33,5,1,0,1,0,1,0,0,0,0,10,540236,475,3,0,0,6,0,0,-21,4,-1
KR_7760685643,2920,2530,0,1,1,0,0,1,3,0,0,0,0,0,2,1,0,1,0,0,1,0,0,0,0,0,3,100565,390,-1,1,-1,3,0,0,1,-1,0
KR_7760723264,13912,13783,266,262,2,2,2,2,4,2,0,0,0,0,16,12,2,2,0,0,0,1,0,0,0,0,10,540232,129,4,0,0,2,0,0,4,0,0
KR_7760736043,16557,17133,256,246,9,8,8,9,7,9,0,1,0,0,16,16,2,3,0,2,1,0,0,1,0,0,10,540258,-576,10,1,-1,-2,-1,0,0,-1,-2
KR_7760747320,14872,15039,240,264,5,6,6,5,7,4,0,0,0,0,14,15,4,5,1,1,1,0,0,0,0,0,10,540218,-167,-24,-1,1,3,0,0,-1,-1,0
KR_7760748727,16671,15116,244,232,10,6,6,10,9,10,0,0,0,0,44,15,2,2,1,0,1,0,0,0,0,0,10,540229,1555,12,4,-4,-1,0,0,29,0,1
KR_7760779938,15028,13823,250,265,5,2,2,5,7,1,1,0,0,0,17,11,2,2,2,1,1,0,1,0,0,0,10,540220,1205,-15,3,-3,6,1,0,6,0,1
KR_7760783662,15086,14482,257,268,4,3,3,4,5,6,0,1,0,0,15,56,1,2,1,0,0,1,0,1,0,0,10,540251,604,-11,1,-1,-1,-1,0,-41,-1,1
KR_7760783907,16181,14729,254,238,8,6,6,8,8,10,0,0,0,0,21,38,6,3,2,0,1,0,0,0,0,0,10,540227,1452,16,2,-2,-2,0,0,-17,3,2
KR_7760795373,15458,13512,265,243,7,3,3,7,7,2,0,1,0,0,21,15,0,3,0,0,1,0,0,1,0,0,10,540249,1946,22,4,-4,5,-1,0,6,-3,0
KR_7760805578,14713,15210,298,258,3,5,5,3,0,5,0,0,0,0,24,20,7,5,1,0,1,0,0,0,0,0,10,540217,-497,40,-2,2,-5,0,0,4,2,1
KR_7760813534,15992,13967,236,251,9,3,3,9,12,2,1,0,0,0,23,21,2,4,0,2,0,1,1,0,0,0,10,540264,2025,-15,6,-6,10,1,0,2,-2,-2
KR_7760831197,17743,13269,290,254,10,1,1,10,19,2,0,0,0,0,15,37,5,2,2,0,1,0,0,0,0,0,10,540104,4474,36,9,-9,17,0,0,-22,3,2
KR_7760834481,14141,16069,274,247,2,9,9,2,4,8,0,1,0,0,24,14,3,6,0,1,0,1,0,1,0,0,10,540254,-1928,27,-7,7,-4,-1,0,10,-3,-1
KR_7760835146,17041,16632,242,245,12,9,9,13,8,9,0,0,0,0,9,17,3,0,2,0,0,1,0,0,0,0,10,540236,409,-3,3,-4,-1,0,0,-8,3,2
KR_7760847749,15559,14783,259,234,6,6,6,6,5,6,0,0,0,0,17,14,0,3,1,0,0,1,0,0,0,0,10,540201,776,25,0,0,-1,0,0,3,-3,1
KR_7760851422,15025,16177,282,281,3,8,8,3,3,4,0,1,0,0,18,18,1,0,1,0,1,0,0,1,0,0,10,540216,-1152,1,-5,5,-1,-1,0,0,1,1
KR_7760864343,14622,14510,249,262,5,4,4,5,5,2,0,0,0,0,16,11,1,2,0,1,0,1,0,0,0,0,10,540246,112,-13,1,-1,3,0,0,5,-1,-1
KR_7760866351,15332,17938,231,272,7,10,10,7,9,10,0,0,0,0,18,114,3,2,0,3,0,1,0,0,0,0,10,540253,-2606,-41,-3,3,-1,0,0,-96,1,-3
KR_7760866537,15526,14803,312,294,4,3,3,4,4,3,0,0,0,0,18,17,6,6,1,0,0,1,0,0,0,0,10,540285,723,18,1,-1,1,0,0,1,0,1
KR_7760868545,15813,15045,248,255,8,6,6,8,9,1,0,1,0,0,16,18,2,3,1,4,1,0,0,1,0,0,10,540226,768,-7,2,-2,8,-1,0,-2,-1,-3
KR_7760879367,14293,19872,248,296,5,14,14,6,3,17,1,0,0,0,12,19,3,1,0,5,0,1,1,0,0,0,10,540244,-5579,-48,-9,8,-14,1,0,-7,2,-5
KR_7760888172,13754,14488,247,260,2,4,4,2,1,6,0,1,0,0,14,22,2,3,1,1,0,1,0,1,0,0,10,540243,-734,-13,-2,2,-5,-1,0,-8,-1,0
KR_7760891014,15373,15133,275,265,6,5,5,6,5,6,0,0,0,0,18,16,4,2,2,1,1,0,0,0,0,0,10,540230,240,10,1,-1,-1,0,0,2,2,1
KR_7760892418,15395,13757,262,263,6,2,2,6,7,2,0,0,0,0,16,13,3,5,0,0,0,1,0,0,0,0,10,540204,1638,-1,4,-4,5,0,0,3,-2,0
KR_7760904583,14857,14327,266,277,4,3,3,4,8,4,0,1,0,0,12,15,4,2,0,0,0,1,0,1,0,0,10,540262,530,-11,1,-1,4,-1,0,-3,2,0
KR_7760916899,14497,14182,244,263,4,3,3,4,6,4,0,0,0,0,14,35,2,1,1,1,1,0,0,0,0,0,10,540235,315,-19,1,-1,2,0,0,-21,1,0
KR_7760924041,15247,13841,280,286,4,1,1,4,6,2,0,0,0,0,36,16,3,5,1,0,1,0,0,0,0,0,10,540273,1406,-6,3,-3,4,0,0,20,-2,1
KR_7760927235,14700,15704,271,284,3,6,6,3,6,11,0,1,0,0,15,14,3,5,0,1,0,1,0,1,0,0,10,540202,-1004,-13,-3,3,-5,-1,0,1,-2,-1
KR_7760927421,16174,13766,252,225,8,4,4,8,5,3,0,0,0,0,22,17,1,0,3,0,1,0,0,0,0,0,10,540255,2408,27,4,-4,2,0,0,5,1,3
KR_7760934325,15650,15780,268,281,6,6,6,6,5,10,0,0,0,0,16,16,4,2,1,0,0,1,0,0,0,0,10,540260,-130,-13,0,0,-5,0,0,0,2,1
KR_7760943553,16182,13827,270,229,6,4,4,6,5,8,0,1,0,0,131,34,3,2,0,0,1,0,0,1,0,0,10,540240,2355,41,2,-2,-3,-1,0,97,1,0
KR_7760944202,13772,14472,293,280,1,3,3,1,0,3,0,0,0,0,24,16,5,7,0,0,0,1,0,0,0,0,10,540258,-700,13,-2,2,-3,0,0,8,-2,0
KR_7760945624,16409,15230,270,245,8,6,6,8,10,10,0,0,0,0,14,15,3,5,0,0,1,0,0,0,0,0,10,540219,1179,25,2,-2,0,0,0,-1,-2,0
KR_7760950561,15149,15931,242,265,6,6,7,6,6,8,0,0,0,0,17,26,3,3,0,0,1,0,0,0,0,0,10,540257,-782,-23,0,1,-2,0,0,-9,0,0
KR_7760962245,14238,13815,301,296,2,1,1,2,1,1,0,1,0,0,17,15,3,3,0,0,1,0,0,1,0,0,10,540204,423,5,1,-1,0,-1,0,2,0,0
KR_7760965951,13557,16141,243,244,2,8,8,2,3,15,0,1,0,0,15,17,3,2,0,1,1,0,0,1,0,0,10,540276,-2584,-1,-6,6,-12,-1,0,-2,1,-1
KR_7760970985,14505,16105,264,273,3,6,6,3,4,6,1,0,0,0,15,36,5,3,0,1,0,1,1,0,0,0,10,540199,-1600,-9,-3,3,-2,1,0,-21,2,-1
KR_7760980693,15643,14054,283,254,4,3,3,4,3,8,0,1,0,0,15,30,2,1,1,0,0,1,0,1,0,0,10,540232,1589,29,1,-1,-5,-1,0,-15,1,1
KR_7760985201,13564,16629,214,272,3,9,9,3,1,6,0,1,0,0,9,22,0,1,0,1,0,1,0,1,0,0,10,540225,-3065,-58,-6,6,-5,-1,0,-13,-1,-1
KR_7760985906,14803,13763,286,260,4,3,3,4,2,2,0,0,0,0,41,16,4,4,1,0,0,1,0,0,0,0,10,540167,1040,26,1,-1,0,0,0,25,0,1
KR_7761005403,15081,16285,214,289,8,6,6,8,12,6,1,0,0,0,18,27,4,3,1,1,1,0,1,0,0,0,10,540233,-1204,-75,2,-2,6,1,0,-9,1,0
KR_7761008469,14403,14723,319,257,1,5,5,1,1,3,1,0,0,0,18,12,2,3,0,0,0,1,1,0,0,0,10,540255,-320,62,-4,4,-2,1,0,6,-1,0
KR_7761017699,15998,14168,288,253,5,3,3,5,9,2,0,1,0,0,35,38,3,4,0,1,0,1,0,1,0,0,10,540249,1830,35,2,-2,7,-1,0,-3,-1,-1
KR_7761024668,15452,15719,249,247,6,7,7,6,3,10,0,1,0,0,86,15,2,7,0,0,0,1,0,1,0,0,10,540240,-267,2,-1,1,-7,-1,0,71,-5,0
KR_7761031719,13374,16222,212,247,4,10,10,4,3,7,0,1,0,0,14,16,2,2,1,2,1,0,0,1,0,0,10,540250,-2848,-35,-6,6,-4,-1,0,-2,0,-1
KR_7761052072,14952,15476,283,268,4,4,4,4,3,7,0,0,0,0,19,17,2,4,2,1,1,0,0,0,0,0,10,540260,-524,15,0,0,-4,0,0,2,-2,1
KR_7761061811,16022,15287,226,245,10,6,6,10,11,3,0,0,0,0,15,13,2,2,0,2,1,0,0,0,0,0,10,540217,735,-19,4,-4,8,0,0,2,0,-2
KR_7761065320,16383,14687,270,284,7,3,3,7,8,7,0,0,0,0,17,18,5,4,1,0,1,0,0,0,0,0,10,540223,1696,-14,4,-4,1,0,0,-1,1,1
KR_7761077482,15693,13608,283,277,6,1,1,6,5,1,0,0,0,0,18,18,3,6,1,0,1,0,0,0,0,0,10,540254,2085,6,5,-5,4,0,0,0,-3,1
KR_7761078747,16834,13088,260,238,10,2,2,10,8,2,0,1,0,0,15,15,3,5,0,0,1,0,0,1,0,0,10,540252,3746,22,8,-8,6,-1,0,0,-2,0
KR_7761081507,15962,15328,269,246,7,7,7,7,4,7,0,1,0,0,18,12,4,5,1,0,0,1,0,1,0,0,10,540228,634,23,0,0,-3,-1,0,6,-1,1
KR_7761090098,14482,14797,251,258,6,4,4,6,1,6,0,0,0,0,16,17,3,3,0,2,1,0,0,0,0,0,10,540189,-315,-7,2,-2,-5,0,0,-1,0,-2
KR_7761098928,14812,18090,249,240,4,13,13,4,7,17,0,0,0,0,20,18,0,4,1,1,0,1,0,0,0,0,10,540238,-3278,9,-9,9,-10,0,0,2,-4,0
KR_7761102103,12915,14279,225,272,2,3,3,2,2,2,0,1,0,0,16,131,2,5,0,0,1,0,0,1,0,0,10,540245,-1364,-47,-1,1,0,-1,0,-115,-3,0
KR_7761110575,15493,16443,243,291,7,8,8,7,11,5,0,1,0,0,13,16,5,2,1,2,0,1,0,1,0,0,10,540213,-950,-48,-1,1,6,-1,0,-3,3,-1
KR_7761122376,15094,16094,257,248,6,9,9,6,5,10,0,0,0,0,80,15,2,2,1,0,0,1,0,0,0,0,10,540222,-1000,9,-3,3,-5,0,0,65,0,1
KR_7761125595,16248,14427,242,222,10,6,6,10,8,1,0,0,0,0,13,12,3,1,0,1,0,1,0,0,0,0,10,540229,1821,20,4,-4,7,0,0,1,2,-1
KR_7761135758,14677,15338,273,269,3,6,6,3,3,6,0,1,0,0,21,16,1,5,2,1,0,1,0,1,0,0,10,540217,-661,4,-3,3,-3,-1,0,5,-4,1
KR_7761146541,15133,16365,277,260,5,8,8,6,4,8,0,1,0,0,14,20,3,4,0,0,1,0,0,1,0,0,10,540243,-1232,17,-3,2,-4,-1,0,-6,-1,0
KR_7761152036,16968,17570,239,258,9,11,11,9,13,12,0,1,0,0,34,27,2,0,0,1,0,1,0,1,0,0,10,540229,-602,-19,-2,2,1,-1,0,7,2,-1
KR_7761153094,13992,15623,255,280,3,6,6,3,4,3,0,1,0,0,15,26,1,4,1,1,0,1,0,1,0,0,10,540216,-1631,-25,-3,3,1,-1,0,-11,-3,0
KR_7761156960,13977,15699,261,269,2,6,6,2,4,10,0,0,0,0,15,15,1,3,1,0,1,0,0,0,0,0,10,540243,-1722,-8,-4,4,-6,0,0,0,-2,1
KR_7761158217,17001,15874,272,233,10,8,8,10,10,10,1,0,0,0,38,35,3,2,1,0,1,0,1,0,0,0,10,540252,1127,39,2,-2,0,1,0,3,1,1
KR_7761166052,15625,15290,266,288,6,4,4,6,4,3,0,1,0,0,37,39,2,0,0,1,0,1,0,1,0,0,10,540260,335,-22,2,-2,1,-1,0,-2,2,-1
KR_7761169700,18707,16584,258,221,13,10,10,14,13,9,0,0,0,0,15,15,2,2,2,2,1,0,0,0,0,0,10,540185,2123,37,3,-4,4,0,0,0,0,0
KR_7761179153,14455,16502,249,311,4,6,6,5,3,6,0,1,0,0,17,14,1,4,0,2,0,1,0,1,0,0,10,540288,-2047,-62,-2,1,-3,-1,0,3,-3,-2
KR_7761179449,14917,17726,267,276,4,10,10,4,5,15,0,0,0,0,15,17,4,4,0,0,0,1,0,0,0,0,10,540242,-2809,-9,-6,6,-10,0,0,-2,0,0
KR_7761181047,14870,15636,288,256,3,6,6,3,3,5,0,0,0,0,20,21,2,4,1,1,1,0,0,0,0,0,10,540260,-766,32,-3,3,-2,0,0,-1,-2,0
KR_7761194866,15254,15769,251,237,6,7,7,6,4,10,0,0,0,0,15,17,5,2,1,1,0,1,0,0,0,0,10,540241,-515,14,-1,1,-6,0,0,-2,3,0
KR_7761201536,14337,16367,240,247,3,9,9,3,3,8,0,0,0,0,13,13,1,0,0,1,0,1,0,0,0,0,10,540242,-2030,-7,-6,6,-5,0,0,0,1,-1
KR_7761210115,14746,15253,253,280,5,4,4,5,6,5,0,0,0,0,35,16,3,2,1,2,0,1,0,0,0,0,10,540219,-507,-27,1,-1,1,0,0,19,1,-1
KR_7761213457,17233,15229,264,258,9,5,5,9,12,5,0,0,0,0,19,12,0,3,3,0,0,1,0,0,0,0,10,540229,2004,6,4,-4,7,0,0,7,-3,3
KR_7761213570,14814,17106,242,290,6,9,9,6,5,6,0,0,0,0,12,115,4,1,0,1,0,1,0,0,0,0,10,540216,-2292,-48,-3,3,-1,0,0,-103,3,-1
KR_7761221884,13739,17473,253,265,2,10,10,2,2,8,0,0,0,0,34,118,4,1,0,1,0,1,0,0,0,0,10,540294,-3734,-12,-8,8,-6,0,0,-84,3,-1
KR_7761230108,14823,15424,271,293,4,4,4,4,5,3,0,1,0,0,17,17,4,2,0,0,1,0,0,1,0,0,10,540205,-601,-22,0,0,2,-1,0,0,2,0
KR_7761231979,13878,16084,263,284,2,5,5,2,1,5,0,0,0,0,15,17,2,3,0,3,0,1,0,0,0,0,10,540236,-2206,-21,-3,3,-4,0,0,-2,-1,-3
KR_7761240121,14527,14287,256,245,5,5,5,5,4,3,0,1,0,0,20,17,2,2,0,0,1,0,0,1,0,0,10,540226,240,11,0,0,1,-1,0,3,0,0
KR_7761244604,13506,16013,257,296,2,5,5,2,1,4,0,1,0,0,19,16,2,3,1,3,0,1,0,1,0,0,10,540208,-2507,-39,-3,3,-3,-1,0,3,-1,-2
KR_7761249199,14439,14632,251,275,4,4,4,4,8,6,0,1,0,0,25,12,1,5,0,0,0,1,0,1,0,0,10,540205,-193,-24,0,0,2,-1,0,13,-4,0
KR_7761251273,16371,15858,264,277,7,6,6,7,7,7,0,0,0,0,24,12,0,7,0,1,1,0,0,0,0,0,10,540257,513,-13,1,-1,0,0,0,12,-7,-1
KR_7761256695,15376,15644,213,238,7,7,7,7,10,8,0,1,0,0,20,23,2,2,0,2,0,1,0,1,0,0,10,540203,-268,-25,0,0,2,-1,0,-3,0,-2
KR_7761257841,17147,15884,260,257,10,6,6,10,11,9,0,1,0,0,17,15,2,4,0,1,0,1,0,1,0,0,10,540234,1263,3,4,-4,2,-1,0,2,-2,-1
KR_7761264220,14312,13901,255,253,4,4,4,4,8,4,1,0,0,0,12,15,3,0,1,1,0,1,1,0,0,0,10,540287,411,2,0,0,4,1,0,-3,3,0
KR_7761275031,15188,15596,305,277,3,6,6,3,4,6,0,0,0,0,33,34,7,6,0,0,0,1,0,0,0,0,10,540208,-408,28,-3,3,-2,0,0,-1,1,0
KR_7761280381,15278,14710,276,263,5,3,3,5,4,6,0,0,0,0,12,17,1,1,0,1,0,1,0,0,0,0,10,540269,568,13,2,-2,-2,0,0,-5,0,-1
KR_7761280857,16092,14598,273,269,7,4,4,7,11,5,1,0,0,0,48,15,1,2,2,0,1,0,1,0,0,0,10,540256,1494,4,3,-3,6,1,0,33,-1,2
KR_7761287691,14918,14257,281,238,3,4,4,3,3,5,0,0,0,0,17,15,2,3,0,1,0,1,0,0,0,0,10,540210,661,43,-1,1,-2,0,0,2,-1,-1
KR_7761302335,14984,15938,274,254,5,7,7,5,4,8,1,0,0,0,24,24,7,3,0,0,0,1,1,0,0,0,10,540223,-954,20,-2,2,-4,1,0,0,4,0
KR_7761305710,15080,17807,292,284,3,12,12,3,2,11,0,0,0,0,15,39,6,5,0,0,0,1,0,0,0,0,10,540274,-2727,8,-9,9,-9,0,0,-24,1,0
KR_7761308189,15583,14000,285,238,6,4,4,6,5,7,0,0,0,0,21,17,3,9,2,0,0,1,0,0,0,0,10,540213,1583,47,2,-2,-2,0,0,4,-6,2
KR_7761308421,13977,14985,255,290,3,4,4,3,6,6,0,0,0,0,16,16,0,3,0,0,0,1,0,0,0,0,10,540226,-1008,-35,-1,1,0,0,0,0,-3,0
KR_7761314676,14169,15001,239,282,4,4,4,4,3,4,0,1,0,0,14,15,0,1,0,2,1,0,0,1,0,0,10,540231,-832,-43,0,0,-1,-1,0,-1,-1,-2
KR_7761339084,17002,14100,256,254,9,4,4,9,13,2,1,0,0,0,17,12,4,5,1,1,1,0,1,0,0,0,10,540223,2902,2,5,-5,11,1,0,5,-1,0
KR_7761341697,16781,14549,260,289,9,3,3,9,15,2,0,1,0,0,38,11,2,4,1,0,1,0,0,1,0,0,10,540222,2232,-29,6,-6,13,-1,0,27,-2,1
KR_7761350104,14372,15380,260,236,4,8,8,4,3,6,0,1,0,0,14,43,2,3,0,1,1,0,0,1,0,0,10,540184,-1008,24,-4,4,-3,-1,0,-29,-1,-1
KR_7761351500,14835,14257,254,236,5,4,4,5,6,5,0,1,0,0,11,12,0,1,0,1,0,1,0,1,0,0,10,540270,578,18,1,-1,1,-1,0,-1,-1,-1
KR_7761357011,14611,18573,271,281,3,13,13,3,4,15,0,0,0,0,14,14,0,0,1,1,1,0,0,0,0,0,10,540251,-3962,-10,-10,10,-11,0,0,0,0,0
KR_7761365610,15494,14959,249,274,5,4,4,5,9,6,0,0,0,0,11,17,5,0,1,0,0,1,0,0,0,0,10,540249,535,-25,1,-1,3,0,0,-6,5,1
KR_7761368041,13820,17018,255,263,3,11,11,3,2,10,0,0,0,0,19,17,3,2,1,1,0,1,0,0,0,0,10,540230,-3198,-8,-8,8,-8,0,0,2,1,0
KR_7761371072,16622,14895,283,263,7,5,5,7,9,6,0,0,0,0,25,18,1,3,1,0,0,1,0,0,0,0,10,540233,1727,20,2,-2,3,0,0,7,-2,1
KR_7761390612,17315,17229,242,260,10,10,10,10,8,14,0,0,0,0,17,37,7,6,0,0,0,1,0,0,0,0,10,540257,86,-18,0,0,-6,0,0,-20,1,0
KR_7761397785,15010,14976,252,264,5,4,4,5,7,4,0,0,0,0,19,20,2,3,0,0,1,0,0,0,0,0,10,540255,34,-12,1,-1,3,0,0,-1,-1,0
KR_7761398615,13416,15450,234,250,3,8,8,3,4,2,0,0,0,0,24,17,2,3,0,0,0,1,0,0,0,0,10,540322,-2034,-16,-5,5,2,0,0,7,-1,0
KR_7761428620,16020,16647,253,264,8,8,8,8,7,9,0,0,0,0,13,20,0,2,3,0,0,1,0,0,0,0,10,540140,-627,-11,0,0,-2,0,0,-7,-2,3
KR_7761429196,15071,15181,272,280,3,4,4,3,6,5,0,0,0,0,15,14,2,4,1,1,1,0,0,0,0,0,10,540204,-110,-8,-1,1,1,0,0,1,-2,0
KR_7761431291,15230,15321,286,270,4,5,5,4,3,8,0,0,0,0,20,15,2,3,1,1,1,0,0,0,0,0,10,540189,-91,16,-1,1,-5,0,0,5,-1,0
KR_7761433843,17509,14929,267,255,11,4,4,11,11,3,0,0,0,0,19,15,2,7,1,0,1,0,0,0,0,0,10,540238,2580,12,7,-7,8,0,0,4,-5,1
KR_7761443422,15258,14454,257,249,7,4,4,7,6,5,0,0,0,0,18,15,2,3,0,0,0,1,0,0,0,0,10,540113,804,8,3,-3,1,0,0,3,-1,0
KR_7761459013,16406,14554,242,247,8,5,5,8,10,3,0,1,0,0,57,16,4,3,1,1,0,1,0,1,0,0,10,540217,1852,-5,3,-3,7,-1,0,41,1,0
KR_7761464708,14631,16566,224,258,6,9,9,6,10,16,0,0,0,0,16,16,1,2,1,1,1,0,0,0,0,0,10,540252,-1935,-34,-3,3,-6,0,0,0,-1,0
KR_7761465790,15666,17733,214,243,8,13,13,8,12,12,0,0,0,0,29,16,3,5,0,0,1,0,0,0,0,0,10,540272,-2067,-29,-5,5,0,0,0,13,-2,0
KR_7761489796,14271,15505,256,263,3,5,5,3,3,5,0,1,0,0,17,17,1,4,0,3,0,1,0,1,0,0,10,540097,-1234,-7,-2,2,-2,-1,0,0,-3,-3
KR_7761491214,14328,17127,231,262,4,8,8,5,7,11,0,0,0,0,37,15,2,3,1,0,0,1,0,0,0,0,10,540189,-2799,-31,-4,3,-4,0,0,22,-1,1
KR_7761505653,15028,13524,286,214,4,3,3,4,3,4,0,0,0,0,15,23,4,2,1,0,0,1,0,0,0,0,10,540217,1504,72,1,-1,-1,0,0,-8,2,1
KR_7761517959,16862,12541,270,245,10,0,0,10,16,0,1,0,0,0,18,31,4,3,0,0,1,0,1,0,0,0,10,540236,4321,25,10,-10,16,1,0,-13,1,0
KR_7761522006,16080,15163,282,254,7,5,5,7,7,6,1,0,0,0,13,17,2,2,1,2,1,0,1,0,0,0,10,540239,917,28,2,-2,1,1,0,-4,0,-1
KR_7761529240,14600,14344,223,248,6,4,4,6,11,7,1,0,0,0,17,17,2,1,0,0,1,0,1,0,0,0,10,540225,256,-25,2,-2,4,1,0,0,1,0
KR_7761531971,13464,14068,270,261,1,3,3,1,1,2,0,0,0,0,13,36,3,1,1,1,0,1,0,0,0,0,10,540218,-604,9,-2,2,-1,0,0,-23,2,0
KR_7761538375,13938,16149,254,284,3,7,7,3,5,5,0,1,0,0,16,16,3,4,0,2,0,1,0,1,0,0,10,540204,-2211,-30,-4,4,0,-1,0,0,-1,-2
KR_7761551447,14616,15186,273,259,4,4,4,4,0,7,1,0,0,0,20,18,5,3,1,1,0,1,1,0,0,0,10,540261,-570,14,0,0,-7,1,0,2,2,0
KR_7761557835,14232,16864,281,297,3,6,6,3,1,10,0,0,0,0,36,16,2,2,0,2,0,1,0,0,0,0,10,540219,-2632,-16,-3,3,-9,0,0,20,0,-2
KR_7761581673,15961,15438,230,267,9,6,6,9,8,3,0,0,0,0,13,38,3,0,0,1,1,0,0,0,0,0,10,540210,523,-37,3,-3,5,0,0,-25,3,-1
KR_7761581938,15049,13640,259,277,6,1,1,6,9,0,0,0,0,0,37,16,2,4,0,0,1,0,0,0,0,0,10,540115,1409,-18,5,-5,9,0,0,21,-2,0
KR_7761585609,15961,15404,273,263,6,5,6,6,9,8,0,0,0,0,15,15,2,3,0,2,0,1,0,0,0,0,10,540254,557,10,1,0,1,0,0,0,-1,-2
KR_7761587088,17056,16114,246,227,11,9,9,11,8,13,0,1,0,0,11,18,4,1,0,0,1,0,0,1,0,0,10,540232,942,19,2,-2,-5,-1,0,-7,3,0
KR_7761604921,15420,16377,247,242,5,9,9,5,5,9,0,0,0,0,20,42,4,3,2,0,0,1,0,0,0,0,10,540187,-957,5,-4,4,-4,0,0,-22,1,2
KR_7761615286,13859,14961,268,280,2,4,4,2,2,2,1,0,0,0,14,13,1,2,0,1,0,1,1,0,0,0,10,540197,-1102,-12,-2,2,0,1,0,1,-1,-1
KR_7761619168,16791,16173,283,258,9,8,8,9,6,10,0,0,0,0,17,27,6,1,2,1,0,1,0,0,0,0,10,540187,618,25,1,-1,-4,0,0,-10,5,1
KR_7761622353,16357,15942,255,263,9,6,8,9,10,5,0,0,0,0,34,15,3,2,1,0,1,0,0,0,0,0,10,540235,415,-8,3,-1,5,0,0,19,1,1
KR_7761630871,16327,17056,269,251,8,10,10,8,7,12,0,0,0,0,23,14,4,3,0,0,1,0,0,0,0,0,10,540276,-729,18,-2,2,-5,0,0,9,1,0
KR_7761640975,15389,14013,280,257,6,3,3,6,3,1,0,0,0,0,20,16,3,3,0,0,1,0,0,0,0,0,10,540274,1376,23,3,-3,2,0,0,4,0,0
KR_7761650562,14957,14725,271,262,4,4,4,4,3,7,0,0,0,0,13,36,4,2,1,1,1,0,0,0,0,0,10,540235,232,9,0,0,-4,0,0,-23,2,0
KR_7761651466,15927,14136,265,247,8,4,4,8,7,4,0,1,0,0,15,12,4,1,1,0,0,1,0,1,0,0,10,540237,1791,18,4,-4,3,-1,0,3,3,1
KR_7761652186,15388,16135,254,264,6,8,8,6,5,7,0,1,0,0,18,34,2,4,0,0,1,0,0,1,0,0,10,540224,-747,-10,-2,2,-2,-1,0,-16,-2,0
KR_7761655529,16377,16467,257,262,8,7,7,8,11,10,0,0,0,0,20,38,3,4,0,0,0,1,0,0,0,0,10,540214,-90,-5,1,-1,1,0,0,-18,-1,0
KR_7761664669,14687,13575,271,270,4,2,2,4,4,1,0,1,0,0,14,16,1,2,0,0,1,0,0,1,0,0,10,540215,1112,1,2,-2,3,-1,0,-2,-1,0
KR_7761675599,16878,16109,238,250,11,8,8,11,8,10,0,0,0,0,21,36,5,3,0,0,0,1,0,0,0,0,10,540276,769,-12,3,-3,-2,0,0,-15,2,0
KR_7761679679,16017,14395,300,268,5,3,3,5,7,5,0,0,0,0,23,20,4,4,0,0,1,0,0,0,0,0,10,540201,1622,32,2,-2,2,0,0,3,0,0
KR_7761683255,16765,14314,283,278,8,2,2,8,9,2,0,1,0,0,18,16,4,3,1,1,1,0,0,1,0,0,10,540227,2451,5,6,-6,7,-1,0,2,1,0
KR_7761689611,16372,15857,287,270,7,7,7,7,7,5,0,0,0,0,17,25,2,5,0,0,0,1,0,0,0,0,10,540274,515,17,0,0,2,0,0,-8,-3,0
KR_7761690304,13589,16844,242,238,2,10,10,2,3,15,1,0,0,0,14,20,1,3,1,1,0,1,1,0,0,0,10,540187,-3255,4,-8,8,-12,1,0,-6,-2,0
KR_7761698766,14826,13653,255,264,5,2,2,6,4,4,0,0,0,0,19,31,3,2,0,0,0,1,0,0,0,0,10,540225,1173,-9,3,-4,0,0,0,-12,1,0
KR_7761720574,15786,13678,292,276,5,2,2,5,5,0,0,0,0,0,16,32,3,3,1,0,1,0,0,0,0,0,10,540228,2108,16,3,-3,5,0,0,-16,0,1
KR_7761722827,15123,14533,291,265,4,4,4,4,3,3,0,1,0,0,17,19,5,4,1,0,1,0,0,1,0,0,10,540217,590,26,0,0,0,-1,0,-2,1,1
KR_7761723720,14733,16789,242,257,5,10,10,5,4,7,0,0,0,0,17,33,4,1,2,1,1,0,0,0,0,0,10,540212,-2056,-15,-5,5,-3,0,0,-16,3,1
KR_7761728529,15242,16135,234,242,6,10,10,6,7,9,0,0,0,0,14,16,4,3,1,0,1,0,0,0,0,0,10,540242,-893,-8,-4,4,-2,0,0,-2,1,1
KR_7761728928,16797,16994,261,243,8,9,9,8,7,11,0,1,0,0,14,28,2,2,1,2,0,1,0,1,0,0,10,540222,-197,18,-1,1,-4,-1,0,-14,0,-1
KR_7761732015,15047,16394,242,277,6,7,7,6,3,9,0,0,0,0,24,41,6,5,0,0,0,1,0,0,0,0,10,540219,-1347,-35,-1,1,-6,0,0,-17,1,0
KR_7761735581,15459,16134,258,230,6,10,10,6,3,14,0,0,0,0,174,30,5,2,1,0,0,1,0,0,0,0,10,540199,-675,28,-4,4,-11,0,0,144,3,1
KR_7761748296,15014,14029,288,251,4,3,3,4,3,1,0,0,0,0,37,16,8,4,0,0,0,1,0,0,0,0,10,540218,985,37,1,-1,2,0,0,21,4,0
KR_7761759045,15777,15842,261,265,7,8,8,7,8,6,0,0,0,0,20,15,0,4,0,1,1,0,0,0,0,0,10,540251,-65,-4,-1,1,2,0,0,5,-4,-1
KR_7761763865,16075,15730,266,265,7,7,7,7,9,5,1,0,0,0,13,14,3,2,0,2,1,0,1,0,0,0,10,540251,345,1,0,0,4,1,0,-1,1,-2
KR_7761765241,17313,17064,258,264,11,8,8,11,16,8,0,1,0,0,16,29,2,1,0,0,1,0,0,1,0,0,10,540187,249,-6,3,-3,8,-1,0,-13,1,0
KR_7761767343,15551,15461,259,281,5,5,5,5,8,7,0,0,0,0,35,29,5,6,1,0,0,1,0,0,0,0,10,540224,90,-22,0,0,1,0,0,6,-1,1
KR_7761776194,15505,16010,217,240,8,9,9,9,6,8,0,1,0,0,13,16,1,2,2,1,1,0,0,1,0,0,10,540233,-505,-23,-1,0,-2,-1,0,-3,-1,1
KR_7761782554,13325,16743,238,292,2,8,8,2,2,7,0,0,0,0,16,36,2,3,0,2,0,1,0,0,0,0,10,540157,-3418,-54,-6,6,-5,0,0,-20,-1,-2
KR_7761786382,15564,16722,260,271,6,10,10,6,9,17,0,0,0,0,10,11,0,1,0,1,0,1,0,0,0,0,10,540236,-1158,-11,-4,4,-8,0,0,-1,-1,-1
KR_7761802191,14237,17276,254,316,3,8,8,3,3,6,0,0,0,0,16,26,4,5,0,0,0,1,0,0,0,0,10,540216,-3039,-62,-5,5,-3,0,0,-10,-1,0
KR_7761804442,14369,16393,294,276,2,8,8,2,3,10,0,1,0,0,16,28,1,4,0,0,0,1,0,1,0,0,10,540195,-2024,18,-6,6,-7,-1,0,-12,-3,0
KR_7761805187,15675,14713,271,270,5,4,4,5,11,6,0,1,0,0,22,107,3,4,0,1,1,0,0,1,0,0,10,540215,962,1,1,-1,5,-1,0,-85,-1,-1
KR_7761811015,16261,13750,282,248,6,3,3,6,8,2,0,0,0,0,16,32,5,4,2,0,1,0,0,0,0,0,10,540230,2511,34,3,-3,6,0,0,-16,1,2
KR_7761811445,13658,15182,249,271,2,6,6,2,2,4,0,1,0,0,34,22,2,3,1,1,0,1,0,1,0,0,10,540113,-1524,-22,-4,4,-2,-1,0,12,-1,0
KR_7761823412,16058,16120,250,274,9,7,7,9,4,8,0,0,0,0,18,21,3,3,1,1,0,1,0,0,0,0,10,540207,-62,-24,2,-2,-4,0,0,-3,0,0
KR_7761823787,17543,14584,259,266,11,4,4,11,15,4,0,0,0,0,19,19,3,4,2,0,1,0,0,0,0,0,10,540233,2959,-7,7,-7,11,0,0,0,-1,2
KR_7761834027,15513,14659,251,256,5,4,4,5,6,6,0,1,0,0,12,18,5,3,0,0,1,0,0,1,0,0,10,540239,854,-5,1,-1,0,-1,0,-6,2,0
KR_7761837683,15509,14366,286,286,5,3,3,5,6,2,0,1,0,0,14,26,5,3,0,0,1,0,0,1,0,0,10,540219,1143,0,2,-2,4,-1,0,-12,2,0
KR_7761837976,16668,14690,274,276,8,4,4,8,6,3,0,0,0,0,16,11,2,7,0,0,0,1,0,0,0,0,10,540208,1978,-2,4,-4,3,0,0,5,-5,0
KR_7761841873,16914,16489,262,250,10,8,9,10,9,10,0,0,0,0,16,12,4,3,1,1,1,0,0,0,0,0,10,540219,425,12,2,-1,-1,0,0,4,1,0
KR_7761854563,18179,13861,267,214,12,4,5,12,17,4,0,0,0,0,23,16,6,4,2,0,1,0,0,0,0,0,10,540167,4318,53,8,-7,13,0,0,7,2,2
KR_7761855752,16764,14969,272,255,8,6,6,8,7,4,0,0,0,0,25,16,3,3,1,0,1,0,0,0,0,0,10,540247,1795,17,2,-2,3,0,0,9,0,1
KR_7761862978,14566,15280,265,264,4,5,5,4,3,7,0,1,0,0,21,19,2,5,1,0,1,0,0,1,0,0,10,540245,-714,1,-1,1,-4,-1,0,2,-3,1
KR_7761868113,19152,13900,295,229,13,3,3,13,12,4,0,0,0,0,16,17,3,1,0,0,1,0,0,0,0,0,10,540247,5252,66,10,-10,8,0,0,-1,2,0
KR_7761877330,16936,15876,256,281,8,6,7,8,13,4,0,0,0,0,19,105,3,5,1,3,1,0,0,0,0,0,10,540182,1060,-25,2,-1,9,0,0,-86,-2,-2
KR_7761878413,14917,15183,280,282,4,4,4,4,6,3,1,0,0,0,16,33,2,2,0,0,0,1,1,0,0,0,10,540257,-266,-2,0,0,3,1,0,-17,0,0
KR_7761881362,17389,16230,287,279,9,5,5,9,8,9,0,0,0,0,19,18,1,5,3,0,1,0,0,0,0,0,10,540195,1159,8,4,-4,-1,0,0,1,-4,3
KR_7761884932,15452,15570,279,296,5,4,4,5,5,5,0,0,0,0,18,18,5,6,1,1,0,1,0,0,0,0,10,540215,-118,-17,1,-1,0,0,0,0,-1,0
KR_7761896022,16159,16354,215,212,9,9,9,9,6,8,0,0,0,0,12,17,1,2,0,0,0,1,0,0,0,0,10,540256,-195,3,0,0,-2,0,0,-5,-1,0
KR_7761904119,17449,16120,279,269,9,8,8,9,12,4,0,0,0,0,13,13,3,4,0,0,1,0,0,0,0,0,10,540244,1329,10,1,-1,8,0,0,0,-1,0
KR_7761905594,16704,14328,267,253,8,5,5,8,11,1,1,0,0,0,17,16,4,4,0,1,1,0,1,0,0,0,10,540238,2376,14,3,-3,10,1,0,1,0,-1
KR_7761913584,15912,14854,284,265,6,4,4,6,8,2,0,0,0,0,20,15,4,4,0,0,1,0,0,0,0,0,10,540218,1058,19,2,-2,6,0,0,5,0,0
KR_7761916809,14687,15080,274,276,4,5,5,4,3,5,0,0,0,0,22,18,5,3,0,0,0,1,0,0,0,0,10,540236,-393,-2,-1,1,-2,0,0,4,2,0
KR_7761925505,16427,14480,257,255,10,4,4,10,5,6,0,0,0,0,12,40,4,0,1,0,1,0,0,0,0,0,10,540207,1947,2,6,-6,-1,0,0,-28,4,1
KR_7761931925,15457,14902,266,246,6,4,4,6,10,6,0,0,0,0,14,19,3,4,0,1,1,0,0,0,0,0,10,540215,555,20,2,-2,4,0,0,-5,-1,-1
KR_7761938655,15615,14423,270,257,6,4,4,6,6,3,0,0,0,0,107,36,3,4,2,0,0,1,0,0,0,0,10,540256,1192,13,2,-2,3,0,0,71,-1,2
KR_7761939377,14881,14785,284,302,4,2,2,4,3,4,1,0,0,0,11,25,2,6,0,1,0,1,1,0,0,0,10,540235,96,-18,2,-2,-1,1,0,-14,-4,-1
KR_7761947696,15276,17414,261,265,5,9,10,5,4,7,0,0,0,0,53,22,5,4,0,2,0,1,0,0,0,0,10,540258,-2138,-4,-4,5,-3,0,0,31,1,-2
KR_7761948864,16872,14255,259,264,9,3,4,9,15,3,0,0,0,0,37,109,6,1,2,0,1,0,0,0,0,0,10,540295,2617,-5,6,-5,12,0,0,-72,5,2
KR_7761956322,13504,15699,252,302,2,5,5,2,3,1,0,0,0,0,14,15,3,3,0,1,1,0,0,0,0,0,10,540247,-2195,-50,-3,3,2,0,0,-1,0,-1
KR_7761957880,15285,14373,238,275,7,3,3,7,6,1,0,1,0,0,12,18,4,4,2,2,1,0,0,1,0,0,10,540235,912,-37,4,-4,5,-1,0,-6,0,0
KR_7761961252,14976,15364,259,261,5,6,6,5,2,4,0,1,0,0,17,18,4,1,0,1,0,1,0,1,0,0,10,540213,-388,-2,-1,1,-2,-1,0,-1,3,-1
KR_7761961459,18311,13154,287,238,12,2,2,12,15,1,0,0,0,0,19,29,3,0,0,0,1,0,0,0,0,0,10,540235,5157,49,10,-10,14,0,0,-10,3,0
KR_7761981641,15998,15611,251,241,8,7,7,8,6,10,0,0,0,0,10,113,1,0,1,1,0,1,0,0,0,0,10,540201,387,10,1,-1,-4,0,0,-103,1,0
KR_7761984045,16167,17296,256,273,7,7,7,7,6,8,0,0,0,0,15,14,4,2,1,3,1,0,0,0,0,1,10,540221,-1129,-17,0,0,-2,0,0,1,2,-2
KR_7761984540,15925,18204,239,243,7,14,14,7,7,17,0,0,0,0,17,27,2,4,0,0,1,0,0,0,0,0,10,540185,-2279,-4,-7,7,-10,0,0,-10,-2,0
KR_7761987137,17161,15090,259,238,11,6,6,11,8,5,1,0,0,0,14,34,2,1,1,2,1,0,1,0,0,0,10,540196,2071,21,5,-5,3,1,0,-20,1,-1
KR_7761996536,15965,14896,268,272,7,4,4,7,7,4,0,1,0,0,20,13,1,3,0,0,1,0,0,1,0,0,10,540227,1069,-4,3,-3,3,-1,0,7,-2,0
KR_7762000419,17793,14092,247,221,12,4,4,12,13,3,0,0,0,0,19,35,4,3,2,0,1,0,0,0,0,0,10,540233,3701,26,8,-8,10,0,0,-16,1,2
KR_7762001247,18886,13014,277,243,14,2,2,14,14,1,0,0,0,0,113,14,2,3,3,0,1,0,0,0,1,0,10,540262,5872,34,12,-12,13,0,0,99,-1,3
KR_7762005061,14991,15651,232,282,5,5,5,5,8,5,0,0,0,0,20,80,3,3,1,3,0,1,0,0,0,0,10,540182,-660,-50,0,0,3,0,0,-60,0,-2
KR_7762008683,14394,14177,273,266,4,3,3,4,1,3,0,1,0,0,18,15,3,3,0,1,0,1,0,1,0,0,10,540209,217,7,1,-1,-2,-1,0,3,0,-1
KR_7762014334,16355,14992,268,274,7,4,4,7,9,5,0,1,0,0,112,23,6,5,0,1,0,1,0,1,0,0,10,540249,1363,-6,3,-3,4,-1,0,89,1,-1
KR_7762019921,14962,16558,255,291,5,7,7,5,2,9,0,0,0,0,20,16,1,2,0,0,0,1,0,0,0,0,10,540246,-1596,-36,-2,2,-7,0,0,4,-1,0
KR_7762026356,14405,16590,237,257,4,9,9,4,5,9,0,0,0,0,15,32,2,3,0,0,0,1,0,0,0,0,10,540197,-2185,-20,-5,5,-4,0,0,-17,-1,0
KR_7762027554,14155,15678,267,268,2,6,6,2,2,5,0,0,0,0,12,15,2,2,0,1,1,0,0,0,0,0,10,540232,-1523,-1,-4,4,-3,0,0,-3,0,-1
KR_7762043315,16636,14120,247,235,9,4,4,9,6,4,0,0,0,0,18,14,1,1,1,0,1,0,0,0,0,0,10,540229,2516,12,5,-5,2,0,0,4,0,1
KR_7762052496,15513,16235,252,235,8,9,9,9,7,12,0,0,0,0,26,18,5,5,1,1,1,0,0,0,0,0,10,540199,-722,17,-1,0,-5,0,0,8,0,0
KR_7762068543,15376,18141,243,262,8,13,13,8,4,13,1,0,0,0,17,17,3,6,0,0,0,1,1,0,0,0,10,540235,-2765,-19,-5,5,-9,1,0,0,-3,0
KR_7762076009,15358,16629,222,238,6,9,9,6,7,6,0,0,0,0,28,12,0,0,0,1,0,1,0,0,0,0,10,540245,-1271,-16,-3,3,1,0,0,16,0,-1
KR_7762089764,14322,17827,292,279,2,9,9,3,0,9,0,0,0,0,14,14,2,1,3,3,0,1,0,0,0,0,10,540181,-3505,13,-7,6,-9,0,0,0,1,0
KR_7762093449,15668,14449,280,243,6,5,5,6,2,4,0,0,0,0,15,20,1,2,1,0,0,1,0,0,0,0,10,540247,1219,37,1,-1,-2,0,0,-5,-1,1
KR_7762104217,17347,12409,269,206,10,2,2,10,13,2,0,0,0,0,16,11,5,3,3,0,1,0,0,0,0,0,10,540179,4938,63,8,-8,11,0,0,5,2,3
KR_7762111577,14477,15735,230,263,5,7,7,5,3,2,1,0,0,0,10,16,2,2,0,4,1,0,1,0,0,0,10,540179,-1258,-33,-2,2,1,1,0,-6,0,-4
KR_7762127155,15438,13584,253,266,7,2,2,7,6,2,0,0,0,0,19,20,4,1,0,0,1,0,0,0,0,0,10,540231,1854,-13,5,-5,4,0,0,-1,3,0
KR_7762127427,15212,13391,276,241,6,3,3,6,4,7,0,1,0,0,20,12,2,3,1,0,0,1,0,1,0,0,10,540180,1821,35,3,-3,-3,-1,0,8,-1,1
KR_7762132159,15989,15096,231,244,8,5,5,8,11,3,0,0,0,0,18,16,1,1,2,1,1,0,0,0,0,0,10,540183,893,-13,3,-3,8,0,0,2,0,1
KR_7762136864,15740,13400,245,208,8,5,5,8,5,2,0,0,0,0,10,15,4,1,0,0,1,0,0,0,0,0,10,540248,2340,37,3,-3,3,0,0,-5,3,0
KR_7762145989,13951,13422,272,250,1,2,2,1,0,2,0,0,0,0,12,25,5,4,1,0,1,0,0,0,0,0,10,540235,529,22,-1,1,-2,0,0,-13,1,1
KR_7762151252,15747,19446,246,310,6,14,14,6,6,15,0,0,0,0,14,18,1,4,0,2,0,1,0,0,0,0,10,540215,-3699,-64,-8,8,-9,0,0,-4,-3,-2
KR_7762172259,16708,15481,253,236,10,5,5,10,14,13,1,0,0,0,18,11,2,3,3,0,0,1,1,0,0,0,10,540267,1227,17,5,-5,1,1,0,7,-1,3
KR_7762176143,17693,16340,218,236,15,9,9,15,12,10,0,0,0,0,14,13,1,0,0,2,0,1,0,0,0,0,10,540300,1353,-18,6,-6,2,0,0,1,1,-2
KR_7762180086,17271,14144,224,209,10,6,6,10,13,6,0,0,0,0,20,16,1,4,3,0,0,1,0,0,0,0,10,540104,3127,15,4,-4,7,0,0,4,-3,3
KR_7762191685,15997,15304,245,241,9,5,5,10,11,8,1,0,0,0,15,11,1,3,2,0,1,0,1,0,0,0,10,540253,693,4,4,-5,3,1,0,4,-2,2
KR_7762196468,6033,4778,71,46,2,0,0,2,0,0,0,0,0,0,5,6,0,0,0,0,1,0,0,0,0,0,5,227469,1255,25,2,-2,0,0,0,-1,0,0
KR_7762210218,13077,14691,237,266,2,5,5,2,2,2,0,0,0,0,21,17,1,2,0,0,1,0,0,0,0,0,10,540252,-1614,-29,-3,3,0,0,0,4,-1,0
KR_7762218462,15175,13393,273,250,7,2,2,8,3,6,0,0,0,0,20,12,4,4,0,0,1,0,0,0,0,0,10,540141,1782,23,5,-6,-3,0,0,8,0,0
KR_7762221783,14461,16487,246,241,5,8,8,5,9,13,0,0,0,0,19,14,2,4,0,0,1,0,0,0,0,0,10,540217,-2026,5,-3,3,-4,0,0,5,-2,0
KR_7762247729,17466,17307,291,269,9,7,7,10,11,11,0,0,0,0,16,17,3,2,0,1,1,0,0,0,0,0,10,540260,159,22,2,-3,0,0,0,-1,1,-1
KR_7762247921,14297,15546,216,243,6,8,8,6,4,11,1,0,0,0,37,21,5,5,0,1,0,1,1,0,0,0,10,540257,-1249,-27,-2,2,-7,1,0,16,0,-1
KR_7762260238,14262,14819,261,269,4,3,3,4,2,4,0,0,0,0,14,37,9,3,0,0,1,0,0,0,0,0,10,540219,-557,-8,1,-1,-2,0,0,-23,6,0
KR_7762288196,14563,16223,267,241,4,9,9,4,2,13,0,1,0,0,15,15,3,2,0,2,0,1,0,1,0,0,10,540236,-1660,26,-5,5,-11,-1,0,0,1,-2
KR_7762290786,14896,14779,243,265,6,5,5,6,5,5,1,0,0,0,10,19,0,1,0,0,1,0,1,0,0,0,10,540278,117,-22,1,-1,0,1,0,-9,-1,0
KR_7762296665,14187,16982,239,287,5,9,9,5,4,6,0,0,0,0,35,13,2,5,0,2,0,1,0,0,0,0,10,540272,-2795,-48,-4,4,-2,0,0,22,-3,-2
KR_7762303755,16394,18238,234,246,10,12,12,10,6,10,0,0,0,0,11,42,3,2,2,1,0,1,0,0,0,0,10,540255,-1844,-12,-2,2,-4,0,0,-31,1,1
KR_7762314849,14774,17330,258,300,4,9,11,4,5,6,0,0,0,0,16,12,1,3,0,1,0,1,0,0,0,0,10,540241,-2556,-42,-5,7,-1,0,0,4,-2,-1
KR_7762316986,16191,15175,264,270,9,4,4,9,8,6,0,0,0,0,16,59,0,4,2,0,1,0,0,0,0,0,10,540253,1016,-6,5,-5,2,0,0,-43,-4,2
KR_7762321338,16612,13173,261,239,9,2,2,9,11,2,0,0,0,0,18,13,1,2,0,0,0,1,0,0,0,0,10,540251,3439,22,7,-7,9,0,0,5,-1,0
KR_7762329930,17052,14214,287,252,8,5,5,8,11,5,0,0,0,0,34,36,1,1,1,0,1,0,0,0,0,0,10,540230,2838,35,3,-3,6,0,0,-2,0,1
KR_7762347737,15211,15111,248,239,6,6,6,6,2,5,0,0,0,0,12,11,2,1,1,0,0,1,0,0,0,0,10,540234,100,9,0,0,-3,0,0,1,1,1
KR_7762352477,14786,14389,226,272,6,3,3,6,5,2,1,0,0,0,17,13,0,3,0,0,1,0,1,0,0,0,10,540233,397,-46,3,-3,3,1,0,4,-3,0
KR_7762353414,15050,16499,238,259,6,10,10,6,6,9,0,1,0,0,10,13,1,2,0,1,0,1,0,1,0,0,10,540160,-1449,-21,-4,4,-3,-1,0,-3,-1,-1
KR_7762363478,16028,14385,273,261,7,3,3,7,6,4,0,0,0,0,35,19,6,1,1,3,1,0,0,0,0,0,10,540230,1643,12,4,-4,2,0,0,16,5,-2
KR_7762370044,16770,16051,255,275,8,8,8,8,10,4,0,1,0,0,20,16,3,5,0,0,1,0,0,1,0,0,10,540225,719,-20,0,0,6,-1,0,4,-2,0
KR_7762370367,17071,14998,273,262,12,5,5,12,7,7,1,0,0,0,23,16,3,6,0,0,1,0,1,0,0,0,10,540240,2073,11,7,-7,0,1,0,7,-3,0
KR_7762375139,14066,15202,241,250,4,5,5,4,4,8,0,1,0,0,12,110,1,3,0,0,0,1,0,1,0,0,10,540254,-1136,-9,-1,1,-4,-1,0,-98,-2,0
KR_7762387956,16489,16515,255,294,8,6,6,8,12,4,1,0,0,0,107,14,1,2,0,2,0,1,1,0,0,0,10,540218,-26,-39,2,-2,8,1,0,93,-1,-2
KR_7762393608,14059,16436,272,274,3,8,8,3,2,10,0,0,0,0,14,42,3,5,0,1,0,1,0,0,0,0,10,540244,-2377,-2,-5,5,-8,0,0,-28,-2,-1
KR_7762398544,14867,16465,270,269,4,8,8,4,3,9,0,0,0,0,33,16,5,3,2,0,1,0,0,0,0,0,10,540206,-1598,1,-4,4,-6,0,0,17,2,2
KR_7762405170,16192,17261,268,249,7,10,10,7,9,15,0,1,0,0,18,17,0,5,2,0,0,1,0,1,0,0,10,540275,-1069,19,-3,3,-6,-1,0,1,-5,2
KR_7762405328,15247,16647,243,246,6,8,8,6,6,9,0,0,0,0,16,20,7,3,0,3,0,1,0,0,0,0,10,540233,-1400,-3,-2,2,-3,0,0,-4,4,-3
KR_7762408530,14104,14716,242,247,4,5,5,4,3,3,0,0,0,0,17,145,3,1,0,2,1,0,0,0,0,0,10,540203,-612,-5,-1,1,0,0,0,-128,2,-2
KR_7762419086,16250,14758,271,267,7,4,4,7,7,3,0,1,0,0,15,27,3,2,1,0,1,0,0,1,0,0,10,540200,1492,4,3,-3,4,-1,0,-12,1,1
KR_7762428184,15710,16111,261,240,6,9,9,6,2,6,0,1,0,0,15,15,3,0,2,1,0,1,0,1,0,0,10,540221,-401,21,-3,3,-4,-1,0,0,3,1
KR_7762432756,15269,14581,293,296,4,2,2,4,3,3,0,0,0,0,114,16,6,3,1,0,1,0,0,0,0,0,10,540235,688,-3,2,-2,0,0,0,98,3,1
KR_7762443025,15416,13961,273,258,6,4,4,6,4,2,0,0,0,0,29,15,2,2,1,0,1,0,0,0,0,0,10,540227,1455,15,2,-2,2,0,0,14,0,1
KR_7762447384,15027,15819,254,225,3,8,8,3,5,13,0,1,0,0,12,17,3,1,1,1,0,1,0,1,0,0,10,540230,-792,29,-5,5,-8,-1,0,-5,2,0
KR_7762453925,16017,15751,275,255,7,7,7,7,8,8,0,1,0,0,16,13,4,6,1,0,0,1,0,1,0,0,10,540247,266,20,0,0,0,-1,0,3,-2,1
KR_7762471065,15062,13416,266,257,5,2,2,5,8,1,0,0,0,0,16,36,1,6,1,0,0,1,0,0,0,0,10,540185,1646,9,3,-3,7,0,0,-20,-5,1
KR_7762474721,15780,15663,288,257,5,5,5,6,6,9,0,0,0,0,109,13,3,2,1,2,1,0,0,0,0,0,10,540216,117,31,0,-1,-3,0,0,96,1,-1
KR_7762484998,17632,16163,260,255,10,7,7,10,11,10,0,0,0,0,38,18,4,3,2,1,1,0,0,0,0,0,10,540226,1469,5,3,-3,1,0,0,20,1,1
KR_7762488071,15722,13573,241,258,8,2,2,8,10,3,0,0,0,0,50,16,3,2,0,3,1,0,0,0,0,0,10,540221,2149,-17,6,-6,7,0,0,34,1,-3
KR_7762491946,17113,15710,269,252,9,6,6,10,8,8,0,1,0,0,14,14,1,0,2,0,1,0,0,1,0,0,10,540231,1403,17,3,-4,0,-1,0,0,1,2
KR_7762492349,14770,13592,232,253,5,2,3,5,5,1,0,1,0,0,16,12,3,3,1,1,1,0,0,1,0,0,10,540222,1178,-21,3,-2,4,-1,0,4,0,0
KR_7762502456,13983,14793,243,299,3,3,3,3,3,2,0,0,0,0,16,21,3,3,0,1,1,0,0,0,0,0,10,540229,-810,-56,0,0,1,0,0,-5,0,-1
KR_7762502950,13565,19676,174,274,5,17,17,5,3,13,0,0,0,0,15,19,3,3,0,0,0,1,0,0,0,0,10,540265,-6111,-100,-12,12,-10,0,0,-4,0,0
KR_7762504726,14338,14899,288,295,2,4,4,2,0,5,0,1,0,0,16,50,2,5,1,0,0,1,0,1,0,0,10,540247,-561,-7,-2,2,-5,-1,0,-34,-3,1
KR_7762513935,14903,15026,262,286,5,4,4,6,2,5,0,0,0,0,39,17,6,7,0,0,0,1,0,0,0,0,10,540165,-123,-24,1,-2,-3,0,0,22,-1,0
KR_7762533857,14845,14179,263,281,3,2,2,3,5,1,0,0,0,0,23,86,5,6,1,0,1,0,0,0,0,0,10,540238,666,-18,1,-1,4,0,0,-63,-1,1
KR_7762535907,17288,16537,238,261,10,7,7,10,11,8,0,0,0,0,40,19,8,5,0,0,1,0,0,0,0,0,10,540221,751,-23,3,-3,3,0,0,21,3,0
KR_7762536593,15851,15771,274,264,6,6,6,6,5,7,0,0,0,0,14,15,3,0,0,1,0,1,0,0,0,0,10,540218,80,10,0,0,-2,0,0,-1,3,-1
KR_7762551428,15948,14846,259,289,7,4,4,7,6,1,0,1,0,0,17,12,0,4,0,3,1,0,0,1,0,0,10,540212,1102,-30,3,-3,5,-1,0,5,-4,-3
KR_7762558850,15710,13705,272,259,6,2,2,6,5,3,0,1,0,0,25,23,0,6,3,0,1,0,0,1,0,0,10,540250,2005,13,4,-4,2,-1,0,2,-6,3
KR_7762562197,14832,15632,248,242,5,8,8,5,3,4,0,0,0,0,16,45,4,6,3,1,0,1,0,0,0,0,10,540245,-800,6,-3,3,-1,0,0,-29,-2,2
KR_7762566657,14925,15665,250,234,5,7,7,5,4,6,0,0,0,0,19,23,3,1,1,0,1,0,0,0,0,0,10,540284,-740,16,-2,2,-2,0,0,-4,2,1
KR_7762566830,13763,15807,260,251,3,7,7,3,0,8,0,0,0,0,19,29,2,5,1,2,0,1,0,0,0,0,10,540226,-2044,9,-4,4,-8,0,0,-10,-3,-1
KR_7762577781,13713,13551,209,277,6,1,1,6,2,1,0,1,0,0,16,13,0,2,1,2,1,0,0,1,0,0,10,540215,162,-68,5,-5,1,-1,0,3,-2,-1
KR_7762578213,14702,14304,285,293,4,2,2,4,4,2,0,0,0,0,14,15,2,0,0,0,1,0,0,0,0,0,10,540233,398,-8,2,-2,2,0,0,-1,2,0
KR_7762578687,13146,13684,243,253,1,3,3,1,1,0,0,1,0,0,13,11,2,5,0,0,0,1,0,1,0,0,10,540224,-538,-10,-2,2,1,-1,0,2,-3,0
KR_7762583303,16535,14544,283,259,7,4,4,7,11,7,0,0,0,0,19,23,4,5,0,0,1,0,0,0,0,0,10,540084,1991,24,3,-3,4,0,0,-4,-1,0
KR_7762583982,15476,16297,253,242,6,10,10,6,5,8,0,0,0,0,38,17,4,4,0,0,0,1,0,0,0,0,10,540222,-821,11,-4,4,-3,0,0,21,0,0
KR_7762588670,14369,16861,290,301,2,6,6,2,4,5,0,1,0,0,14,15,3,2,1,2,0,1,0,1,0,0,10,540081,-2492,-11,-4,4,-1,-1,0,-1,1,-1
KR_7762590631,15680,15206,267,267,6,4,5,6,6,4,0,0,0,0,21,11,0,3,2,0,0,1,0,0,0,0,10,540223,474,0,2,-1,2,0,0,10,-3,2
KR_7762600335,16331,13526,237,244,9,2,2,9,10,1,0,0,0,0,16,58,17,2,1,0,1,0,0,0,0,0,10,540210,2805,-7,7,-7,9,0,0,-42,15,1
KR_7762605760,15511,15842,229,247,8,7,8,8,7,6,0,1,0,0,12,13,2,1,0,2,0,1,0,1,0,0,10,540243,-331,-18,1,0,1,-1,0,-1,1,-2
KR_7762616038,14712,15865,264,294,4,5,5,4,5,3,0,1,0,0,25,20,4,2,0,2,1,0,0,1,0,0,10,540219,-1153,-30,-1,1,2,-1,0,5,2,-2
KR_7762617596,17846,12844,257,248,12,1,1,12,17,1,0,0,0,0,15,18,5,0,0,0,1,0,0,0,0,0,10,540214,5002,9,11,-11,16,0,0,-3,5,0
KR_7762623000,15682,14974,234,280,7,4,4,7,12,1,0,0,0,0,13,71,1,0,2,3,1,0,0,0,0,0,10,540108,708,-46,3,-3,11,0,0,-58,1,-1
KR_7762623504,15876,16303,256,239,7,8,8,7,9,8,0,0,0,0,14,38,5,2,1,0,1,0,0,0,0,0,10,540214,-427,17,-1,1,1,0,0,-24,3,1
KR_7762638284,16139,16789,286,271,8,8,8,8,8,10,0,0,0,0,15,33,1,2,1,1,0,1,0,0,0,0,10,540270,-650,15,0,0,-2,0,0,-18,-1,0
KR_7762641262,15129,13043,260,254,6,1,1,6,4,2,0,1,0,0,12,14,2,3,0,0,1,0,0,1,0,0,10,540155,2086,6,5,-5,2,-1,0,-2,-1,0
KR_7762650145,17080,16017,265,291,8,5,5,8,10,8,0,1,0,0,16,12,3,4,3,0,0,1,0,1,0,0,10,540288,1063,-26,3,-3,2,-1,0,4,-1,3
KR_7762652046,15347,13741,277,276,5,2,2,5,6,1,0,1,0,0,14,12,2,3,0,0,1,0,0,1,0,0,10,540240,1606,1,3,-3,5,-1,0,2,-1,0
KR_7762654153,10720,12918,183,229,1,4,4,1,0,2,0,1,0,0,12,18,1,2,0,1,0,1,0,1,0,0,9,463707,-2198,-46,-3,3,-2,-1,0,-6,-1,-1
KR_7762661827,14923,14284,241,230,6,5,5,6,4,5,0,0,0,0,13,17,3,0,0,0,1,0,0,0,0,0,10,540251,639,11,1,-1,-1,0,0,-4,3,0
KR_7762666196,17151,14990,277,256,9,5,5,9,10,6,0,0,0,0,13,37,3,3,2,0,1,0,0,0,0,0,10,540263,2161,21,4,-4,4,0,0,-24,0,2
KR_7762666757,14058,17531,253,281,4,8,8,4,2,9,0,1,0,0,16,17,5,4,0,3,0,1,0,1,0,0,10,540209,-3473,-28,-4,4,-7,-1,0,-1,1,-3
KR_7762669200,16251,15881,254,247,9,8,8,9,8,10,0,0,0,0,27,13,4,5,0,0,1,0,0,0,0,0,10,540244,370,7,1,-1,-2,0,0,14,-1,0
KR_7762671730,15981,14334,247,246,9,4,4,9,6,4,0,1,0,0,14,22,1,2,0,1,1,0,0,1,0,0,10,540211,1647,1,5,-5,2,-1,0,-8,-1,-1
KR_7762678725,15308,15461,256,275,6,5,5,6,8,5,0,1,0,0,19,19,2,4,0,0,1,0,0,1,0,0,10,540271,-153,-19,1,-1,3,-1,0,0,-2,0
KR_7762679647,14509,15107,247,284,4,4,4,5,4,2,0,1,0,0,17,15,3,4,1,0,0,1,0,1,0,0,10,540234,-598,-37,0,-1,2,-1,0,2,-1,1
KR_7762680915,14815,15010,256,266,5,4,4,5,7,5,0,1,0,0,14,12,1,4,0,1,1,0,0,1,0,0,10,540217,-195,-10,1,-1,2,-1,0,2,-3,-1
KR_7762686802,15837,16859,242,268,8,9,9,8,10,12,0,0,0,0,26,20,4,5,0,1,0,1,0,0,0,0,10,540248,-1022,-26,-1,1,-2,0,0,6,-1,-1
KR_7762705519,17621,16346,258,267,8,7,7,8,11,9,0,0,0,0,21,14,1,2,0,3,0,1,0,0,0,0,10,540254,1275,-9,1,-1,2,0,0,7,-1,-3
KR_7762711578,14694,15308,284,255,3,7,7,3,3,10,0,1,0,0,15,12,2,3,1,0,1,0,0,1,0,0,10,540275,-614,29,-4,4,-7,-1,0,3,-1,1
KR_7762714671,16378,16445,232,250,10,9,9,10,9,8,0,0,0,0,16,16,2,2,0,0,1,0,0,0,0,0,10,540211,-67,-18,1,-1,1,0,0,0,0,0
KR_7762716554,16013,13614,297,295,5,0,1,5,7,0,1,0,0,0,26,18,4,3,2,0,1,0,1,0,0,0,10,540250,2399,2,5,-4,7,1,0,8,1,2
KR_7762717859,15428,15626,258,264,5,6,6,5,8,9,0,1,0,0,19,12,3,2,0,0,0,1,0,1,0,0,10,540174,-198,-6,-1,1,-1,-1,0,7,1,0
KR_7762728850,16202,15942,280,237,7,8,8,7,10,10,0,0,0,0,14,13,2,1,0,1,1,0,0,0,0,0,10,540244,260,43,-1,1,0,0,0,1,1,-1
KR_7762736269,15614,13496,235,243,7,3,3,7,7,1,0,1,0,0,19,14,3,4,0,1,0,1,0,1,0,0,10,540245,2118,-8,4,-4,6,-1,0,5,-1,-1
KR_7762743353,19842,14878,302,231,13,6,6,13,14,6,0,1,0,0,18,27,4,3,4,0,1,0,0,1,0,0,10,540224,4964,71,7,-7,8,-1,0,-9,1,4
KR_7762745500,15357,14337,263,250,6,3,3,6,3,2,0,1,0,0,14,15,1,4,0,3,1,0,0,1,0,0,10,540255,1020,13,3,-3,1,-1,0,-1,-3,-3
KR_7762751805,16119,13392,254,273,7,1,1,7,11,0,0,0,0,0,17,12,3,4,2,0,1,0,0,0,0,0,10,540213,2727,-19,6,-6,11,0,0,5,-1,2
KR_7762758552,13871,17239,213,252,4,10,10,4,4,14,0,0,0,0,16,15,1,4,0,2,0,1,0,0,0,0,10,540078,-3368,-39,-6,6,-10,0,0,1,-3,-2
KR_7762773472,15150,14594,242,255,6,4,4,6,7,6,0,1,0,0,18,17,4,3,0,0,0,1,0,1,0,0,10,540238,556,-13,2,-2,1,-1,0,1,1,0
KR_7762780214,17529,14369,247,247,12,3,3,12,9,4,0,0,0,0,16,21,3,3,0,0,1,0,0,0,0,0,10,540278,3160,0,9,-9,5,0,0,-5,0,0
KR_7762788075,15935,14536,264,275,7,3,3,7,7,2,0,0,0,0,16,99,2,0,3,2,1,0,0,0,0,0,10,540255,1399,-11,4,-4,5,0,0,-83,2,1
KR_7762796122,16958,16924,279,278,9,8,8,9,8,8,0,0,0,0,17,30,1,3,0,1,1,0,0,0,0,0,10,540230,34,1,1,-1,0,0,0,-13,-2,-1
KR_7762798857,13904,18659,215,247,4,15,15,4,7,14,0,0,0,0,9,14,2,0,0,1,0,1,0,0,0,0,10,540272,-4755,-32,-11,11,-7,0,0,-5,2,-1
KR_7762801167,15966,13679,258,261,7,2,2,7,11,4,0,1,0,0,17,11,2,6,0,1,1,0,0,1,0,0,10,540243,2287,-3,5,-5,7,-1,0,6,-4,-1
KR_7762813685,14719,13221,274,256,4,1,1,4,4,1,0,1,0,0,15,17,4,3,0,1,0,1,0,1,0,0,10,540289,1498,18,3,-3,3,-1,0,-2,1,-1
KR_7762813818,12766,14682,245,256,1,5,5,1,0,2,0,0,0,0,108,24,5,3,0,1,0,1,0,0,0,0,10,540233,-1916,-11,-4,4,-2,0,0,84,2,-1
KR_7762826126,15802,14745,246,255,7,5,5,7,5,8,0,1,0,0,13,19,3,1,0,0,0,1,0,1,0,0,10,540300,1057,-9,2,-2,-3,-1,0,-6,2,0
KR_7762848223,13878,17262,240,274,3,8,8,3,3,13,0,0,0,0,26,19,1,0,0,1,0,1,0,0,0,0,10,540255,-3384,-34,-5,5,-10,0,0,7,1,-1
KR_7762855884,15628,14645,287,270,5,3,3,5,6,2,0,0,0,0,13,18,4,2,0,0,1,0,0,0,0,0,10,540244,983,17,2,-2,4,0,0,-5,2,0
KR_7762858234,15602,16110,242,227,8,10,10,8,7,12,1,0,0,0,14,16,4,1,0,1,1,0,1,0,0,0,10,540257,-508,15,-2,2,-5,1,0,-2,3,-1
KR_7762860201,15174,15712,244,231,6,8,8,6,8,9,0,0,0,0,32,15,1,4,0,0,0,1,0,0,0,0,10,540215,-538,13,-2,2,-1,0,0,17,-3,0
KR_7762877116,12627,17228,259,258,0,9,9,0,0,20,0,1,0,0,18,17,3,4,0,3,0,1,0,1,0,0,10,540235,-4601,1,-9,9,-20,-1,0,1,-1,-3
KR_7762879782,16241,14952,273,243,7,4,4,7,9,4,0,0,0,0,37,15,0,1,0,2,1,0,0,0,0,0,10,540195,1289,30,3,-3,5,0,0,22,-1,-2
KR_7762883907,15195,13561,262,266,5,1,1,5,4,1,0,0,0,0,13,18,4,0,1,0,1,0,0,0,0,0,10,540234,1634,-4,4,-4,3,0,0,-5,4,1
KR_7762897009,14163,17131,227,267,5,9,9,5,7,11,0,0,0,0,159,18,3,5,0,0,0,1,0,0,0,0,10,540253,-2968,-40,-4,4,-4,0,0,141,-2,0
KR_7762899330,15805,16939,284,295,4,8,8,4,8,8,0,0,0,0,15,16,3,6,1,1,0,1,0,0,0,0,10,540234,-1134,-11,-4,4,0,0,0,-1,-3,0
KR_7762912730,13579,17099,210,259,3,11,11,3,4,7,0,0,0,0,18,16,3,4,0,2,0,1,0,0,0,0,10,540270,-3520,-49,-8,8,-3,0,0,2,-1,-2
KR_7762927147,15916,15343,276,244,8,6,6,8,5,7,1,0,0,0,18,23,2,5,0,2,0,1,1,0,0,0,10,540214,573,32,2,-2,-2,1,0,-5,-3,-2
KR_7762977871,16061,15429,294,277,6,5,5,6,6,4,0,0,0,0,17,37,3,4,1,0,0,1,0,0,0,0,10,540215,632,17,1,-1,2,0,0,-20,-1,1
KR_7762987177,14392,15019,236,259,4,5,5,4,5,8,0,0,0,0,15,15,3,4,1,1,0,1,0,0,0,0,10,540096,-627,-23,-1,1,-3,0,0,0,-1,0
KR_7763010371,15468,14572,253,242,7,5,5,7,10,6,0,1,0,0,17,23,2,2,0,0,1,0,0,1,0,0,10,540218,896,11,2,-2,4,-1,0,-6,0,0
KR_7763012929,15663,15973,273,233,5,8,9,5,6,9,1,0,0,0,42,33,1,11,2,1,0,1,1,0,0,0,10,540187,-310,40,-3,4,-3,1,0,9,-10,1
KR_7763014885,13991,14170,258,248,3,4,4,3,4,7,1,0,0,0,16,15,2,6,0,0,1,0,1,0,0,0,10,540237,-179,10,-1,1,-3,1,0,1,-4,0
KR_7763015389,16295,14527,278,272,8,3,3,8,5,1,0,0,0,0,13,15,2,2,1,0,1,0,0,0,0,0,10,540247,1768,6,5,-5,4,0,0,-2,0,1
KR_7763017444,16565,16915,257,267,9,9,9,9,10,12,0,0,0,0,15,18,6,3,1,1,1,0,0,0,0,0,10,540248,-350,-10,0,0,-2,0,0,-3,3,0
KR_7763030622,16601,16369,245,262,9,7,7,9,8,10,0,0,0,0,12,16,3,2,1,0,1,0,0,0,0,0,10,540259,232,-17,2,-2,-2,0,0,-4,1,1
KR_7763039416,15333,14224,277,290,5,3,3,5,5,1,0,0,0,0,36,18,1,2,0,0,1,0,0,0,0,0,10,540210,1109,-13,2,-2,4,0,0,18,-1,0
KR_7763050050,14723,14603,261,277,4,3,3,4,4,3,0,0,0,0,31,45,23,1,1,0,0,1,0,0,0,0,10,540249,120,-16,1,-1,1,0,0,-14,22,1
KR_7763055314,15353,16512,246,255,6,9,9,6,5,9,0,1,0,0,11,13,3,3,0,1,0,1,0,1,0,0,10,540279,-1159,-9,-3,3,-4,-1,0,-2,0,-1
KR_7763064574,15807,15395,250,247,6,6,6,6,8,13,0,1,0,0,12,15,4,2,0,1,0,1,0,1,0,0,10,540184,412,3,0,0,-5,-1,0,-3,2,-1
KR_7763071627,14288,14834,297,296,2,2,2,2,2,2,1,0,0,0,13,26,4,1,0,2,1,0,1,0,0,0,10,540107,-546,1,0,0,0,1,0,-13,3,-2
KR_7763075425,15825,12942,284,272,5,0,0,5,8,0,0,0,0,0,14,29,2,2,1,0,1,0,0,0,0,0,10,540222,2883,12,5,-5,8,0,0,-15,0,1
KR_7763081491,15725,15998,252,238,6,8,8,6,13,9,0,0,0,0,29,15,1,1,0,0,0,1,0,0,0,0,10,540194,-273,14,-2,2,4,0,0,14,0,0
KR_7763085303,13383,18299,220,253,4,14,14,4,2,16,0,0,0,0,12,32,3,1,0,0,1,0,0,0,0,0,10,540251,-4916,-33,-10,10,-14,0,0,-20,2,0
KR_7763103114,18211,16558,270,272,11,7,7,11,9,4,0,0,0,0,12,11,2,1,0,3,0,1,0,0,0,0,10,540231,1653,-2,4,-4,5,0,0,1,1,-3
KR_7763108122,16054,16636,278,244,6,8,8,6,8,7,0,0,0,0,16,124,1,4,2,3,1,0,0,0,0,0,10,540115,-582,34,-2,2,1,0,0,-108,-3,-1
KR_7763114515,14961,17080,226,231,5,11,11,5,9,12,0,1,0,0,35,25,3,4,0,0,0,1,0,1,0,0,10,540245,-2119,-5,-6,6,-3,-1,0,10,-1,0
KR_7763126360,16463,15825,298,241,5,8,8,5,3,8,0,1,0,0,34,28,3,15,3,0,0,1,0,1,0,0,10,540230,638,57,-3,3,-5,-1,0,6,-12,3
KR_7763132582,15392,13874,276,293,5,1,1,5,3,2,1,0,0,0,14,15,3,5,0,0,1,0,1,0,0,0,10,540215,1518,-17,4,-4,1,1,0,-1,-2,0
KR_7763133667,14793,14839,265,276,4,4,4,4,6,4,0,0,0,0,19,17,3,4,1,0,0,1,0,0,0,0,10,540194,-46,-11,0,0,2,0,0,2,-1,1
KR_7763137679,16495,14690,276,252,7,4,4,7,4,9,0,0,0,0,19,18,4,4,3,1,0,1,0,0,0,0,10,540227,1805,24,3,-3,-5,0,0,1,0,2
KR_7763147241,14722,13138,255,252,5,1,1,5,3,2,0,0,0,0,15,29,4,3,2,1,1,0,0,0,0,0,10,540253,1584,3,4,-4,1,0,0,-14,1,1
KR_7763156932,15841,14869,301,261,5,4,4,5,4,5,1,0,0,0,35,127,3,2,2,0,1,0,1,0,0,0,10,540240,972,40,1,-1,-1,1,0,-92,1,2
KR_7763174762,15672,16181,260,275,7,7,7,7,6,6,0,0,0,0,14,22,3,3,1,2,1,0,0,0,0,0,10,540281,-509,-15,0,0,0,0,0,-8,0,-1
KR_7763195001,15433,14491,248,255,6,4,5,6,6,5,0,0,0,0,20,18,3,7,1,1,1,0,0,0,0,0,10,540279,942,-7,2,-1,1,0,0,2,-4,0
KR_7763200072,18199,18879,252,276,11,14,14,11,11,10,0,1,0,0,18,16,1,2,0,0,0,1,0,1,0,0,10,540218,-680,-24,-3,3,1,-1,0,2,-1,0
KR_7763200498,14649,15688,210,236,6,7,7,6,6,11,0,0,0,0,15,48,5,5,0,2,1,0,0,0,0,0,10,540231,-1039,-26,-1,1,-5,0,0,-33,0,-2
KR_7763204570,16145,13535,312,260,6,2,2,6,2,1,1,0,0,0,26,97,2,5,0,0,1,0,1,0,0,0,10,540236,2610,52,4,-4,1,1,0,-71,-3,0
KR_7763208131,15044,15434,255,291,6,4,4,6,6,3,1,0,0,0,15,16,2,3,0,2,0,1,1,0,0,0,10,540234,-390,-36,2,-2,3,1,0,-1,-1,-2
KR_7763219082,15832,15294,238,268,7,5,5,7,15,6,0,1,0,0,18,16,4,3,1,0,1,0,0,1,0,0,10,540095,538,-30,2,-2,9,-1,0,2,1,1
KR_7763220229,13225,14453,267,294,1,3,3,1,1,1,0,0,0,0,13,13,2,6,0,2,1,0,0,0,0,0,10,540238,-1228,-27,-2,2,0,0,0,0,-4,-2
KR_7763221489,15482,16852,240,264,7,10,10,7,6,8,0,0,0,0,16,12,2,1,0,0,1,0,0,0,0,0,10,540229,-1370,-24,-3,3,-2,0,0,4,1,0
KR_7763239695,15867,14994,272,294,6,4,4,6,8,2,0,1,0,0,17,201,4,2,0,0,1,0,0,1,0,0,10,540238,873,-22,2,-2,6,-1,0,-184,2,0
KR_7763242792,14167,16444,257,259,3,7,7,3,3,9,0,0,0,0,13,36,8,1,0,0,0,1,0,0,0,0,10,540219,-2277,-2,-4,4,-6,0,0,-23,7,0
KR_7763249079,19640,16903,252,232,15,11,11,15,12,9,0,0,0,0,15,16,0,3,1,0,0,1,0,0,0,0,10,540238,2737,20,4,-4,3,0,0,-1,-3,1
KR_7763259768,16637,16466,210,248,9,8,8,9,20,8,0,0,0,0,17,19,3,5,0,0,0,1,0,0,0,0,10,540232,171,-38,1,-1,12,0,0,-2,-2,0
KR_7763263482,14865,12987,296,239,3,2,2,3,4,0,0,0,0,0,16,47,5,2,0,0,1,0,0,0,0,0,10,540189,1878,57,1,-1,4,0,0,-31,3,0
KR_7763272490,16289,15331,253,266,9,6,6,9,10,5,0,0,0,0,29,16,2,3,1,1,1,0,0,0,0,0,10,540286,958,-13,3,-3,5,0,0,13,-1,0
KR_7763273621,14520,14787,257,272,4,5,5,4,5,3,0,1,0,0,14,15,3,3,0,1,0,1,0,1,0,0,10,540213,-267,-15,-1,1,2,-1,0,-1,0,-1
KR_7763288488,13708,13934,255,278,3,2,2,3,4,3,1,0,0,0,13,17,1,3,0,0,1,0,1,0,0,0,10,540219,-226,-23,1,-1,1,1,0,-4,-2,0
KR_7763296901,16994,15294,262,256,9,5,5,9,14,10,0,1,0,0,13,42,4,0,0,1,1,0,0,1,0,0,10,540290,1700,6,4,-4,4,-1,0,-29,4,-1
KR_7763329477,13726,12917,230,255,4,0,0,4,6,0,0,0,0,0,136,16,4,2,0,1,1,0,0,0,0,0,10,540209,809,-25,4,-4,6,0,0,120,2,-1
KR_7763335054,14840,13779,265,261,4,2,2,4,8,3,0,0,0,0,15,31,4,4,0,1,0,1,0,0,0,0,10,540286,1061,4,2,-2,5,0,0,-16,0,-1
KR_7763335689,17142,16519,236,234,10,9,9,10,9,14,0,0,0,0,14,21,3,2,4,1,1,0,0,0,0,0,10,540254,623,2,1,-1,-5,0,0,-7,1,3
KR_7763340644,14692,16401,236,278,5,8,8,5,4,6,0,0,0,0,24,14,2,1,1,1,1,0,0,0,0,0,10,540213,-1709,-42,-3,3,-2,0,0,10,1,0
KR_7763361838,14940,17671,250,251,6,11,11,6,4,17,0,1,0,0,250,14,2,2,0,1,0,1,0,1,0,0,10,540255,-2731,-1,-5,5,-13,-1,0,236,0,-1
KR_7763363804,16139,13495,240,237,9,2,2,9,12,3,0,0,0,0,20,24,4,2,1,0,1,0,0,0,0,0,10,540225,2644,3,7,-7,9,0,0,-4,2,1
KR_7763379159,14496,13557,261,253,4,3,3,4,4,4,0,1,0,0,189,13,1,2,2,0,1,0,0,1,0,0,10,540202,939,8,1,-1,0,-1,0,176,-1,2
KR_7763392241,16978,17124,236,232,9,13,13,9,12,16,0,1,0,0,12,17,4,1,0,0,0,1,0,1,0,0,10,540227,-146,4,-4,4,-4,-1,0,-5,3,0
KR_7763399570,16143,16365,278,240,5,8,8,5,7,10,0,0,0,0,13,16,4,3,4,0,1,0,0,0,0,0,10,540237,-222,38,-3,3,-3,0,0,-3,1,4
KR_7763408195,14531,12786,263,265,4,0,0,5,3,0,0,0,0,0,23,28,4,2,0,0,1,0,0,0,0,0,10,540210,1745,-2,4,-5,3,0,0,-5,2,0
KR_7763410320,16463,13577,240,265,8,1,1,8,10,1,0,0,0,0,21,34,2,6,1,1,1,0,0,0,0,0,10,540234,2886,-25,7,-7,9,0,0,-13,-4,0
KR_7763419582,14575,15544,252,233,4,6,7,4,2,9,0,0,0,0,19,14,0,5,2,0,0,1,0,0,0,0,10,540204,-969,19,-2,3,-7,0,0,5,-5,2
KR_7763428687,16454,16187,247,240,9,7,7,9,12,7,1,0,0,0,16,10,0,1,1,0,1,0,1,0,0,0,10,540195,267,7,2,-2,5,1,0,6,-1,1
KR_7763429544,15762,15592,241,258,8,6,6,8,7,4,0,0,0,0,19,28,5,3,0,0,1,0,0,0,0,0,10,540237,170,-17,2,-2,3,0,0,-9,2,0
KR_7763431359,15744,11874,248,221,8,0,0,8,7,0,0,0,0,0,13,15,2,2,2,0,1,0,0,0,0,0,10,540095,3870,27,8,-8,7,0,0,-2,0,2
KR_7763438006,14515,16349,269,292,5,6,6,5,0,5,0,0,0,0,15,22,6,2,1,2,0,1,0,0,0,0,10,540241,-1834,-23,-1,1,-5,0,0,-7,4,-1
KR_7763448907,16308,16489,285,282,6,7,7,6,6,8,0,1,0,0,26,17,2,1,0,2,1,0,0,1,0,0,10,540202,-181,3,-1,1,-2,-1,0,9,1,-2
KR_7763456222,16667,16194,251,235,9,8,8,9,12,11,0,0,0,0,20,24,5,3,0,1,0,1,0,0,0,0,10,540211,473,16,1,-1,1,0,0,-4,2,-1
KR_7763481458,16559,14469,248,277,9,3,3,9,9,2,0,1,0,0,20,10,2,3,0,0,1,0,0,1,0,0,10,540135,2090,-29,6,-6,7,-1,0,10,-1,0
KR_7763496415,16407,13973,283,276,7,2,3,7,9,1,0,0,0,0,18,22,2,3,0,0,1,0,0,0,0,0,10,540187,2434,7,5,-4,8,0,0,-4,-1,0
KR_7763501713,16783,15838,257,244,8,7,8,8,8,11,0,0,0,0,54,20,2,5,2,0,1,0,0,0,0,0,10,540103,945,13,1,0,-3,0,0,34,-3,2
KR_7763505772,15360,15792,260,272,6,5,5,6,8,6,0,0,0,0,35,35,2,2,0,2,1,0,0,0,0,0,10,540188,-432,-12,1,-1,2,0,0,0,0,-2
KR_7763513332,14700,15480,227,256,6,8,8,6,8,3,0,0,0,0,13,15,6,1,0,1,0,1,0,0,0,0,10,540227,-780,-29,-2,2,5,0,0,-2,5,-1
KR_7763515344,14776,16297,249,260,4,7,7,5,4,9,0,0,0,0,15,32,2,2,1,0,0,1,0,0,0,0,10,540187,-1521,-11,-3,2,-5,0,0,-17,0,1
KR_7763520448,17139,15487,273,244,9,7,7,9,8,5,0,1,0,0,20,24,3,5,2,0,1,0,0,1,0,0,10,540222,1652,29,2,-2,3,-1,0,-4,-2,2
KR_7763530867,16510,13918,262,251,7,3,3,7,7,5,0,0,0,0,16,14,4,4,1,0,1,0,0,0,0,0,10,540241,2592,11,4,-4,2,0,0,2,0,1
KR_7763530880,14928,15291,266,245,5,7,7,5,3,6,0,0,0,0,15,19,2,2,1,0,1,0,0,0,0,0,10,540244,-363,21,-2,2,-3,0,0,-4,0,1
KR_7763537949,17854,14955,270,235,11,5,5,12,9,7,0,0,0,0,20,19,4,3,0,0,1,0,0,0,0,0,10,540120,2899,35,6,-7,2,0,0,1,1,0
KR_7763550936,15407,15456,272,243,5,8,8,5,3,8,0,1,0,0,17,110,2,6,1,0,0,1,0,1,0,0,10,540222,-49,29,-3,3,-5,-1,0,-93,-4,1
KR_7763552530,13951,15902,225,268,4,7,7,4,6,5,0,0,0,0,14,24,4,0,0,2,1,0,0,0,0,0,10,540228,-1951,-43,-3,3,1,0,0,-10,4,-2
KR_7763555010,17981,12769,284,224,10,2,2,10,14,0,0,0,0,0,17,22,5,1,1,0,1,0,0,0,0,0,10,540250,5212,60,8,-8,14,0,0,-5,4,1
KR_7763558084,15953,14700,274,264,6,4,5,6,7,5,0,1,0,0,16,18,1,1,1,0,0,1,0,1,0,0,10,540269,1253,10,2,-1,2,-1,0,-2,0,1
KR_7763585706,15085,17957,255,249,6,11,11,6,7,15,0,0,0,0,13,35,4,3,0,1,1,0,0,0,0,0,10,540226,-2872,6,-5,5,-8,0,0,-22,1,-1
KR_7763589672,16606,14289,271,285,9,2,2,9,9,2,0,1,0,0,16,12,3,4,1,1,1,0,0,1,0,0,10,540288,2317,-14,7,-7,7,-1,0,4,-1,0
KR_7763596461,15945,15603,261,256,6,7,7,6,9,6,1,0,0,0,140,21,4,2,0,1,0,1,1,0,0,0,10,540300,342,5,-1,1,3,1,0,119,2,-1
KR_7763604590,16396,15791,293,268,7,7,7,7,5,9,0,0,0,0,33,28,4,3,0,0,0,1,0,0,0,0,10,540219,605,25,0,0,-4,0,0,5,1,0
KR_7763609882,13641,14159,256,258,2,3,3,2,2,2,0,1,0,0,17,12,3,4,0,1,1,0,0,1,0,0,10,540243,-518,-2,-1,1,0,-1,0,5,-1,-1
KR_7763624991,14966,14833,293,272,3,5,5,3,4,5,0,1,0,0,13,14,3,3,0,0,0,1,0,1,0,0,10,540265,133,21,-2,2,-1,-1,0,-1,0,0
KR_7763626506,15261,15282,293,265,3,5,5,3,4,3,0,0,0,0,34,135,2,0,1,0,0,1,0,0,0,0,10,540189,-21,28,-2,2,1,0,0,-101,2,1
KR_7763631797,15341,15349,284,264,4,7,7,4,4,4,0,0,0,0,14,13,1,1,1,0,1,0,0,0,0,0,10,540222,-8,20,-3,3,0,0,0,1,0,1
KR_7763641632,15519,14301,215,232,8,4,4,8,10,4,0,1,0,0,39,22,4,6,0,1,1,0,0,1,0,0,10,540209,1218,-17,4,-4,6,-1,0,17,-2,-1
KR_7763651311,14947,16785,270,284,3,7,7,3,5,6,1,0,0,0,32,18,6,1,2,1,0,1,1,0,0,0,10,540211,-1838,-14,-4,4,-1,1,0,14,5,1
KR_7763651339,14333,15320,308,280,2,5,5,2,1,2,1,0,0,0,16,34,3,1,0,1,0,1,1,0,0,0,10,540213,-987,28,-3,3,-1,1,0,-18,2,-1
KR_7763656520,14865,15227,289,268,4,5,5,4,1,5,0,0,0,0,16,15,3,1,0,0,1,0,0,0,0,0,10,540221,-362,21,-1,1,-4,0,0,1,2,0
KR_7763663888,16391,17146,217,226,10,13,13,10,8,12,0,0,0,0,19,34,2,2,1,1,1,0,0,0,0,0,10,540284,-755,-9,-3,3,-4,0,0,-15,0,0
KR_7763679472,16034,16102,241,252,8,7,8,8,10,9,0,0,0,0,14,20,2,2,0,2,1,0,0,0,0,0,10,540230,-68,-11,1,0,1,0,0,-6,0,-2
KR_7763683794,15007,15359,230,235,7,7,8,7,6,5,0,0,0,0,185,23,3,5,0,1,1,0,0,0,0,0,10,540228,-352,-5,0,1,1,0,0,162,-2,-1
KR_7763684223,15393,15122,293,255,5,5,5,5,6,9,1,0,0,0,26,110,8,5,0,0,1,0,1,0,0,0,10,540236,271,38,0,0,-3,1,0,-84,3,0
KR_7763694902,16523,15014,287,288,8,4,4,8,8,3,0,1,0,0,14,15,4,2,0,0,0,1,0,1,0,0,10,540093,1509,-1,4,-4,5,-1,0,-1,2,0
KR_7763703405,13566,16684,238,268,4,8,9,4,1,8,1,0,0,0,15,18,1,4,0,3,0,1,1,0,0,0,10,540280,-3118,-30,-4,5,-7,1,0,-3,-3,-3
KR_7763720400,14767,13912,273,288,4,1,1,4,5,1,0,1,0,0,15,16,5,2,0,0,1,0,0,1,0,0,10,540187,855,-15,3,-3,4,-1,0,-1,3,0
KR_7763724913,15655,16050,252,244,6,9,9,6,7,5,0,0,0,0,17,20,3,6,0,1,1,0,0,0,0,0,10,540189,-395,8,-3,3,2,0,0,-3,-3,-1
KR_7763732412,16225,14496,246,255,8,3,3,8,7,4,0,0,0,0,12,18,3,4,1,1,1,0,0,0,0,0,10,540208,1729,-9,5,-5,3,0,0,-6,-1,0
KR_7763740048,15221,15959,260,261,6,7,7,6,4,6,0,0,0,0,140,12,2,1,2,1,0,1,0,0,0,0,10,540104,-738,-1,-1,1,-2,0,0,128,1,1
KR_7763749532,15658,14085,299,294,5,2,2,5,6,1,0,0,0,0,16,16,4,2,0,0,0,1,0,0,0,0,10,540252,1573,5,3,-3,5,0,0,0,2,0
KR_7763755249,17645,15639,230,239,13,6,6,13,18,7,0,0,0,0,19,16,3,6,0,0,1,0,0,0,0,0,10,540089,2006,-9,7,-7,11,0,0,3,-3,0
KR_7763761689,13817,16512,272,285,2,7,7,2,0,7,0,0,0,0,19,17,3,3,0,1,0,1,0,0,0,0,10,540110,-2695,-13,-5,5,-7,0,0,2,0,-1
KR_7763761794,16480,15501,268,275,7,5,5,7,10,11,0,0,0,0,86,13,2,4,3,0,1,0,0,0,0,0,10,540283,979,-7,2,-2,-1,0,0,73,-2,3
KR_7763764340,14814,14031,259,280,3,2,2,3,4,1,0,0,0,0,23,19,0,3,1,0,1,0,0,0,0,0,10,540233,783,-21,1,-1,3,0,0,4,-3,1
KR_7763770327,18867,15644,258,247,12,6,6,12,19,7,0,0,0,0,17,36,2,1,2,0,0,1,0,0,0,0,10,540223,3223,11,6,-6,12,0,0,-19,1,2
KR_7763771816,15005,15139,278,273,3,5,6,3,4,7,1,0,0,0,154,18,2,3,0,0,1,0,1,0,0,0,10,540217,-134,5,-2,3,-3,1,0,136,-1,0
KR_7763778248,18694,16126,280,221,12,6,6,12,11,9,0,0,0,0,12,22,2,0,0,2,1,0,0,0,0,0,10,540102,2568,59,6,-6,2,0,0,-10,2,-2
KR_7763783441,15467,13728,296,283,4,1,1,4,5,0,0,1,0,0,14,22,5,0,0,0,1,0,0,1,0,0,10,540210,1739,13,3,-3,5,-1,0,-8,5,0
KR_7763799079,14921,15288,256,234,5,7,7,5,1,9,0,0,0,0,11,38,3,1,0,0,0,1,0,0,0,0,10,540230,-367,22,-2,2,-8,0,0,-27,2,0
KR_7763805229,14571,14903,244,256,5,4,4,5,3,4,0,0,0,0,37,17,2,1,0,0,0,1,0,0,0,0,10,540248,-332,-12,1,-1,-1,0,0,20,1,0
KR_7763805450,15149,15327,293,271,4,5,5,4,3,7,0,1,0,0,13,13,2,1,0,0,0,1,0,1,0,0,10,540265,-178,22,-1,1,-4,-1,0,0,1,0
KR_7763811708,15645,14507,253,230,6,5,5,7,5,3,1,0,0,0,17,37,2,5,2,1,1,0,1,0,0,0,10,540241,1138,23,1,-2,2,1,0,-20,-3,1
KR_7763813002,16281,14097,278,258,8,3,3,8,5,2,0,1,0,0,18,17,2,1,0,1,1,0,0,1,0,0,10,540226,2184,20,5,-5,3,-1,0,1,1,-1
KR_7763813869,15926,16136,229,290,8,7,7,8,9,5,0,0,0,0,31,27,4,4,1,2,0,1,0,0,0,0,10,540220,-210,-61,1,-1,4,0,0,4,0,-1
KR_7763814197,13980,17707,213,243,4,12,12,4,3,14,0,0,0,0,14,17,2,2,0,0,0,1,0,0,0,0,10,540170,-3727,-30,-8,8,-11,0,0,-3,0,0
KR_7763823722,16423,14877,249,246,9,6,6,9,6,4,0,0,0,0,16,15,0,1,3,1,1,0,0,0,0,0,10,540244,1546,3,3,-3,2,0,0,1,-1,2
KR_7763824781,19925,14557,248,237,17,4,4,17,21,4,1,0,0,0,15,17,3,3,2,1,1,0,1,0,0,0,10,540188,5368,11,13,-13,17,1,0,-2,0,1
KR_7763826865,15309,15660,264,260,5,6,6,5,6,5,0,0,0,0,19,19,1,6,0,0,0,1,0,0,0,0,10,540207,-351,4,-1,1,1,0,0,0,-5,0
KR_7763833586,14405,17306,252,235,4,11,11,4,4,19,0,0,0,0,16,34,1,4,1,0,0,1,0,0,0,0,10,540230,-2901,17,-7,7,-15,0,0,-18,-3,1
KR_7763842281,16904,16070,257,210,9,10,10,10,11,8,0,0,0,0,64,16,3,0,3,2,0,1,0,0,0,0,10,540233,834,47,-1,0,3,0,0,48,3,1
KR_7763842651,15955,14903,252,251,6,5,5,6,10,6,0,0,0,0,17,34,4,2,3,1,1,0,0,0,0,0,10,540244,1052,1,1,-1,4,0,0,-17,2,2
KR_7763846595,15717,16912,256,255,6,9,9,6,5,10,1,0,0,0,17,17,5,6,1,0,0,1,1,0,0,0,10,540194,-1195,1,-3,3,-5,1,0,0,-1,1
KR_7763846927,15349,16234,253,247,3,8,8,3,7,10,0,0,0,0,31,16,3,1,1,1,0,1,0,0,0,0,10,540266,-885,6,-5,5,-3,0,0,15,2,0
KR_7763854070,15384,16070,223,265,7,7,7,7,7,7,0,0,0,0,13,11,1,3,1,0,0,1,0,0,0,0,10,540242,-686,-42,0,0,0,0,0,2,-2,1
KR_7763861745,15165,13732,312,255,3,2,2,3,3,4,1,0,0,0,17,35,4,1,0,1,0,1,1,0,0,0,10,540235,1433,57,1,-1,-1,1,0,-18,3,-1
KR_7763873271,12904,18276,236,269,1,11,11,1,1,12,0,0,0,0,102,15,1,4,0,2,0,1,0,0,0,0,10,540231,-5372,-33,-10,10,-11,0,0,87,-3,-2
KR_7763876348,15836,13867,252,242,8,3,3,8,9,4,0,0,0,0,19,18,6,3,1,0,1,0,0,0,0,0,10,540219,1969,10,5,-5,5,0,0,1,3,1
KR_7763878636,18627,18916,227,213,14,16,16,14,13,25,0,0,0,0,16,25,1,2,1,0,0,1,0,0,0,0,10,540197,-289,14,-2,2,-12,0,0,-9,-1,1
KR_7763879364,16151,14640,287,296,7,3,3,7,6,3,0,0,0,0,142,16,3,4,0,0,1,0,0,0,0,0,10,540221,1511,-9,4,-4,3,0,0,126,-1,0
KR_7763883090,17756,14585,268,245,11,5,5,11,20,4,1,0,0,0,19,121,4,5,2,0,1,0,1,0,0,0,10,540253,3171,23,6,-6,16,1,0,-102,-1,2
KR_7763887514,15592,16546,263,245,6,8,8,6,5,7,0,1,0,0,15,108,1,1,1,2,0,1,0,1,0,0,10,540211,-954,18,-2,2,-2,-1,0,-93,0,-1
KR_7763902462,15459,13418,334,270,3,1,1,3,1,1,1,0,0,0,30,15,4,3,1,0,1,0,1,0,0,0,10,540210,2041,64,2,-2,0,1,0,15,1,1
KR_7763906384,14409,15458,272,237,3,7,7,3,2,7,0,0,0,0,38,15,2,5,0,0,0,1,0,0,0,0,10,540209,-1049,35,-4,4,-5,0,0,23,-3,0
KR_7763911161,15862,16452,248,232,7,9,9,7,8,12,0,0,0,0,22,39,2,4,3,0,1,0,0,0,0,0,10,540199,-590,16,-2,2,-4,0,0,-17,-2,3
KR_7763911229,15297,17705,244,232,7,10,10,7,8,17,0,0,0,0,17,14,0,1,1,0,0,1,0,0,0,0,10,540232,-2408,12,-3,3,-9,0,0,3,-1,1
KR_7763911865,13701,16321,258,254,2,8,8,2,1,10,0,0,0,0,12,15,5,1,1,1,0,1,0,0,0,0,10,540195,-2620,4,-6,6,-9,0,0,-3,4,0
KR_7763915816,15590,14297,251,250,9,4,4,10,6,4,1,0,0,0,15,41,2,4,2,0,1,0,1,0,0,0,10,540224,1293,1,5,-6,2,1,0,-26,-2,2
KR_7763919619,16233,14728,271,261,7,3,3,7,10,5,1,0,0,0,19,16,3,5,2,0,1,0,1,0,0,0,10,540210,1505,10,4,-4,5,1,0,3,-2,2
KR_7763925507,15132,15392,265,265,5,7,8,5,2,5,0,1,0,0,13,22,2,3,0,0,1,0,0,1,0,0,10,540240,-260,0,-2,3,-3,-1,0,-9,-1,0
KR_7763930530,16369,14592,249,279,9,2,2,9,10,3,0,0,0,0,29,15,3,0,1,0,1,0,0,0,0,0,10,540223,1777,-30,7,-7,7,0,0,14,3,1
KR_7763932582,17129,13922,295,241,11,3,3,11,8,3,0,0,0,0,14,15,3,2,1,0,1,0,0,0,0,0,10,540247,3207,54,8,-8,5,0,0,-1,1,1
KR_7763932703,17312,14275,275,244,12,4,5,12,8,1,1,0,0,0,16,16,2,1,0,0,0,1,1,0,0,0,10,540125,3037,31,8,-7,7,1,0,0,1,0
KR_7763944650,14561,15613,260,269,3,6,6,3,5,3,0,0,0,0,123,16,4,2,0,3,1,0,0,0,0,0,10,540234,-1052,-9,-3,3,2,0,0,107,2,-3
KR_7763947757,14388,16524,251,246,4,10,10,4,2,12,0,1,0,0,13,17,2,1,0,3,0,1,0,1,0,0,10,540272,-2136,5,-6,6,-10,-1,0,-4,1,-3
KR_7763957708,17880,14930,255,211,11,7,7,11,10,9,0,1,0,0,13,16,5,1,2,0,1,0,0,1,0,0,10,540199,2950,44,4,-4,1,-1,0,-3,4,2
KR_7763958466,14704,15471,203,238,7,8,8,7,6,9,0,0,0,0,18,13,0,2,0,0,1,0,0,0,0,0,10,540107,-767,-35,-1,1,-3,0,0,5,-2,0
KR_7763972974,15437,16545,287,259,5,8,8,5,6,12,0,1,0,0,34,16,6,2,0,2,1,0,0,1,0,0,10,540250,-1108,28,-3,3,-6,-1,0,18,4,-2
KR_7763977760,15759,16414,253,240,6,10,10,6,6,17,0,1,0,0,20,23,2,4,1,0,0,1,0,1,0,0,10,540104,-655,13,-4,4,-11,-1,0,-3,-2,1
KR_7763979586,14507,16966,231,266,5,10,10,5,6,11,0,0,0,0,17,18,5,4,1,3,0,1,0,0,0,0,10,540213,-2459,-35,-5,5,-5,0,0,-1,1,-2
KR_7763995150,15666,16158,249,266,6,7,7,6,6,5,0,0,0,0,36,15,2,3,1,0,0,1,0,0,0,0,10,540216,-492,-17,-1,1,1,0,0,21,-1,1
KR_7763997221,16669,14498,274,257,8,4,4,8,8,3,1,0,0,0,42,18,4,3,1,1,1,0,1,0,0,0,10,540243,2171,17,4,-4,5,1,0,24,1,0
KR_7764013256,15919,14037,275,247,5,3,3,5,6,4,0,0,0,0,14,15,4,4,2,0,1,0,0,0,0,0,10,540199,1882,28,2,-2,2,0,0,-1,0,2
KR_7764015287,15608,14274,278,278,6,2,2,6,6,3,0,0,0,0,13,14,4,3,2,0,0,1,0,0,0,0,10,540224,1334,0,4,-4,3,0,0,-1,1,2
KR_7764020963,13848,15937,236,255,3,7,7,3,4,9,0,0,0,0,11,16,3,1,0,0,0,1,0,0,0,0,10,540249,-2089,-19,-4,4,-5,0,0,-5,2,0
KR_7764050781,15888,15957,265,266,6,6,6,7,5,4,0,0,0,0,45,33,3,3,2,2,1,0,0,0,0,0,10,540211,-69,-1,0,-1,1,0,0,12,0,0
KR_7764074141,15918,14626,292,240,5,6,6,6,5,4,0,0,0,0,15,21,4,1,1,0,0,1,0,0,0,0,10,540188,1292,52,-1,0,1,0,0,-6,3,1
KR_7764098697,16526,14260,254,227,7,5,5,7,12,3,0,0,0,0,12,16,8,3,1,1,1,0,0,0,0,0,10,540210,2266,27,2,-2,9,0,0,-4,5,0
KR_7764111972,15850,15494,210,227,8,9,9,8,8,6,0,0,0,0,29,17,5,4,1,0,0,1,0,0,0,0,10,540212,356,-17,-1,1,2,0,0,12,1,1
KR_7764113279,15553,16512,259,215,6,10,10,6,5,12,0,0,0,0,20,15,4,4,1,0,0,1,0,0,0,0,10,540077,-959,44,-4,4,-7,0,0,5,0,1
KR_7764131291,17157,14766,257,222,9,6,6,9,12,10,0,1,0,0,18,37,8,5,1,0,1,0,0,1,0,0,10,540266,2391,35,3,-3,2,-1,0,-19,3,1
KR_7764146635,14632,14169,268,281,3,2,2,3,4,2,0,0,0,0,17,17,2,0,0,0,0,1,0,0,0,0,10,540209,463,-13,1,-1,2,0,0,0,2,0
KR_7764155932,14242,13873,271,256,3,3,3,3,2,2,0,0,0,0,17,12,6,1,0,0,0,1,0,0,0,0,10,540227,369,15,0,0,0,0,0,5,5,0
KR_7764167028,14454,14316,259,276,4,4,4,4,2,1,0,0,0,0,38,16,2,4,0,1,0,1,0,0,0,0,10,540274,138,-17,0,0,1,0,0,22,-2,-1
KR_7764175591,15081,15221,275,296,5,4,4,5,8,2,0,0,0,0,14,22,3,3,0,1,1,0,0,0,0,0,10,540263,-140,-21,1,-1,6,0,0,-8,0,-1
KR_7764195171,17261,17285,253,236,9,11,11,9,11,13,0,0,0,0,18,16,3,1,3,0,0,1,0,0,0,0,10,540251,-24,17,-2,2,-2,0,0,2,2,3
KR_7764210746,16595,14831,262,278,8,4,4,8,8,2,0,0,0,0,21,18,2,4,0,0,0,1,0,0,0,0,10,540259,1764,-16,4,-4,6,0,0,3,-2,0
KR_7764222095,16424,14025,268,251,8,2,2,8,11,2,0,0,0,0,16,18,3,3,1,0,1,0,0,0,0,0,10,540215,2399,17,6,-6,9,0,0,-2,0,1
KR_7764232965,14635,14561,252,268,4,4,4,4,5,3,1,0,0,0,17,13,1,5,0,1,0,1,1,0,0,0,10,540218,74,-16,0,0,2,1,0,4,-4,-1
KR_7764252456,16971,13823,230,208,11,4,4,11,11,6,0,0,0,0,24,14,1,1,0,0,1,0,0,0,0,0,10,540246,3148,22,7,-7,5,0,0,10,0,0
KR_7764256937,15816,14921,262,262,7,4,4,7,12,5,0,0,0,0,24,24,4,3,0,1,1,0,0,0,0,0,10,540284,895,0,3,-3,7,0,0,0,1,-1
KR_7764257210,13843,13528,234,276,5,2,2,5,2,0,0,0,0,0,12,37,4,2,0,0,0,1,0,0,0,0,10,540194,315,-42,3,-3,2,0,0,-25,2,0
KR_7764287238,17890,12372,291,218,10,1,1,10,14,1,0,0,0,0,15,30,4,0,3,0,1,0,0,0,0,0,10,540222,5518,73,9,-9,13,0,0,-15,4,3
KR_7764306122,15513,15293,265,249,7,7,7,7,5,6,0,1,0,0,20,37,1,2,1,2,0,1,0,1,0,0,10,540189,220,16,0,0,-1,-1,0,-17,-1,-1
KR_7764309387,15260,13807,219,244,8,4,4,8,6,3,0,1,0,0,13,14,0,3,0,0,0,1,0,1,0,0,10,540265,1453,-25,4,-4,3,-1,0,-1,-3,0
KR_7764325703,15105,14988,212,254,6,6,6,6,8,4,0,1,0,0,14,18,1,0,0,0,0,1,0,1,0,0,10,540077,117,-42,0,0,4,-1,0,-4,1,0
KR_7764346268,16768,14259,268,271,7,3,4,8,9,3,0,0,0,0,14,17,5,0,1,0,0,1,0,0,0,0,10,540252,2509,-3,4,-4,6,0,0,-3,5,1
KR_7764347277,16131,14402,241,232,9,5,5,9,11,7,0,0,0,0,19,16,3,2,1,0,0,1,0,0,0,0,10,540136,1729,9,4,-4,4,0,0,3,1,1
KR_7764349543,14056,15073,283,269,2,5,5,2,3,3,1,0,0,0,35,19,6,5,0,0,0,1,1,0,0,0,10,540226,-1017,14,-3,3,0,1,0,16,1,0
KR_7764354065,18086,14073,242,219,14,5,5,14,14,5,0,0,0,0,20,14,2,6,0,0,0,1,0,0,0,0,10,540231,4013,23,9,-9,9,0,0,6,-4,0
KR_7764362762,18826,18162,250,262,11,12,12,11,13,18,0,0,0,0,19,24,3,2,2,0,1,0,0,0,0,0,10,540224,664,-12,-1,1,-5,0,0,-5,1,2
KR_7764371999,14876,14247,247,286,5,2,2,5,4,1,1,0,0,0,14,45,22,0,1,4,1,0,1,0,0,0,10,540208,629,-39,3,-3,3,1,0,-31,22,-3
KR_7764383804,15450,16335,250,256,6,8,8,6,5,10,0,1,0,0,102,13,1,4,1,1,1,0,0,1,0,0,10,540224,-885,-6,-2,2,-5,-1,0,89,-3,0
KR_7764384000,15449,13970,249,227,7,5,5,7,7,3,0,0,0,0,14,18,1,0,0,0,0,1,0,0,0,0,10,540177,1479,22,2,-2,4,0,0,-4,1,0
KR_7764391510,16196,16000,268,216,7,9,9,7,5,7,0,0,0,0,21,13,1,4,1,1,0,1,0,0,0,0,10,540272,196,52,-2,2,-2,0,0,8,-3,0
KR_7764402691,15422,14771,286,254,5,4,4,5,5,4,0,0,0,0,15,16,2,6,0,0,0,1,0,0,0,0,10,540241,651,32,1,-1,1,0,0,-1,-4,0
KR_7764404127,13714,14343,260,263,2,4,4,2,2,7,0,0,0,0,18,18,4,3,1,0,1,0,0,0,0,0,10,540264,-629,-3,-2,2,-5,0,0,0,1,1
KR_7764417390,14062,15129,258,277,3,4,4,3,2,6,0,0,0,0,21,41,1,3,0,0,1,0,0,0,0,0,10,540258,-1067,-19,-1,1,-4,0,0,-20,-2,0
KR_7764421523,15020,14873,239,301,5,3,3,5,5,2,0,1,0,0,18,13,2,7,0,1,0,1,0,1,0,0,10,540219,147,-62,2,-2,3,-1,0,5,-5,-1
KR_7764428928,13531,15450,228,260,3,6,6,3,7,5,0,0,0,0,33,14,1,1,0,2,1,0,0,0,0,0,10,540260,-1919,-32,-3,3,2,0,0,19,0,-2
KR_7764433079,15180,15638,269,227,5,8,8,5,4,10,0,0,0,0,155,28,2,3,0,0,0,1,0,0,0,0,10,540232,-458,42,-3,3,-6,0,0,127,-1,0
KR_7764434684,13349,14703,246,278,2,4,4,2,2,2,0,1,0,0,43,12,3,3,0,0,0,1,0,1,0,0,10,540233,-1354,-32,-2,2,0,-1,0,31,0,0
KR_7764458843,15947,17878,224,241,7,12,12,7,15,19,0,0,0,0,18,26,2,3,0,0,0,1,0,0,0,0,10,540233,-1931,-17,-5,5,-4,0,0,-8,-1,0
KR_7764465839,15835,14047,248,248,8,3,3,8,11,4,0,0,0,0,16,15,5,3,0,0,1,0,0,0,0,0,10,540190,1788,0,5,-5,7,0,0,1,2,0
KR_7764472003,17669,18683,225,261,11,12,12,12,14,13,0,0,0,0,13,13,3,0,1,4,1,0,0,0,0,0,10,540238,-1014,-36,-1,0,1,0,0,0,3,-3
KR_7764473301,18309,13572,272,237,13,2,2,13,12,2,0,0,0,0,17,16,2,1,4,0,1,0,0,0,0,0,10,540260,4737,35,11,-11,10,0,0,1,1,4
KR_7764480587,15079,14957,278,278,4,4,4,4,5,2,1,0,0,0,14,9,1,5,0,1,0,1,1,0,0,0,10,540130,122,0,0,0,3,1,0,5,-4,-1
KR_7764490841,15634,15684,270,274,5,6,6,5,6,7,0,1,0,0,37,16,3,3,0,0,1,0,0,1,0,0,10,540262,-50,-4,-1,1,-1,-1,0,21,0,0
KR_7764490928,16701,13926,298,259,7,3,3,7,7,4,0,1,0,0,107,16,1,2,3,0,1,0,0,1,0,0,10,540326,2775,39,4,-4,3,-1,0,91,-1,3
KR_7764498282,15406,15219,262,280,6,5,5,6,9,6,0,1,0,0,17,13,2,6,0,0,0,1,0,1,0,0,10,540234,187,-18,1,-1,3,-1,0,4,-4,0
KR_7764519066,15306,14013,268,262,4,3,3,4,6,3,0,0,0,0,35,104,5,4,1,0,0,1,0,0,0,0,10,540140,1293,6,1,-1,3,0,0,-69,1,1
KR_7764522868,17452,13448,294,258,8,2,2,8,14,3,1,0,0,0,114,19,1,2,1,0,0,1,1,0,0,0,10,540232,4004,36,6,-6,11,1,0,95,-1,1
KR_7764528116,14998,14389,284,238,4,4,4,4,3,5,0,0,0,0,48,47,4,4,1,0,0,1,0,0,0,0,10,540291,609,46,0,0,-2,0,0,1,0,1
KR_7764529898,15640,14828,271,252,5,4,4,5,6,5,0,0,0,0,18,108,2,5,2,1,0,1,0,0,0,0,10,540235,812,19,1,-1,1,0,0,-90,-3,1
KR_7764531102,15903,16178,289,283,5,6,6,6,6,11,1,0,0,0,15,31,5,3,1,0,1,0,1,0,0,0,10,540299,-275,6,-1,0,-5,1,0,-16,2,1
KR_7764538818,16237,13652,286,229,6,3,3,6,5,3,0,0,0,0,11,13,4,0,1,0,1,0,0,0,0,0,10,540204,2585,57,3,-3,2,0,0,-2,4,1
KR_7764554095,14858,16812,264,256,4,8,8,4,1,9,0,0,0,0,124,21,5,5,2,1,0,1,0,0,0,0,10,540221,-1954,8,-4,4,-8,0,0,103,0,1
KR_7764564162,13075,16694,272,303,0,6,6,0,0,4,0,0,0,0,30,16,2,2,0,3,0,1,0,0,0,0,10,540206,-3619,-31,-6,6,-4,0,0,14,0,-3
KR_7764569157,13942,14157,259,269,2,1,1,2,1,1,0,0,0,0,20,55,4,6,1,2,0,1,0,0,0,0,10,540249,-215,-10,1,-1,0,0,0,-35,-2,-1
KR_7764586256,15186,15891,238,274,7,6,6,7,6,4,0,1,0,0,20,16,5,4,0,0,0,1,0,1,0,0,10,540268,-705,-36,1,-1,2,-1,0,4,1,0
KR_7764588023,15506,14943,293,302,4,3,3,4,7,4,1,0,0,0,18,14,4,5,0,1,0,1,1,0,0,0,10,540227,563,-9,1,-1,3,1,0,4,-1,-1
KR_7764606671,13935,16162,288,282,1,7,7,1,1,10,0,1,0,0,13,18,2,1,0,0,0,1,0,1,0,0,10,540243,-2227,6,-6,6,-9,-1,0,-5,1,0
KR_7764614102,15416,13721,296,266,4,2,2,4,4,3,0,1,0,0,18,42,2,4,0,1,1,0,0,1,0,0,10,540228,1695,30,2,-2,1,-1,0,-24,-2,-1
KR_7764614238,15885,13735,271,268,7,2,2,7,6,0,1,0,0,0,19,15,3,6,2,0,1,0,1,0,0,0,10,540250,2150,3,5,-5,6,1,0,4,-3,2
KR_7764619878,18288,17738,207,243,13,12,12,13,17,12,0,0,0,0,30,18,3,1,1,1,0,1,0,0,0,0,10,540217,550,-36,1,-1,5,0,0,12,2,0
KR_7764624183,17893,13554,258,230,12,2,2,12,11,3,0,0,0,0,25,20,2,4,1,0,1,0,0,0,0,0,10,540231,4339,28,10,-10,8,0,0,5,-2,1
KR_7764631602,14762,17877,235,294,5,11,11,5,5,13,0,0,0,0,18,17,2,1,0,1,0,1,0,0,0,0,10,540209,-3115,-59,-6,6,-8,0,0,1,1,-1
KR_7764633050,15239,15538,236,247,7,8,8,7,7,7,0,0,0,0,28,14,5,4,2,1,0,1,0,0,0,0,10,540246,-299,-11,-1,1,0,0,0,14,1,1
KR_7764634146,14246,15061,278,249,2,6,6,2,4,6,0,1,0,0,36,18,3,0,1,1,0,1,0,1,0,0,10,540216,-815,29,-4,4,-2,-1,0,18,3,0
KR_7764648885,15971,16023,229,267,9,6,6,9,9,4,1,0,0,0,18,15,3,5,0,1,1,0,1,0,0,0,10,540177,-52,-38,3,-3,5,1,0,3,-2,-1
KR_7764649914,15272,13453,273,262,5,2,2,5,5,0,0,0,0,0,12,18,5,1,0,0,1,0,0,0,0,0,10,540205,1819,11,3,-3,5,0,0,-6,4,0
KR_7764672409,14473,15998,266,267,3,7,7,3,4,15,0,1,0,0,15,25,2,1,0,0,1,0,0,1,0,0,10,540192,-1525,-1,-4,4,-11,-1,0,-10,1,0
KR_7764675527,14338,15247,272,251,3,7,7,3,3,7,0,1,0,0,13,9,0,2,0,0,0,1,0,1,0,0,10,540259,-909,21,-4,4,-4,-1,0,4,-2,0
KR_7764676295,13733,16411,260,294,2,8,8,2,1,11,0,1,0,0,11,50,3,3,0,0,0,1,0,1,0,0,10,540270,-2678,-34,-6,6,-10,-1,0,-39,0,0
KR_7764682254,14743,14818,267,236,4,5,5,4,2,7,0,0,0,0,17,16,2,2,0,0,0,1,0,0,0,0,10,540208,-75,31,-1,1,-5,0,0,1,0,0
KR_7764686455,16681,13656,252,237,8,4,4,8,6,1,0,0,0,0,16,16,0,3,1,0,0,1,0,0,0,0,10,540312,3025,15,4,-4,5,0,0,0,-3,1
KR_7764691512,14659,15928,289,270,3,7,7,3,3,9,0,1,0,0,18,37,2,5,0,0,0,1,0,1,0,0,10,540231,-1269,19,-4,4,-6,-1,0,-19,-3,0
KR_7764698866,15121,17626,260,255,5,12,12,5,8,22,0,1,0,0,18,18,5,2,1,1,0,1,0,1,0,0,10,540229,-2505,5,-7,7,-14,-1,0,0,3,0
KR_7764720723,14717,15460,244,267,5,5,5,5,7,4,0,0,0,0,95,15,3,2,2,2,0,1,0,0,0,0,10,540207,-743,-23,0,0,3,0,0,80,1,0
KR_7764724798,15468,15498,261,255,6,5,5,6,8,10,0,0,0,0,20,19,2,4,0,0,1,0,0,0,0,0,10,540226,-30,6,1,-1,-2,0,0,1,-2,0
KR_7764769803,14131,15460,259,273,3,6,6,3,3,8,0,1,0,0,19,17,3,1,0,1,0,1,0,1,0,0,10,540241,-1329,-14,-3,3,-5,-1,0,2,2,-1
KR_7764777207,16090,13002,269,278,8,0,0,8,12,0,0,0,0,0,36,15,3,6,0,0,1,0,0,0,0,0,10,540232,3088,-9,8,-8,12,0,0,21,-3,0
KR_7764780981,15900,15030,216,252,10,6,6,10,9,3,0,0,0,0,21,17,3,3,0,1,1,0,0,0,0,0,10,540202,870,-36,4,-4,6,0,0,4,0,-1
KR_7764785403,15260,14176,272,274,4,2,2,4,5,4,0,0,0,0,18,32,4,4,0,0,1,0,0,0,0,0,10,540226,1084,-2,2,-2,1,0,0,-14,0,0
KR_7764797941,15081,13999,312,273,3,3,3,3,1,2,0,1,0,0,13,19,2,3,1,0,0,1,0,1,0,0,10,540291,1082,39,0,0,-1,-1,0,-6,-1,1
KR_7764800882,15545,15052,280,273,6,5,5,6,4,4,1,0,0,0,10,15,3,3,2,0,1,0,1,0,0,0,10,540253,493,7,1,-1,0,1,0,-5,0,2
KR_7764825706,12863,15492,242,274,1,5,5,1,0,6,0,0,0,0,52,21,4,3,0,2,0,1,0,0,0,0,10,540218,-2629,-32,-4,4,-6,0,0,31,1,-2
KR_7764835516,14095,15896,271,275,2,6,6,2,3,7,0,0,0,0,60,15,1,7,0,0,0,1,0,0,0,0,10,540237,-1801,-4,-4,4,-4,0,0,45,-6,0
KR_7764846209,16684,17653,259,236,11,13,13,11,10,12,0,1,0,0,16,11,1,5,0,0,1,0,0,1,0,0,10,540218,-969,23,-2,2,-2,-1,0,5,-4,0
KR_7764848539,13096,16438,237,274,3,8,8,3,3,6,1,0,0,0,11,33,2,2,0,5,0,1,1,0,0,0,10,540220,-3342,-37,-5,5,-3,1,0,-22,0,-5
KR_7764895432,15139,15885,257,271,4,7,7,4,6,5,0,0,0,0,17,15,2,3,0,0,1,0,0,0,0,0,10,540253,-746,-14,-3,3,1,0,0,2,-1,0
KR_7764953229,16170,15644,233,220,9,7,7,9,9,11,0,1,0,0,16,21,6,3,2,1,0,1,0,1,0,0,10,540202,526,13,2,-2,-2,-1,0,-5,3,1
KR_7764966141,14185,15759,266,248,2,7,7,3,2,8,0,0,0,0,17,18,5,5,0,1,0,1,0,0,0,0,10,540203,-1574,18,-5,4,-6,0,0,-1,0,-1
KR_7764998585,15723,15073,294,261,7,5,5,7,6,4,1,0,0,0,13,27,2,3,0,0,1,0,1,0,0,0,10,540270,650,33,2,-2,2,1,0,-14,-1,0
KR_7765000696,14060,14794,263,255,2,5,5,3,4,8,0,0,0,0,38,15,4,3,0,0,0,1,0,0,0,0,10,540206,-734,8,-3,2,-4,0,0,23,1,0
KR_7765007977,15287,16790,277,270,4,7,8,4,4,8,0,0,0,0,17,37,3,8,0,2,1,0,0,0,0,0,10,540221,-1503,7,-3,4,-4,0,0,-20,-5,-2
KR_7765012825,16136,15882,236,252,8,7,7,8,9,5,0,1,0,0,10,27,0,1,2,1,1,0,0,1,0,0,10,540183,254,-16,1,-1,4,-1,0,-17,-1,1
KR_7765018805,14312,15978,262,259,3,7,7,3,4,6,1,0,0,0,15,17,2,4,0,0,1,0,1,0,0,0,10,540238,-1666,3,-4,4,-2,1,0,-2,-2,0
KR_7765023533,15376,14167,247,265,7,3,3,7,5,2,0,0,0,0,22,143,6,1,0,1,1,0,0,0,0,0,10,540229,1209,-18,4,-4,3,0,0,-121,5,-1
KR_7765027097,16056,15053,237,294,9,3,3,9,12,1,0,0,0,0,17,17,5,1,1,2,0,1,0,0,0,0,10,540217,1003,-57,6,-6,11,0,0,0,4,-1
KR_7765030346,15410,15740,245,265,6,7,7,6,5,8,0,0,0,0,29,20,4,5,2,0,1,0,0,0,0,0,10,540241,-330,-20,-1,1,-3,0,0,9,-1,2
KR_7765073130,15924,15399,280,261,5,6,6,5,7,4,1,0,0,0,15,18,4,3,1,1,1,0,1,0,0,0,10,540228,525,19,-1,1,3,1,0,-3,1,0
KR_7765073555,15526,16666,257,249,6,9,9,6,6,8,1,0,0,0,10,32,2,1,0,3,0,1,1,0,0,0,10,540221,-1140,8,-3,3,-2,1,0,-22,1,-3
KR_7765090757,16888,17711,261,276,9,10,10,9,10,10,0,0,0,0,13,123,3,6,0,2,1,0,0,0,0,0,10,540223,-823,-15,-1,1,0,0,0,-110,-3,-2
KR_7765092096,15221,13819,307,256,4,2,2,4,1,3,0,0,0,0,12,15,2,0,0,1,1,0,0,0,0,0,10,540297,1402,51,2,-2,-2,0,0,-3,2,-1
KR_7765096543,13872,13970,241,233,3,4,4,3,5,3,0,0,0,0,14,16,3,1,1,0,1,0,0,0,0,0,10,540228,-98,8,-1,1,2,0,0,-2,2,1
KR_7765098816,13847,15604,242,270,4,6,6,4,2,6,0,0,0,0,14,16,4,2,0,0,0,1,0,0,0,0,10,540249,-1757,-28,-2,2,-4,0,0,-2,2,0
KR_7765110613,15983,15285,287,237,5,6,6,5,4,7,0,0,0,0,15,7,0,5,1,0,1,0,0,0,0,0,10,540177,698,50,-1,1,-3,0,0,8,-5,1
KR_7765116624,15331,12874,288,245,4,1,1,4,7,1,0,1,0,0,15,32,0,3,0,0,0,1,0,1,0,0,10,540233,2457,43,3,-3,6,-1,0,-17,-3,0
KR_7765121761,14113,15779,286,284,2,6,6,2,0,5,0,0,0,0,36,16,4,5,0,0,0,1,0,0,0,0,10,540232,-1666,2,-4,4,-5,0,0,20,-1,0
KR_7765131567,16765,14393,264,264,9,4,4,9,7,5,0,0,0,0,37,18,7,2,2,0,1,0,0,0,0,0,10,540174,2372,0,5,-5,2,0,0,19,5,2
KR_7765134272,15613,13841,286,239,5,3,3,5,3,6,0,1,0,0,44,17,3,17,0,0,1,0,0,1,0,0,10,540213,1772,47,2,-2,-3,-1,0,27,-14,0
KR_7765141601,15200,14580,246,228,6,5,5,6,6,7,0,0,0,0,11,19,5,1,0,0,0,1,0,0,0,0,10,540242,620,18,1,-1,-1,0,0,-8,4,0
KR_7765157523,15572,16124,239,238,7,8,8,7,12,8,0,0,0,0,11,18,4,1,1,1,1,0,0,0,0,0,10,540258,-552,1,-1,1,4,0,0,-7,3,0
KR_7765172830,17389,14688,265,253,10,4,4,10,9,7,1,0,0,0,15,20,0,1,1,0,0,1,1,0,0,0,10,540257,2701,12,6,-6,2,1,0,-5,-1,1
KR_7765176787,18505,14288,240,208,15,5,5,15,21,6,0,0,0,0,31,17,4,4,1,0,1,0,0,0,0,0,10,540232,4217,32,10,-10,15,0,0,14,0,1
KR_7765201087,14208,14908,275,270,3,5,5,3,1,3,0,0,0,0,14,16,3,4,0,0,0,1,0,0,0,0,10,540214,-700,5,-2,2,-2,0,0,-2,-1,0
KR_7765202207,15187,15609,257,247,5,7,7,5,6,8,0,0,0,0,17,18,4,1,3,1,0,1,0,0,0,0,10,540212,-422,10,-2,2,-2,0,0,-1,3,2
KR_7765206817,16244,15617,236,236,9,7,7,9,12,13,0,0,0,0,24,36,3,4,1,0,1,0,0,0,0,0,10,540198,627,0,2,-2,-1,0,0,-12,-1,1
KR_7765212277,16288,15160,328,284,5,3,3,5,7,6,0,0,0,0,24,35,6,8,1,1,0,1,0,0,0,0,10,540285,1128,44,2,-2,1,0,0,-11,-2,0
KR_7765222559,16235,13254,289,270,8,1,3,8,6,0,0,0,0,0,19,38,3,2,0,0,1,0,0,0,0,0,10,540102,2981,19,7,-5,6,0,0,-19,1,0
KR_7765230907,15670,13602,272,256,5,2,2,5,6,5,0,0,0,0,43,17,2,6,1,0,1,0,0,0,0,0,10,540253,2068,16,3,-3,1,0,0,26,-4,1
KR_7765232810,14780,16466,262,278,4,8,8,4,3,8,0,1,0,0,12,16,3,4,0,1,0,1,0,1,0,0,10,540211,-1686,-16,-4,4,-5,-1,0,-4,-1,-1
KR_7765234172,15511,14714,280,278,4,4,4,4,5,4,0,1,0,0,112,17,4,2,0,0,0,1,0,1,0,0,10,540254,797,2,0,0,1,-1,0,95,2,0
KR_7765247729,15119,14930,281,264,4,5,5,4,6,6,0,0,0,0,15,15,4,3,0,0,1,0,0,0,0,0,10,540256,189,17,-1,1,0,0,0,0,1,0
KR_7765275268,15610,16494,276,226,5,10,10,5,3,11,0,0,0,0,32,31,4,6,1,0,1,0,0,0,0,0,10,540230,-884,50,-5,5,-8,0,0,1,-2,1
KR_7765276996,14422,15734,252,263,4,5,5,4,5,8,0,0,0,0,21,16,4,1,0,2,1,0,0,0,0,0,10,540267,-1312,-11,-1,1,-3,0,0,5,3,-2
KR_7765279052,17306,15777,277,281,10,5,5,10,8,7,0,0,0,0,18,16,1,6,1,0,0,1,0,0,0,0,10,540108,1529,-4,5,-5,1,0,0,2,-5,1
KR_7765285315,15848,13835,284,258,7,3,3,7,5,6,0,0,0,0,11,25,3,1,1,0,0,1,0,0,0,0,10,540085,2013,26,4,-4,-1,0,0,-14,2,1
KR_7765289400,15963,13857,290,248,5,3,3,5,4,4,0,0,0,0,23,12,2,7,2,0,0,1,0,0,0,0,10,540203,2106,42,2,-2,0,0,0,11,-5,2
KR_7765297964,14462,14338,262,287,3,3,3,3,4,2,0,1,0,0,16,13,4,2,0,0,0,1,0,1,0,0,10,540169,124,-25,0,0,2,-1,0,3,2,0
KR_7765322759,16503,15228,261,245,10,6,6,10,3,5,0,0,0,0,16,16,4,3,0,1,1,0,0,0,0,0,10,540240,1275,16,4,-4,-2,0,0,0,1,-1
KR_7765328827,13514,13783,250,278,2,1,1,2,3,2,0,1,0,0,14,36,5,4,2,0,1,0,0,1,0,0,10,540321,-269,-28,1,-1,1,-1,0,-22,1,2
KR_7765338404,14671,15768,257,257,3,6,6,3,4,8,0,1,0,0,14,14,2,2,1,0,1,0,0,1,0,0,10,540176,-1097,0,-3,3,-4,-1,0,0,0,1
KR_7765348421,15669,13664,265,256,7,2,2,7,8,1,0,0,0,0,20,19,3,1,0,1,1,0,0,0,0,0,10,540230,2005,9,5,-5,7,0,0,1,2,-1
KR_7765356979,16478,14318,256,254,9,2,2,9,11,2,1,0,0,0,19,15,2,2,1,1,1,0,1,0,0,0,10,540200,2160,2,7,-7,9,1,0,4,0,0
KR_7765367636,15963,17547,266,202,7,12,12,7,6,14,0,0,0,0,19,14,4,2,1,1,0,1,0,0,0,0,10,540257,-1584,64,-5,5,-8,0,0,5,2,0
KR_7765374928,16597,14451,283,234,6,5,5,6,11,6,0,1,0,0,15,14,3,4,2,0,0,1,0,1,0,0,10,540308,2146,49,1,-1,5,-1,0,1,-1,2
KR_7765375239,15449,14278,293,271,4,3,3,5,6,5,0,1,0,0,14,12,6,2,1,1,1,0,0,1,0,0,10,540222,1171,22,1,-2,1,-1,0,2,4,0
KR_7765387047,17008,13379,278,251,8,2,2,8,7,2,0,0,0,0,27,19,2,5,1,0,0,1,0,0,0,0,10,540203,3629,27,6,-6,5,0,0,8,-3,1
KR_7765397318,15698,16043,213,276,8,6,6,8,11,5,0,0,0,0,15,12,5,1,1,4,0,1,0,0,0,0,10,540097,-345,-63,2,-2,6,0,0,3,4,-3
KR_7765405808,17532,16993,243,237,11,10,10,11,11,11,0,0,0,0,13,14,3,3,0,1,0,1,0,0,0,0,10,540227,539,6,1,-1,0,0,0,-1,0,-1
KR_7765419423,14795,16232,255,272,5,7,7,5,4,7,0,0,0,0,13,23,6,5,0,2,1,0,0,0,0,0,10,540251,-1437,-17,-2,2,-3,0,0,-10,1,-2
KR_7765426739,17396,17504,237,250,10,10,10,10,10,10,0,1,0,0,16,28,2,5,0,2,0,1,0,1,0,0,10,540211,-108,-13,0,0,0,-1,0,-12,-3,-2
KR_7765434259,15452,16336,253,266,6,6,6,6,6,11,0,0,0,0,17,37,6,5,2,0,0,1,0,0,0,0,10,540087,-884,-13,0,0,-5,0,0,-20,1,2
KR_7765435722,15002,15302,245,264,5,5,5,6,5,6,0,0,0,0,19,38,3,4,1,2,0,1,0,0,0,0,10,540215,-300,-19,0,-1,-1,0,0,-19,-1,-1
KR_7765457229,17763,14871,270,271,11,4,4,11,10,4,0,0,0,0,15,17,2,5,3,2,1,0,0,0,0,0,10,540278,2892,-1,7,-7,6,0,0,-2,-3,1
KR_7765467161,14369,15544,247,272,4,6,6,4,6,7,0,0,0,0,19,16,3,1,0,1,0,1,0,0,0,0,10,540104,-1175,-25,-2,2,-1,0,0,3,2,-1
KR_7765474182,16185,17121,248,230,7,10,10,7,8,15,0,0,0,0,16,93,3,1,0,1,1,0,0,0,0,0,10,540267,-936,18,-3,3,-7,0,0,-77,2,-1
KR_7765475770,13531,13901,283,264,0,3,3,0,0,5,0,0,0,0,14,15,0,2,3,0,0,1,0,0,0,0,10,540208,-370,19,-3,3,-5,0,0,-1,-2,3
KR_7765483701,16674,17015,278,281,9,8,8,9,8,13,0,1,0,0,14,16,3,1,0,0,0,1,0,1,0,0,10,540245,-341,-3,1,-1,-5,-1,0,-2,2,0
KR_7765501950,15682,13852,266,240,5,3,3,5,3,3,0,0,0,0,16,33,4,2,1,1,0,1,0,0,0,0,10,540270,1830,26,2,-2,0,0,0,-17,2,0
KR_7765503233,16615,14498,295,259,7,4,4,7,5,3,0,0,0,0,16,19,7,1,2,0,0,1,0,0,0,0,10,540196,2117,36,3,-3,2,0,0,-3,6,2
KR_7765526210,17264,14841,269,228,11,5,5,12,9,3,0,0,0,0,19,14,1,5,2,0,1,0,0,0,0,0,10,540227,2423,41,6,-7,6,0,0,5,-4,2
KR_7765538758,15920,18395,274,281,8,12,12,9,7,9,0,0,0,0,30,119,5,3,0,1,0,1,0,0,0,0,10,540218,-2475,-7,-4,3,-2,0,0,-89,2,-1
KR_7765546013,15869,14124,283,285,5,2,2,5,7,3,1,0,0,0,24,13,4,4,3,0,0,1,1,0,0,0,10,540248,1745,-2,3,-3,4,1,0,11,0,3
KR_7765551772,13904,14779,219,269,4,4,4,4,5,3,0,1,0,0,19,9,0,3,0,1,0,1,0,1,0,0,10,540244,-875,-50,0,0,2,-1,0,10,-3,-1
KR_7765561367,18269,14955,281,217,12,6,6,12,11,6,0,0,0,0,136,16,3,3,2,0,1,0,0,0,0,0,10,540245,3314,64,6,-6,5,0,0,120,0,2
KR_7765579236,16111,13118,305,278,6,0,0,6,5,0,0,0,0,0,15,17,6,2,2,0,1,0,0,0,0,0,10,540283,2993,27,6,-6,5,0,0,-2,4,2
KR_7765594499,15811,14636,262,259,7,5,5,7,7,5,0,0,0,0,17,18,2,2,1,1,0,1,0,0,0,0,10,540101,1175,3,2,-2,2,0,0,-1,0,0
KR_7765596255,16806,15724,224,236,11,7,7,11,13,7,0,0,0,0,14,37,5,1,0,0,1,0,0,0,0,0,10,540240,1082,-12,4,-4,6,0,0,-23,4,0
KR_7765607409,13138,16721,249,285,1,8,8,1,1,7,0,0,0,0,31,51,1,1,0,0,0,1,0,0,0,0,10,540197,-3583,-36,-7,7,-6,0,0,-20,0,0
KR_7765614766,14245,14274,301,295,1,1,1,1,0,2,0,1,0,0,17,89,3,4,0,0,1,0,0,1,0,0,10,540199,-29,6,0,0,-2,-1,0,-72,-1,0
KR_7765632660,15499,14655,264,270,7,4,4,7,4,6,0,1,0,0,16,11,0,6,0,0,1,0,0,1,0,0,10,540199,844,-6,3,-3,-2,-1,0,5,-6,0
KR_7765644411,13934,16393,276,280,2,8,8,2,1,10,0,1,0,0,13,16,4,5,0,0,0,1,0,1,0,0,10,540232,-2459,-4,-6,6,-9,-1,0,-3,-1,0
KR_7765651065,15394,13754,313,267,5,2,2,5,2,3,0,0,0,0,13,15,4,3,0,0,0,1,0,0,0,0,10,540206,1640,46,3,-3,-1,0,0,-2,1,0
KR_7765656527,16332,15201,269,255,8,6,6,8,11,6,0,0,0,0,14,13,1,2,0,0,1,0,0,0,0,0,10,540193,1131,14,2,-2,5,0,0,1,-1,0
KR_7765657109,16111,12765,302,236,5,1,1,5,3,1,0,1,0,0,17,16,1,1,0,0,1,0,0,1,0,0,10,540243,3346,66,4,-4,2,-1,0,1,0,0
KR_7765663602,14812,14678,281,265,3,4,4,3,2,5,0,1,0,0,33,14,2,2,1,1,1,0,0,1,0,0,10,540222,134,16,-1,1,-3,-1,0,19,0,0
KR_7765667375,14056,15592,241,250,3,8,8,3,4,12,0,1,0,0,43,18,4,2,0,1,0,1,0,1,0,0,10,540207,-1536,-9,-5,5,-8,-1,0,25,2,-1
KR_7765674266,12529,16163,235,246,1,9,9,1,0,10,1,0,0,0,13,20,6,1,0,3,0,1,1,0,0,0,10,540227,-3634,-11,-8,8,-10,1,0,-7,5,-3
KR_7765676895,15412,15277,290,262,4,5,5,4,4,3,0,1,0,0,14,34,3,4,0,0,0,1,0,1,0,0,10,540238,135,28,-1,1,1,-1,0,-20,-1,0
KR_7765684438,14690,15265,253,262,3,6,6,4,4,5,0,0,0,0,50,19,1,1,2,2,0,1,0,0,0,0,10,540223,-575,-9,-3,2,-1,0,0,31,0,0
KR_7765692705,13329,16425,267,269,1,7,7,1,2,10,0,0,0,0,27,17,3,2,0,1,0,1,0,0,0,0,10,540252,-3096,-2,-6,6,-8,0,0,10,1,-1
KR_7765701924,16809,16638,229,268,10,7,7,10,15,5,0,0,0,0,13,14,3,1,0,2,1,0,0,0,0,0,10,540093,171,-39,3,-3,10,0,0,-1,2,-2
KR_7765703671,16889,14342,272,268,7,3,3,7,8,2,0,1,0,0,36,18,2,4,2,0,0,1,0,1,0,0,10,540251,2547,4,4,-4,6,-1,0,18,-2,2
KR_7765718356,16937,19502,222,254,10,16,16,10,15,27,1,0,0,0,14,39,1,3,1,1,0,1,1,0,0,0,10,540288,-2565,-32,-6,6,-12,1,0,-25,-2,0
KR_7765723102,14323,17457,258,240,4,11,11,4,3,15,0,0,0,0,9,19,0,3,0,1,0,1,0,0,0,0,10,540194,-3134,18,-7,7,-12,0,0,-10,-3,-1
KR_7765726090,13613,15472,243,225,2,8,8,2,4,14,0,0,0,0,15,9,0,1,0,2,1,0,0,0,0,0,10,540235,-1859,18,-6,6,-10,0,0,6,-1,-2
KR_7765732928,12971,15398,180,230,3,7,7,3,4,8,0,1,0,0,22,13,1,2,1,0,1,0,0,1,0,0,10,540263,-2427,-50,-4,4,-4,-1,0,9,-1,1
KR_7765745920,15164,14190,270,261,6,3,3,6,6,4,0,0,0,0,30,14,2,2,0,0,1,0,0,0,0,0,10,540156,974,9,3,-3,2,0,0,16,0,0
KR_7765749324,15217,14522,285,252,5,4,4,5,6,9,1,0,0,0,17,17,4,4,0,0,0,1,1,0,0,0,10,540214,695,33,1,-1,-3,1,0,0,0,0
KR_7765753099,14954,15702,244,254,5,7,7,5,3,6,0,0,0,0,31,16,1,1,1,0,1,0,0,0,0,0,10,540219,-748,-10,-2,2,-3,0,0,15,0,1
KR_7765754539,15579,14373,249,245,7,4,4,8,13,2,0,0,0,0,22,14,3,1,0,2,0,1,0,0,0,0,10,540278,1206,4,3,-4,11,0,0,8,2,-2
KR_7765758181,15674,17716,245,276,5,11,11,5,5,12,0,0,0,0,14,17,2,1,0,1,0,1,0,0,0,0,10,540110,-2042,-31,-6,6,-7,0,0,-3,1,-1
KR_7765759350,16516,14801,277,245,8,6,6,8,5,3,0,1,0,0,15,23,5,2,0,0,1,0,0,1,0,0,10,540240,1715,32,2,-2,2,-1,0,-8,3,0
KR_7765764158,16156,15380,253,243,7,6,6,7,9,5,0,0,0,0,12,13,2,3,0,0,1,0,0,0,0,0,10,540261,776,10,1,-1,4,0,0,-1,-1,0
KR_7765774688,14681,15225,266,254,4,5,5,4,4,5,0,0,0,0,18,47,7,4,0,0,0,1,0,0,0,0,10,540252,-544,12,-1,1,-1,0,0,-29,3,0
KR_7765790637,14971,18475,250,269,4,13,13,4,5,11,0,1,0,0,20,14,3,3,0,1,0,1,0,1,0,0,10,540265,-3504,-19,-9,9,-6,-1,0,6,0,-1
KR_7765793969,16952,14005,294,227,6,4,4,6,10,4,0,0,0,0,113,72,4,3,3,0,0,1,0,0,0,0,10,540242,2947,67,2,-2,6,0,0,41,1,3
KR_7765796089,14024,13885,248,240,3,4,4,3,2,5,1,0,0,0,17,19,2,0,2,0,1,0,1,0,0,0,10,540257,139,8,-1,1,-3,1,0,-2,2,2
KR_7765804028,14988,16331,252,268,5,7,7,5,7,5,0,0,0,0,14,18,1,2,0,1,0,1,0,0,0,0,10,540216,-1343,-16,-2,2,2,0,0,-4,-1,-1
KR_7765806850,15053,15354,217,234,7,8,8,7,5,10,0,1,0,0,20,10,2,1,1,1,0,1,0,1,0,0,10,540217,-301,-17,-1,1,-5,-1,0,10,1,0
KR_7765816898,14769,14641,283,272,3,3,3,3,2,4,0,1,0,0,16,32,3,2,2,0,1,0,0,1,0,0,10,540287,128,11,0,0,-2,-1,0,-16,1,2
KR_7765817407,17163,14581,289,265,8,3,3,9,12,4,1,0,0,0,20,18,3,4,2,1,1,0,1,0,0,0,10,540179,2582,24,5,-6,8,1,0,2,-1,1
KR_7765829778,15725,15419,266,281,6,6,6,7,8,2,0,0,0,0,15,19,0,4,0,2,1,0,0,0,0,0,10,540259,306,-15,0,-1,6,0,0,-4,-4,-2
KR_7765836811,14927,14060,247,262,5,2,2,5,12,3,0,0,0,0,12,16,2,1,1,1,0,1,0,0,0,0,10,540232,867,-15,3,-3,9,0,0,-4,1,0
KR_7765842424,14084,15664,270,273,2,6,6,2,1,5,0,0,0,0,35,13,2,1,1,3,0,1,0,0,0,0,10,540204,-1580,-3,-4,4,-4,0,0,22,1,-2
KR_7765842565,15608,17626,251,260,7,10,10,7,5,12,0,1,0,0,37,15,3,5,0,0,1,0,0,1,0,0,10,540273,-2018,-9,-3,3,-7,-1,0,22,-2,0
KR_7765844431,14235,18416,261,279,3,12,12,3,1,14,0,0,0,0,169,19,8,0,0,0,0,1,0,0,0,0,10,540228,-4181,-18,-9,9,-13,0,0,150,8,0
KR_7765854713,16514,15475,259,261,9,6,6,9,10,4,0,1,0,0,20,31,5,4,1,0,1,0,0,1,0,0,10,540321,1039,-2,3,-3,6,-1,0,-11,1,1
KR_7765856912,16457,13880,237,241,10,4,4,10,9,3,0,0,0,0,18,17,3,3,0,1,1,0,0,0,0,0,10,540217,2577,-4,6,-6,6,0,0,1,0,-1
KR_7765860829,14075,16473,273,284,2,8,8,2,2,3,0,0,0,0,42,114,3,18,0,3,0,1,0,0,0,0,10,540105,-2398,-11,-6,6,-1,0,0,-72,-15,-3
KR_7765868053,13868,14925,276,291,2,4,4,2,2,1,0,0,0,0,32,13,1,2,0,2,0,1,0,0,0,0,10,540195,-1057,-15,-2,2,1,0,0,19,-1,-2
KR_7765868159,16799,14741,249,222,10,6,6,10,6,6,0,0,0,0,12,17,3,1,3,1,1,0,0,0,0,0,10,540255,2058,27,4,-4,0,0,0,-5,2,2
KR_7765880840,15918,14308,253,239,7,5,5,7,8,2,0,1,0,0,9,14,1,2,1,0,0,1,0,1,0,0,10,540227,1610,14,2,-2,6,-1,0,-5,-1,1
KR_7765883146,16282,16049,251,271,9,6,6,10,10,7,0,1,0,0,16,18,2,4,1,0,1,0,0,1,0,0,10,540267,233,-20,3,-4,3,-1,0,-2,-2,1
KR_7765893561,15915,14573,270,256,7,4,4,7,4,4,0,0,0,0,31,44,2,2,1,0,1,0,0,0,0,0,10,540184,1342,14,3,-3,0,0,0,-13,0,1
KR_7765901538,17226,18145,258,248,10,13,13,10,7,17,1,0,0,0,24,18,1,1,1,0,1,0,1,0,0,0,10,540233,-919,10,-3,3,-10,1,0,6,0,1
KR_7765910383,17302,14427,263,261,12,3,3,12,11,1,0,1,0,0,38,15,2,3,3,1,1,0,0,1,0,0,10,540225,2875,2,9,-9,10,-1,0,23,-1,2
KR_7765912174,14768,14321,277,241,3,5,5,3,3,4,0,1,0,0,15,21,1,3,1,0,1,0,0,1,0,0,10,540210,447,36,-2,2,-1,-1,0,-6,-2,1
KR_7765912341,17447,13897,260,248,11,3,3,12,9,2,0,0,0,0,12,19,2,3,2,0,1,0,0,0,0,0,10,540268,3550,12,8,-9,7,0,0,-7,-1,2
KR_7765921175,13653,15661,278,297,1,5,5,1,2,8,1,0,0,0,18,16,2,2,0,0,0,1,1,0,0,0,10,540248,-2008,-19,-4,4,-6,1,0,2,0,0
KR_7765923358,15804,13998,288,248,7,2,2,7,5,4,1,0,0,0,16,38,2,2,2,1,1,0,1,0,0,0,10,540269,1806,40,5,-5,1,1,0,-22,0,1
KR_7765923548,14945,15125,262,267,5,4,4,5,4,4,0,0,0,0,19,17,4,5,0,1,0,1,0,0,0,0,10,540255,-180,-5,1,-1,0,0,0,2,-1,-1
KR_7765930728,16955,14817,293,287,8,3,3,8,8,4,0,0,0,0,14,12,4,2,0,1,0,1,0,0,0,0,10,540190,2138,6,5,-5,4,0,0,2,2,-1
KR_7765942125,16579,13414,256,239,9,2,2,9,12,4,0,0,0,0,15,18,6,3,0,1,0,1,0,0,0,0,10,540227,3165,17,7,-7,8,0,0,-3,3,-1
KR_7765944730,16285,14488,248,244,9,5,5,9,9,2,0,0,0,0,42,13,1,3,0,0,1,0,0,0,0,0,10,540225,1797,4,4,-4,7,0,0,29,-2,0
KR_7765953232,16671,16444,289,249,7,9,9,7,7,8,0,0,0,0,26,37,3,3,1,0,0,1,0,0,0,0,10,540247,227,40,-2,2,-1,0,0,-11,0,1
KR_7765953653,17728,14700,258,244,11,5,5,11,14,2,0,0,0,0,17,140,1,4,1,0,1,0,0,0,0,0,10,540210,3028,14,6,-6,12,0,0,-123,-3,1
KR_7765954852,12583,16910,242,294,0,7,7,0,0,7,0,1,0,0,15,13,0,2,0,4,0,1,0,1,0,0,10,540191,-4327,-52,-7,7,-7,-1,0,2,-2,-4
KR_7765960174,14533,13892,277,296,3,1,1,3,4,1,0,1,0,0,32,117,6,5,0,0,1,0,0,1,0,0,10,540218,641,-19,2,-2,3,-1,0,-85,1,0
KR_7765964508,15527,15817,270,274,6,7,7,6,4,5,0,0,0,0,34,17,3,3,1,1,1,0,0,0,0,0,10,540294,-290,-4,-1,1,-1,0,0,17,0,0
KR_7765967310,14448,17274,293,268,1,9,9,1,1,15,0,0,0,0,14,18,5,3,0,3,0,1,0,0,0,0,10,540218,-2826,25,-8,8,-14,0,0,-4,2,-3
KR_7765968792,15026,17289,264,270,5,10,10,5,3,11,0,0,0,0,17,15,1,5,0,2,0,1,0,0,0,0,10,540236,-2263,-6,-5,5,-8,0,0,2,-4,-2
KR_7765977215,16540,14578,239,230,10,5,5,10,13,6,0,0,0,0,15,15,2,2,1,0,1,0,0,0,0,0,10,540240,1962,9,5,-5,7,0,0,0,0,1
KR_7765989232,16939,15883,274,298,8,5,5,8,11,4,1,0,0,0,15,14,2,2,0,1,1,0,1,0,0,0,10,540191,1056,-24,3,-3,7,1,0,1,0,-1
KR_7765998512,17099,14917,272,246,9,6,6,9,10,7,0,0,0,0,104,16,4,3,0,0,1,0,0,0,0,0,10,540226,2182,26,3,-3,3,0,0,88,1,0
KR_7765998676,16778,18476,233,254,8,14,14,8,12,17,0,1,0,0,15,18,0,4,0,0,0,1,0,1,0,0,10,540216,-1698,-21,-6,6,-5,-1,0,-3,-4,0
KR_7766007241,16753,13912,270,263,8,2,2,8,16,3,0,0,0,0,19,15,3,6,0,0,1,0,0,0,0,0,10,540231,2841,7,6,-6,13,0,0,4,-3,0
KR_7766011181,13737,14288,257,257,2,3,3,2,2,7,0,0,0,0,15,18,3,2,0,0,0,1,0,0,0,0,10,540180,-551,0,-1,1,-5,0,0,-3,1,0
KR_7766015983,15146,17291,225,235,6,11,11,6,7,15,0,0,0,0,19,29,2,3,0,0,1,0,0,0,0,0,10,540236,-2145,-10,-5,5,-8,0,0,-10,-1,0
KR_7766016784,14362,14957,286,270,2,5,5,2,2,6,0,1,0,0,17,18,3,4,0,0,0,1,0,1,0,0,10,540210,-595,16,-3,3,-4,-1,0,-1,-1,0
KR_7766026554,14347,17142,229,263,6,9,9,6,4,9,0,0,0,0,15,24,2,0,0,0,1,0,0,0,0,0,10,540213,-2795,-34,-3,3,-5,0,0,-9,2,0
KR_7766035399,14444,16277,282,274,3,7,7,3,4,10,0,0,0,0,23,14,4,5,2,1,0,1,0,0,0,0,10,540219,-1833,8,-4,4,-6,0,0,9,-1,1
KR_7766048200,15539,14367,266,256,7,4,4,7,6,4,0,0,0,0,16,15,1,2,0,0,1,0,0,0,0,0,10,540187,1172,10,3,-3,2,0,0,1,-1,0
KR_7766060490,16328,14438,269,252,7,4,4,7,13,6,0,0,0,0,19,15,2,6,0,0,1,0,0,0,0,0,10,540191,1890,17,3,-3,7,0,0,4,-4,0
KR_7766073518,14740,16815,264,291,4,7,8,4,3,9,0,1,0,0,13,26,5,3,0,0,0,1,0,1,0,0,10,540230,-2075,-27,-3,4,-6,-1,0,-13,2,0
KR_7766086977,15109,16301,246,260,5,8,8,5,7,7,1,0,0,0,17,28,7,4,1,3,0,1,1,0,0,0,10,540115,-1192,-14,-3,3,0,1,0,-11,3,-2
KR_7766087066,17176,16523,270,273,9,7,7,9,14,12,0,0,0,0,15,16,1,2,1,0,1,0,0,0,0,0,10,540214,653,-3,2,-2,2,0,0,-1,-1,1
KR_7766097823,14219,15779,268,263,4,9,9,4,1,7,0,1,0,0,16,16,2,6,1,0,1,0,0,1,0,0,10,540219,-1560,5,-5,5,-6,-1,0,0,-4,1
KR_7766108455,16375,15948,225,227,9,7,7,9,13,8,1,0,0,0,44,18,4,2,0,1,1,0,1,0,0,0,10,540119,427,-2,2,-2,5,1,0,26,2,-1
KR_7766114035,14631,15065,232,265,5,5,5,5,8,7,1,0,0,0,14,14,2,2,0,0,0,1,1,0,0,0,10,540219,-434,-33,0,0,1,1,0,0,0,0
KR_7766119357,15636,14898,244,268,7,5,5,7,7,6,0,0,0,0,131,11,2,3,1,1,1,0,0,0,0,0,10,540235,738,-24,2,-2,1,0,0,120,-1,0
KR_7766127448,16848,15625,278,239,9,7,7,9,13,5,0,0,0,0,14,18,6,2,0,1,1,0,0,0,0,0,10,540198,1223,39,2,-2,8,0,0,-4,4,-1
KR_7766139423,15433,14586,267,268,5,4,5,5,5,2,0,0,0,0,18,101,4,4,2,1,0,1,0,0,0,0,10,540201,847,-1,1,0,3,0,0,-83,0,1
KR_7766171299,14028,15938,258,283,3,7,7,3,2,5,0,0,0,0,102,13,2,3,0,0,0,1,0,0,0,0,10,540203,-1910,-25,-4,4,-3,0,0,89,-1,0
KR_7766172724,14078,15675,246,275,4,5,5,4,8,7,0,0,0,0,21,18,4,1,0,0,1,0,0,0,0,0,10,540226,-1597,-29,-1,1,1,0,0,3,3,0
KR_7766190908,15367,15208,260,261,6,6,6,6,7,5,1,0,0,0,153,34,8,4,0,0,0,1,1,0,0,0,10,540255,159,-1,0,0,2,1,0,119,4,0
KR_7766198678,17195,14664,273,275,9,3,3,9,10,1,0,0,0,0,13,51,5,4,2,0,1,0,0,0,0,0,10,540244,2531,-2,6,-6,9,0,0,-38,1,2
KR_7766225110,17085,16936,251,250,9,11,11,9,7,10,0,0,0,0,17,14,5,4,5,2,0,1,0,0,0,0,10,540178,149,1,-2,2,-3,0,0,3,1,3
KR_7766251348,16731,17746,232,261,11,9,9,11,10,14,0,0,0,0,11,108,2,0,1,2,0,1,0,0,0,0,10,540266,-1015,-29,2,-2,-4,0,0,-97,2,-1
KR_7766253092,16062,16969,258,250,8,9,9,8,8,15,1,0,0,0,14,47,3,1,0,0,0,1,1,0,0,0,10,540219,-907,8,-1,1,-7,1,0,-33,2,0
KR_7766255431,15525,14039,269,261,6,3,3,6,5,5,0,1,0,0,13,14,3,2,0,0,1,0,0,1,0,0,10,540212,1486,8,3,-3,0,-1,0,-1,1,0
KR_7766298389,16556,13484,248,252,9,2,2,9,10,1,0,0,0,0,18,13,2,3,1,0,1,0,0,0,0,0,10,540234,3072,-4,7,-7,9,0,0,5,-1,1
KR_7766300177,15194,15176,284,246,4,5,5,4,4,7,0,1,0,0,15,26,6,3,0,0,1,0,0,1,0,0,10,540225,18,38,-1,1,-3,-1,0,-11,3,0
KR_7766317802,13651,17151,256,259,3,11,12,3,3,13,0,1,0,0,16,13,2,6,0,1,1,0,0,1,0,0,10,540234,-3500,-3,-8,9,-10,-1,0,3,-4,-1
KR_7766356749,14082,17165,232,268,4,12,12,4,3,8,0,1,0,0,17,13,2,0,0,0,0,1,0,1,0,0,10,540201,-3083,-36,-8,8,-5,-1,0,4,2,0
KR_7766364103,13473,16446,251,309,1,6,6,1,1,5,0,1,0,0,19,16,5,4,0,2,0,1,0,1,0,0,10,540250,-2973,-58,-5,5,-4,-1,0,3,1,-2
KR_7766380742,15149,14257,306,290,3,2,3,3,3,2,0,0,0,0,39,18,3,2,1,0,1,0,0,0,0,0,10,540204,892,16,1,0,1,0,0,21,1,1
KR_7766414837,14336,16116,274,272,2,6,6,2,3,7,0,0,0,0,14,22,4,3,1,0,0,1,0,0,0,0,10,540231,-1780,2,-4,4,-4,0,0,-8,1,1
KR_7766445985,16400,16302,228,236,9,9,9,9,5,11,0,0,0,0,12,18,3,5,0,0,0,1,0,0,0,0,10,540217,98,-8,0,0,-6,0,0,-6,-2,0
KR_7766446110,13428,16254,266,256,1,10,10,1,1,8,0,0,0,0,11,26,2,1,0,1,0,1,0,0,0,0,10,540245,-2826,10,-9,9,-7,0,0,-15,1,-1
KR_7766454624,14638,13956,257,294,5,1,1,5,4,1,1,0,0,0,71,14,2,4,1,0,1,0,1,0,0,0,10,540235,682,-37,4,-4,3,1,0,57,-2,1
KR_7766457585,16859,14893,275,237,8,6,6,8,7,7,0,1,0,0,35,73,2,0,3,0,1,0,0,1,0,0,10,540217,1966,38,2,-2,0,-1,0,-38,2,3
KR_7766463397,14783,14370,272,228,4,5,6,4,3,5,0,0,0,0,19,19,2,3,1,0,1,0,0,0,0,0,10,540318,413,44,-1,2,-2,0,0,0,-1,1
KR_7766463826,14636,16094,222,258,6,8,8,6,3,7,0,1,0,0,106,11,1,3,0,4,0,1,0,1,0,0,10,540211,-1458,-36,-2,2,-4,-1,0,95,-2,-4
KR_7766475262,14037,13250,251,254,3,2,2,3,2,0,0,0,0,0,14,16,3,2,1,0,1,0,0,0,0,0,10,540222,787,-3,1,-1,2,0,0,-2,1,1
KR_7766486590,13407,14202,249,244,2,3,4,2,2,1,0,0,0,0,14,20,2,2,0,2,0,1,0,0,0,0,10,540141,-795,5,-1,2,1,0,0,-6,0,-2
KR_7766503768,16599,14561,239,272,11,3,3,11,20,5,1,0,0,0,16,16,1,1,0,1,1,0,1,0,0,0,10,540235,2038,-33,8,-8,15,1,0,0,0,-1
KR_7766503912,14273,14998,305,269,2,5,5,2,1,4,0,0,0,0,11,29,1,0,0,0,0,1,0,0,0,0,10,540229,-725,36,-3,3,-3,0,0,-18,1,0
KR_7766504450,14376,14277,261,272,3,3,3,3,5,2,0,0,0,0,19,17,5,3,0,1,1,0,0,0,0,0,10,540196,99,-11,0,0,3,0,0,2,2,-1
KR_7766507203,14421,15816,264,276,4,6,6,4,4,5,0,1,0,0,15,16,4,4,0,0,0,1,0,1,0,0,10,540240,-1395,-12,-2,2,-1,-1,0,-1,0,0
KR_7766525062,14033,15651,248,256,4,8,8,4,1,8,0,0,0,0,16,19,6,3,1,0,0,1,0,0,0,0,10,540247,-1618,-8,-4,4,-7,0,0,-3,3,1
KR_7766531646,14054,13682,294,280,1,2,2,1,1,1,0,1,0,0,14,20,5,0,0,0,0,1,0,1,0,0,10,540244,372,14,-1,1,0,-1,0,-6,5,0
KR_7766538555,14065,15317,280,259,2,6,6,2,2,6,0,1,0,0,20,12,1,4,0,2,0,1,0,1,0,0,10,540102,-1252,21,-4,4,-4,-1,0,8,-3,-2
KR_7766542556,16518,15302,276,260,7,6,6,7,9,9,0,1,0,0,13,23,1,3,2,0,0,1,0,1,0,0,10,540206,1216,16,1,-1,0,-1,0,-10,-2,2
KR_7766574722,18851,15995,225,284,14,6,6,14,13,5,0,0,0,0,19,16,6,3,3,1,1,0,0,0,0,0,10,540269,2856,-59,8,-8,8,0,0,3,3,2
KR_7766588195,16222,13664,259,242,7,2,2,7,9,2,0,0,0,0,17,26,2,2,1,1,1,0,0,0,0,0,10,540190,2558,17,5,-5,7,0,0,-9,0,0
KR_7766597312,15878,14539,289,261,5,3,3,6,4,5,0,0,0,0,24,14,3,1,0,0,1,0,0,0,0,0,10,540269,1339,28,2,-3,-1,0,0,10,2,0
KR_7766603104,14001,14673,253,255,3,4,4,3,4,6,1,0,0,0,18,54,0,4,1,0,1,0,1,0,0,0,10,540190,-672,-2,-1,1,-2,1,0,-36,-4,1
KR_7766614170,15643,14877,245,232,8,6,6,8,11,5,0,0,0,0,13,15,8,2,0,0,1,0,0,0,0,0,10,540244,766,13,2,-2,6,0,0,-2,6,0
KR_7766615979,15732,12773,270,234,5,1,1,5,6,2,0,1,0,0,17,12,1,1,4,0,1,0,0,1,0,0,10,540106,2959,36,4,-4,4,-1,0,5,0,4
KR_7766635238,15700,17202,230,262,6,9,9,6,9,14,0,1,0,0,16,18,5,5,0,2,0,1,0,1,0,0,10,540247,-1502,-32,-3,3,-5,-1,0,-2,0,-2
KR_7766667205,14524,15308,286,270,3,5,5,3,2,8,1,0,0,0,14,18,2,2,1,0,0,1,1,0,0,0,10,540247,-784,16,-2,2,-6,1,0,-4,0,1
KR_7766668532,13511,17089,267,268,2,9,9,2,0,14,0,1,0,0,12,107,2,1,0,0,0,1,0,1,0,0,10,540219,-3578,-1,-7,7,-14,-1,0,-95,1,0
KR_7766677504,16830,15957,257,236,11,7,7,11,9,5,0,0,0,0,17,120,3,2,1,1,1,0,0,0,0,0,10,540254,873,21,4,-4,4,0,0,-103,1,0
KR_7766691050,16186,16116,288,273,7,6,6,7,9,6,0,0,0,0,19,17,3,2,1,0,1,0,0,0,0,0,10,540222,70,15,1,-1,3,0,0,2,1,1
KR_7766692309,14567,16132,283,266,2,6,6,3,1,8,0,0,0,0,16,45,3,4,1,0,0,1,0,0,0,0,10,540275,-1565,17,-4,3,-7,0,0,-29,-1,1
KR_7766692631,14180,16282,274,311,2,5,5,3,1,5,0,1,0,0,39,15,4,2,1,2,0,1,0,1,0,0,10,540218,-2102,-37,-3,2,-4,-1,0,24,2,-1
KR_7766715517,15543,14457,295,280,5,2,2,5,2,3,0,0,0,0,16,15,2,4,1,0,0,1,0,0,0,0,10,540175,1086,15,3,-3,-1,0,0,1,-2,1
KR_7766720614,17374,13417,271,240,10,3,3,11,14,2,0,0,0,0,43,19,6,3,0,0,0,1,0,0,0,0,10,540194,3957,31,7,-8,12,0,0,24,3,0
KR_7766736157,17763,14621,275,236,12,5,5,12,14,4,0,0,0,0,15,14,4,2,0,0,1,0,0,0,0,0,10,540198,3142,39,7,-7,10,0,0,1,2,0
KR_7766736793,14462,14533,251,290,4,2,2,4,5,2,0,0,0,0,26,16,5,6,0,1,1,0,0,0,0,0,10,540238,-71,-39,2,-2,3,0,0,10,-1,-1
KR_7766752628,16188,14773,280,238,5,5,5,5,6,7,1,0,0,0,15,19,6,1,4,0,1,0,1,0,0,0,10,540186,1415,42,0,0,-1,1,0,-4,5,4
KR_7766757847,16052,14541,282,263,7,3,3,7,10,3,0,1,0,0,15,10,1,3,0,1,1,0,0,1,0,0,10,540257,1511,19,4,-4,7,-1,0,5,-2,-1
KR_7766758465,14760,15726,264,270,4,7,8,4,3,5,0,1,0,0,14,15,4,2,0,0,1,0,0,1,0,0,10,540260,-966,-6,-3,4,-2,-1,0,-1,2,0
KR_7766763941,15884,16122,242,241,7,8,8,7,7,10,0,0,0,0,14,19,6,2,1,2,0,1,0,0,0,0,10,540213,-238,1,-1,1,-3,0,0,-5,4,-1
KR_7766767793,14966,15875,259,263,6,7,7,6,2,4,0,0,0,0,21,24,2,4,0,0,0,1,0,0,0,0,10,540222,-909,-4,-1,1,-2,0,0,-3,-2,0
KR_7766768879,13962,16571,239,249,4,8,8,4,3,10,0,0,0,0,22,13,0,3,2,2,0,1,0,0,0,0,10,540216,-2609,-10,-4,4,-7,0,0,9,-3,0
KR_7766796730,14550,15324,264,248,5,6,6,5,4,8,0,0,0,0,17,14,4,3,1,3,1,0,0,0,0,0,10,540240,-774,16,-1,1,-4,0,0,3,1,-2
KR_7766798443,15736,14506,269,268,6,4,4,6,9,5,0,0,0,0,36,31,7,4,1,0,1,0,0,0,0,0,10,540214,1230,1,2,-2,4,0,0,5,3,1
KR_7766798673,16448,13453,261,253,7,2,2,7,8,1,0,0,0,0,17,15,4,5,2,0,0,1,0,0,0,0,10,540201,2995,8,5,-5,7,0,0,2,-1,2
KR_7766805062,13007,17931,237,286,2,11,11,2,1,13,1,0,0,0,10,10,0,3,0,4,0,1,1,0,0,0,10,540195,-4924,-49,-9,9,-12,1,0,0,-3,-4
KR_7766806107,16262,14759,247,250,10,4,4,11,9,5,0,1,0,0,18,19,6,3,2,0,1,0,0,1,0,0,10,540269,1503,-3,6,-7,4,-1,0,-1,3,2
KR_7766815209,14811,14283,267,250,4,4,4,5,6,6,0,1,0,0,16,15,1,4,0,1,0,1,0,1,0,0,10,540261,528,17,0,-1,0,-1,0,1,-3,-1
KR_7766815233,16665,14539,264,224,8,6,6,8,8,3,0,0,0,0,16,14,4,4,2,0,1,0,0,0,0,0,10,540196,2126,40,2,-2,5,0,0,2,0,2
KR_7766818037,14273,14987,259,271,4,5,5,4,3,6,0,0,0,0,23,17,2,2,1,0,1,0,0,0,0,0,10,540266,-714,-12,-1,1,-3,0,0,6,0,1
KR_7766819808,14339,14088,290,276,2,3,3,2,1,1,0,1,0,0,14,40,6,4,0,0,1,0,0,1,0,0,10,540223,251,14,-1,1,0,-1,0,-26,2,0
KR_7766841520,15506,14526,267,286,7,3,3,8,6,3,0,0,0,0,13,33,4,1,0,1,1,0,0,0,0,0,10,540238,980,-19,4,-5,3,0,0,-20,3,-1
KR_7766843320,15382,17811,264,264,6,10,10,6,3,13,1,0,0,0,14,17,3,4,0,1,1,0,1,0,0,0,10,540238,-2429,0,-4,4,-10,1,0,-3,-1,-1
KR_7766862179,14747,16452,249,207,6,10,10,6,1,9,0,0,0,0,15,19,4,2,1,0,0,1,0,0,0,0,10,540236,-1705,42,-4,4,-8,0,0,-4,2,1
KR_7766867624,14024,14181,256,252,3,3,3,3,8,8,1,0,0,0,15,15,2,3,1,0,1,0,1,0,0,0,10,540212,-157,4,0,0,0,1,0,0,-1,1
KR_7766878326,14390,17630,259,264,3,12,12,3,4,15,1,0,0,0,33,14,1,2,0,0,1,0,1,0,0,0,10,540193,-3240,-5,-9,9,-11,1,0,19,-1,0
KR_7766882899,14613,13483,296,279,2,1,1,2,2,1,0,1,0,0,15,13,2,3,0,0,1,0,0,1,0,0,10,540239,1130,17,1,-1,1,-1,0,2,-1,0
KR_7766894908,12484,17707,224,280,1,11,11,1,1,10,0,0,0,0,13,9,1,2,0,2,0,1,0,0,0,0,10,540227,-5223,-56,-10,10,-9,0,0,4,-1,-2
KR_7766902132,13186,16453,237,290,2,7,7,2,3,9,0,0,0,0,13,17,2,3,0,2,0,1,0,0,0,0,10,540214,-3267,-53,-5,5,-6,0,0,-4,-1,-2
KR_7766903633,12323,17082,246,293,0,7,8,0,0,8,1,0,0,0,16,18,0,4,0,3,0,1,1,0,0,0,10,540191,-4759,-47,-7,8,-8,1,0,-2,-4,-3
KR_7766920213,14606,16984,289,253,3,10,10,3,2,12,0,0,0,0,13,41,4,2,1,2,1,0,0,0,0,0,10,540212,-2378,36,-7,7,-10,0,0,-28,2,-1
KR_7766940170,2567,2572,1,1,0,0,0,0,0,0,0,0,0,0,3,1,0,0,0,0,0,0,0,0,0,0,3,104315,-5,0,0,0,0,0,0,2,0,0
KR_7766941590,14963,14789,259,279,5,3,3,5,8,6,0,1,0,0,16,17,1,0,0,1,1,0,0,1,0,0,10,540272,174,-20,2,-2,2,-1,0,-1,1,-1
KR_7766947989,13904,15726,250,268,3,5,5,3,3,7,1,0,0,0,15,22,2,1,0,0,1,0,1,0,0,0,10,540254,-1822,-18,-2,2,-4,1,0,-7,1,0
KR_7766954708,12760,18952,208,271,2,13,13,2,1,14,0,1,0,0,29,18,3,3,0,2,0,1,0,1,0,0,10,540217,-6192,-63,-11,11,-13,-1,0,11,0,-2
KR_7766955196,14975,15377,310,269,3,6,6,3,2,4,0,1,0,0,16,15,3,4,0,0,0,1,0,1,0,0,10,540217,-402,41,-3,3,-2,-1,0,1,-1,0
KR_7766963117,14263,16708,244,281,4,8,8,4,4,5,0,0,0,0,11,15,2,2,0,2,0,1,0,0,0,0,10,540236,-2445,-37,-4,4,-1,0,0,-4,0,-2
KR_7766964433,16463,13606,254,236,8,2,2,8,9,3,0,0,0,0,14,14,1,1,0,1,1,0,0,0,0,0,10,540255,2857,18,6,-6,6,0,0,0,0,-1
KR_7766968565,15697,15061,253,245,8,6,6,8,4,3,0,1,0,0,32,18,2,2,1,2,1,0,0,1,0,0,10,540253,636,8,2,-2,1,-1,0,14,0,-1
KR_7766973523,14471,15384,240,233,4,8,8,4,4,6,0,0,0,0,16,16,4,1,3,0,0,1,0,0,0,0,10,540214,-913,7,-4,4,-2,0,0,0,3,3
KR_7766996680,15395,14445,286,246,4,5,5,4,2,3,0,1,0,0,35,13,3,5,1,1,1,0,0,1,0,0,10,540180,950,40,-1,1,-1,-1,0,22,-2,0
KR_7767008720,11062,12211,166,178,4,5,5,5,3,6,0,0,0,0,8,11,2,1,0,0,0,1,0,0,0,0,8,410804,-1149,-12,-1,0,-3,0,0,-3,1,0
KR_7767016980,14909,14185,282,271,5,3,3,5,2,1,0,1,0,0,13,17,3,3,0,0,0,1,0,1,0,0,10,540265,724,11,2,-2,1,-1,0,-4,0,0
KR_7767041481,15181,14565,283,278,3,3,3,3,5,5,0,1,0,0,13,19,7,1,2,0,0,1,0,1,0,0,10,540186,616,5,0,0,0,-1,0,-6,6,2
KR_7767043086,14303,14407,256,241,4,5,5,4,4,6,0,0,0,0,19,48,2,1,0,0,1,0,0,0,0,0,10,540189,-104,15,-1,1,-2,0,0,-29,1,0
KR_7767054739,13564,16398,207,245,6,9,11,6,2,7,0,0,0,0,29,29,3,0,0,1,0,1,0,0,0,0,10,540100,-2834,-38,-3,5,-5,0,0,0,3,-1
KR_7767076647,15916,15037,283,268,6,5,5,6,5,3,1,0,0,0,18,19,4,4,0,0,1,0,1,0,0,0,10,540293,879,15,1,-1,2,1,0,-1,0,0
KR_7767086400,16449,12572,275,241,8,1,1,8,7,0,0,1,0,0,18,14,3,1,3,0,1,0,0,1,0,0,10,540263,3877,34,7,-7,7,-1,0,4,2,3
KR_7767109157,14583,15713,263,285,4,5,5,5,2,4,0,0,0,0,14,23,4,2,2,1,1,0,0,0,0,0,10,540264,-1130,-22,-1,0,-2,0,0,-9,2,1
KR_7767134749,14544,15118,287,276,2,4,4,2,4,5,0,0,0,0,14,18,2,5,0,1,0,1,0,0,0,0,10,540213,-574,11,-2,2,-1,0,0,-4,-3,-1
KR_7767134856,16695,13727,285,272,8,1,1,8,10,3,0,1,0,0,17,34,4,5,0,1,1,0,0,1,0,0,10,540240,2968,13,7,-7,7,-1,0,-17,-1,-1
KR_7767152061,15072,15644,267,271,5,6,6,5,7,7,0,0,0,0,17,32,4,4,0,0,0,1,0,0,0,0,10,540274,-572,-4,-1,1,0,0,0,-15,0,0
KR_7767158433,16703,13832,293,255,7,3,4,7,9,4,0,1,0,0,17,15,1,1,0,0,0,1,0,1,0,0,10,540212,2871,38,4,-3,5,-1,0,2,0,0
KR_7767162537,14515,14463,256,277,3,3,3,3,5,5,0,1,0,0,29,19,2,2,0,1,1,0,0,1,0,0,10,540213,52,-21,0,0,0,-1,0,10,0,-1
KR_7767170280,14598,17398,222,238,6,14,14,6,5,8,0,0,0,0,15,20,5,4,1,0,1,0,0,0,0,0,10,540282,-2800,-16,-8,8,-3,0,0,-5,1,1
KR_7767177540,15018,15456,255,237,4,6,7,4,8,12,0,0,0,0,13,18,4,2,1,1,1,0,0,0,0,0,10,540159,-438,18,-2,3,-4,0,0,-5,2,0
KR_7767187414,15744,15310,244,268,7,6,6,7,11,4,0,0,0,0,13,13,1,1,0,0,0,1,0,0,0,0,10,540224,434,-24,1,-1,7,0,0,0,0,0
KR_7767194539,14752,16220,246,245,6,8,8,7,4,12,0,0,0,0,17,19,3,5,0,1,1,0,0,0,0,0,10,540229,-1468,1,-2,1,-8,0,0,-2,-2,-1
KR_7767200147,16278,15426,257,257,7,5,5,7,11,5,0,0,0,0,15,15,3,4,3,1,1,0,0,0,0,0,10,540200,852,0,2,-2,6,0,0,0,-1,2
KR_7767207354,15440,13927,261,237,5,3,3,5,5,5,0,0,0,0,16,15,4,2,0,0,0,1,0,0,0,0,10,540069,1513,24,2,-2,0,0,0,1,2,0
KR_7767216614,16267,14645,299,256,5,4,4,5,8,9,0,1,0,0,11,13,2,2,1,1,0,1,0,1,0,0,10,540285,1622,43,1,-1,-1,-1,0,-2,0,0
KR_7767218097,15043,15966,275,271,5,5,5,5,3,6,0,0,0,0,15,34,1,1,0,0,1,0,0,0,0,0,10,540234,-923,4,0,0,-3,0,0,-19,0,0
KR_7767220658,16195,13940,275,263,6,2,2,6,8,3,0,0,0,0,19,42,3,6,1,0,1,0,0,0,0,0,10,540214,2255,12,4,-4,5,0,0,-23,-3,1
KR_7767246329,14265,16354,279,287,2,6,6,2,2,6,0,1,0,0,13,16,2,2,1,1,0,1,0,1,0,0,10,540260,-2089,-8,-4,4,-4,-1,0,-3,0,0
KR_7767268543,15246,15304,228,251,6,6,6,6,9,6,0,1,0,0,14,20,4,0,0,1,0,1,0,1,0,0,10,540292,-58,-23,0,0,3,-1,0,-6,4,-1
KR_7767273726,15617,13762,282,271,6,2,2,6,6,3,0,1,0,0,16,20,4,3,0,0,0,1,0,1,0,0,10,540272,1855,11,4,-4,3,-1,0,-4,1,0
KR_7767275733,17605,13871,277,253,9,4,4,9,7,3,0,1,0,0,16,12,0,2,5,0,0,1,0,1,0,0,10,540214,3734,24,5,-5,4,-1,0,4,-2,5
KR_7767280185,15678,16128,219,267,9,6,6,9,10,8,0,0,0,0,19,18,1,3,0,2,0,1,0,0,0,0,10,540237,-450,-48,3,-3,2,0,0,1,-2,-2
KR_7767281189,17758,14588,267,243,11,3,3,11,16,2,0,0,0,0,13,15,0,2,0,0,1,0,0,0,0,0,10,540263,3170,24,8,-8,14,0,0,-2,-2,0
KR_7767282509,14511,14739,234,229,5,6,6,5,5,7,0,0,0,0,15,30,1,4,0,0,1,0,0,0,0,0,10,540308,-228,5,-1,1,-2,0,0,-15,-3,0
KR_7767291503,15516,15738,295,274,4,5,5,4,3,9,0,0,0,0,15,39,0,1,0,0,1,0,0,0,0,0,10,540241,-222,21,-1,1,-6,0,0,-24,-1,0
KR_7767308012,15196,15267,280,276,4,6,6,4,3,2,0,1,0,0,14,12,1,3,1,1,0,1,0,1,0,0,10,540266,-71,4,-2,2,1,-1,0,2,-2,0
KR_7767311048,15157,15410,227,243,5,7,8,5,12,7,0,0,0,0,30,13,8,0,0,0,0,1,0,0,0,0,10,540252,-253,-16,-2,3,5,0,0,17,8,0
KR_7767314088,17428,13577,240,193,13,5,5,13,16,2,0,0,0,0,19,14,6,1,1,0,0,1,0,0,0,0,10,540199,3851,47,8,-8,14,0,0,5,5,1
KR_7767317600,15152,17085,261,293,4,9,9,4,5,10,0,1,0,0,90,29,5,3,1,1,0,1,0,1,0,0,10,540180,-1933,-32,-5,5,-5,-1,0,61,2,0
KR_7767333778,16753,15023,212,213,10,6,6,11,10,5,0,0,0,0,14,15,0,3,2,0,1,0,0,0,0,0,10,540233,1730,-1,4,-5,5,0,0,-1,-3,2
KR_7767341436,17397,16193,266,252,9,7,7,9,11,8,0,0,0,0,124,12,2,2,2,0,1,0,0,0,0,0,10,540231,1204,14,2,-2,3,0,0,112,0,2
KR_7767360063,13016,14465,242,292,1,2,2,1,1,2,0,1,0,0,16,14,3,4,0,0,0,1,0,1,0,0,10,540220,-1449,-50,-1,1,-1,-1,0,2,-1,0
KR_7767369481,15154,15481,241,259,6,6,6,6,7,4,0,0,0,0,18,17,2,3,1,1,0,1,0,0,0,0,10,540253,-327,-18,0,0,3,0,0,1,-1,0
KR_7767385303,15800,15635,259,264,6,5,6,6,13,3,0,0,0,0,17,16,2,4,0,2,0,1,0,0,0,0,10,540235,165,-5,1,0,10,0,0,1,-2,-2
KR_7767392829,15114,17170,282,266,4,9,9,4,5,16,0,0,0,0,18,40,1,7,1,1,0,1,0,0,0,0,10,540255,-2056,16,-5,5,-11,0,0,-22,-6,0
KR_7767398823,16557,14103,275,282,9,2,2,9,14,2,0,0,0,0,16,16,0,0,0,1,1,0,0,0,0,0,10,540214,2454,-7,7,-7,12,0,0,0,0,-1
KR_7767406105,16434,15380,273,252,7,5,5,7,9,7,1,0,0,0,14,13,4,2,3,0,1,0,1,0,0,0,10,540258,1054,21,2,-2,2,1,0,1,2,3
KR_7767427993,16088,15780,272,260,6,6,6,6,8,7,1,0,0,0,15,11,1,3,1,1,0,1,1,0,0,0,10,540257,308,12,0,0,1,1,0,4,-2,0
KR_7767433476,14474,17160,275,289,3,10,10,3,3,7,0,1,0,0,14,17,3,5,0,2,0,1,0,1,0,0,10,540098,-2686,-14,-7,7,-4,-1,0,-3,-2,-2
KR_7767460266,15726,15768,272,274,6,7,7,6,6,6,0,0,0,0,15,20,2,4,1,0,0,1,0,0,0,0,10,540233,-42,-2,-1,1,0,0,0,-5,-2,1
KR_7767464568,14484,15644,231,237,6,7,7,6,3,10,0,0,0,0,17,13,1,3,1,0,0,1,0,0,0,0,10,540257,-1160,-6,-1,1,-7,0,0,4,-2,1
KR_7767465980,14235,15771,283,276,2,6,6,2,2,7,0,1,0,0,16,20,5,2,0,2,1,0,0,1,0,0,10,540230,-1536,7,-4,4,-5,-1,0,-4,3,-2
KR_7767473550,15532,15156,288,274,5,4,4,5,9,7,0,0,0,0,22,19,1,4,0,0,1,0,0,0,0,0,10,540114,376,14,1,-1,2,0,0,3,-3,0
KR_7767497499,15193,14001,294,271,3,2,2,3,4,3,1,0,0,0,16,15,4,3,2,0,1,0,1,0,0,0,10,540198,1192,23,1,-1,1,1,0,1,1,2
KR_7767497777,14695,13019,279,247,4,1,1,4,3,1,1,0,0,0,19,10,1,5,0,0,0,1,1,0,0,0,10,540119,1676,32,3,-3,2,1,0,9,-4,0
KR_7767521239,16927,14560,269,258,8,4,4,8,11,3,0,1,0,0,16,37,3,4,1,0,1,0,0,1,0,0,10,540270,2367,11,4,-4,8,-1,0,-21,-1,1
KR_7767528513,15267,15568,268,301,6,4,4,6,4,3,1,0,0,0,86,12,1,1,0,1,0,1,1,0,0,0,10,540276,-301,-33,2,-2,1,1,0,74,0,-1
KR_7767528534,14052,15831,265,301,3,5,5,3,2,3,0,0,0,0,20,23,1,5,0,0,1,0,0,0,0,0,10,540234,-1779,-36,-2,2,-1,0,0,-3,-4,0
KR_7767546940,13788,13974,233,288,3,1,1,3,7,1,0,0,0,0,39,18,3,4,1,1,1,0,0,0,0,0,10,540218,-186,-55,2,-2,6,0,0,21,-1,0
KR_7767566397,15301,19300,248,306,6,14,14,6,7,22,0,0,0,0,12,17,3,2,0,3,1,0,0,0,0,0,10,540158,-3999,-58,-8,8,-15,0,0,-5,1,-3
KR_7767581254,13384,16634,250,280,2,7,7,2,3,11,0,1,0,0,12,16,6,3,0,1,0,1,0,1,0,0,10,540237,-3250,-30,-5,5,-8,-1,0,-4,3,-1
KR_7767584316,15381,13466,301,265,5,2,2,5,2,2,0,0,0,0,14,9,2,0,0,0,1,0,0,0,0,0,10,540234,1915,36,3,-3,0,0,0,5,2,0
KR_7767601361,17882,16250,239,280,11,5,5,11,15,8,1,0,0,0,59,20,3,7,1,4,1,0,1,0,0,0,10,540198,1632,-41,6,-6,7,1,0,39,-4,-3
KR_7767603113,15571,15505,211,252,8,7,7,8,11,3,0,1,0,0,18,13,1,4,1,4,0,1,0,1,0,0,10,540177,66,-41,1,-1,8,-1,0,5,-3,-3
KR_7767605513,14549,17497,262,253,4,10,10,4,7,16,1,0,0,0,32,12,3,4,0,1,0,1,1,0,0,0,10,540312,-2948,9,-6,6,-9,1,0,20,-1,-1
KR_7767605643,14857,16928,256,280,4,8,8,4,4,10,0,0,0,0,19,20,7,4,0,1,0,1,0,0,0,0,10,540268,-2071,-24,-4,4,-6,0,0,-1,3,-1
KR_7767611560,15374,16491,257,243,5,7,7,5,6,9,0,0,0,0,12,16,3,1,2,3,0,1,0,0,0,1,10,540233,-1117,14,-2,2,-3,0,0,-4,2,-1
KR_7767621515,16087,13196,268,284,7,0,0,7,13,0,0,1,0,0,13,22,3,2,0,0,1,0,0,1,0,0,10,540231,2891,-16,7,-7,13,-1,0,-9,1,0
KR_7767637278,13526,13845,266,248,2,3,3,2,0,6,1,0,0,0,25,14,2,2,1,0,0,1,1,0,0,0,10,540299,-319,18,-1,1,-6,1,0,11,0,1
KR_7767646856,15955,15364,285,276,6,4,4,6,3,7,0,0,0,0,15,16,2,2,2,1,1,0,0,0,0,0,10,540228,591,9,2,-2,-4,0,0,-1,0,1
KR_7767648590,15494,15456,283,276,5,5,5,5,5,7,0,0,0,0,18,18,4,1,0,1,1,0,0,0,0,0,10,540237,38,7,0,0,-2,0,0,0,3,-1
KR_7767651229,15999,15368,285,264,5,5,5,5,4,9,0,0,0,0,17,124,3,2,0,0,1,0,0,0,0,0,10,540206,631,21,0,0,-5,0,0,-107,1,0
KR_7767655551,15823,16332,229,276,8,6,6,8,17,6,1,0,0,0,47,11,0,3,1,4,0,1,1,0,0,0,10,540224,-509,-47,2,-2,11,1,0,36,-3,-3
KR_7767671941,16760,14967,304,240,7,5,5,7,5,6,1,0,0,0,20,13,2,3,1,0,1,0,1,0,0,0,10,540249,1793,64,2,-2,-1,1,0,7,-1,1
KR_7767680730,17690,15210,259,253,12,6,6,12,19,7,0,0,0,0,18,15,5,7,1,0,1,0,0,0,0,0,10,540217,2480,6,6,-6,12,0,0,3,-2,1
KR_7767683929,14110,14596,251,240,4,4,4,4,3,6,0,0,0,0,14,15,2,3,0,2,1,0,0,0,0,0,10,540251,-486,11,0,0,-3,0,0,-1,-1,-2
KR_7767690664,15403,15922,254,262,6,7,7,6,5,7,0,0,0,0,16,17,2,2,1,2,0,1,0,0,0,0,10,540276,-519,-8,-1,1,-2,0,0,-1,0,-1
KR_7767691129,13696,15088,262,276,2,5,5,2,3,5,0,1,0,0,21,20,3,1,0,0,0,1,0,1,0,0,10,540233,-1392,-14,-3,3,-2,-1,0,1,2,0
KR_7767697910,16431,13849,278,258,6,3,3,6,10,3,1,0,0,0,37,14,4,4,1,0,0,1,1,0,0,0,10,540210,2582,20,3,-3,7,1,0,23,0,1
KR_7767700453,15036,14904,210,239,9,7,7,9,10,2,0,0,0,0,10,15,3,1,0,0,1,0,0,0,0,0,10,540256,132,-29,2,-2,8,0,0,-5,2,0
KR_7767705786,16130,14529,263,213,7,6,6,7,8,5,0,0,0,0,98,141,2,2,1,0,0,1,0,0,0,0,10,540210,1601,50,1,-1,3,0,0,-43,0,1
KR_7767711515,14522,14553,277,267,3,3,3,3,10,5,1,0,0,0,23,127,3,6,0,0,1,0,1,0,0,0,10,540236,-31,10,0,0,5,1,0,-104,-3,0
KR_7767725961,14301,15225,268,272,3,4,4,3,2,5,0,0,0,0,12,18,5,0,0,0,1,0,0,0,0,0,10,540214,-924,-4,-1,1,-3,0,0,-6,5,0
KR_7767735436,15610,14552,262,261,6,3,3,6,6,6,0,0,0,0,44,15,2,1,1,0,1,0,0,0,0,0,10,540127,1058,1,3,-3,0,0,0,29,1,1
KR_7767741118,16103,15670,280,263,7,7,7,9,3,7,0,1,0,0,12,16,5,3,0,1,1,0,0,1,0,0,10,540212,433,17,0,-2,-4,-1,0,-4,2,-1
KR_7767742749,16303,14034,284,239,8,4,4,8,9,5,0,0,0,0,21,14,3,4,0,0,0,1,0,0,0,0,10,540198,2269,45,4,-4,4,0,0,7,-1,0
KR_7767744876,16092,15359,257,242,8,8,8,8,13,8,0,1,0,0,14,16,7,5,0,0,1,0,0,1,0,0,10,540232,733,15,0,0,5,-1,0,-2,2,0
KR_7767745481,15854,14662,262,276,6,3,3,6,7,4,0,0,0,0,36,17,5,4,0,1,1,0,0,0,0,0,10,540231,1192,-14,3,-3,3,0,0,19,1,-1
KR_7767753872,16004,15176,268,267,7,4,4,7,6,2,1,0,0,0,17,12,2,2,0,3,0,1,1,0,0,0,10,540244,828,1,3,-3,4,1,0,5,0,-3
KR_7767754793,14370,15939,260,269,3,5,5,3,4,6,0,0,0,0,17,16,1,4,0,2,0,1,0,0,0,0,10,540235,-1569,-9,-2,2,-2,0,0,1,-3,-2
KR_7767759972,12967,15655,271,255,0,7,7,0,0,10,0,1,0,0,32,13,4,1,0,0,0,1,0,1,0,0,10,540256,-2688,16,-7,7,-10,-1,0,19,3,0
KR_7767767044,16174,16364,261,262,7,8,8,7,6,8,0,0,0,0,19,14,4,2,1,1,1,0,0,0,0,0,10,540282,-190,-1,-1,1,-2,0,0,5,2,0
KR_7767767279,15486,15623,245,267,6,6,6,6,10,7,0,0,0,0,17,19,3,3,0,2,0,1,0,0,0,0,10,540283,-137,-22,0,0,3,0,0,-2,0,-2
KR_7767770609,15236,16449,247,225,6,10,10,6,4,11,0,0,0,0,23,14,2,5,1,1,0,1,0,0,0,0,10,540258,-1213,22,-4,4,-7,0,0,9,-3,0
KR_7767783135,16949,14041,262,221,9,5,5,9,7,3,0,0,0,0,132,12,0,2,1,0,1,0,0,0,0,0,10,540228,2908,41,4,-4,4,0,0,120,-2,1
KR_7767787703,17749,15074,270,253,11,4,4,11,16,8,0,0,0,0,18,15,2,1,1,2,0,1,0,0,0,0,10,540276,2675,17,7,-7,8,0,0,3,1,-1
KR_7767788488,14507,14730,264,219,4,6,6,4,1,8,0,1,0,0,13,17,4,3,0,0,0,1,0,1,0,0,10,540280,-223,45,-2,2,-7,-1,0,-4,1,0
KR_7767790626,13341,15656,258,274,1,5,5,1,2,8,0,0,0,0,14,23,2,4,0,0,0,1,0,0,0,0,10,540241,-2315,-16,-4,4,-6,0,0,-9,-2,0
KR_7767797496,15435,14645,284,248,5,5,5,5,4,5,0,1,0,0,13,13,2,3,1,0,1,0,0,1,0,0,10,540240,790,36,0,0,-1,-1,0,0,-1,1
KR_7767798289,17560,16096,264,264,8,7,7,8,19,6,0,1,0,0,21,13,2,7,0,0,0,1,0,1,0,0,10,540200,1464,0,1,-1,13,-1,0,8,-5,0
KR_7767799739,13606,17022,241,291,3,8,8,3,5,8,0,0,0,0,8,18,2,1,0,1,0,1,0,0,0,0,10,540104,-3416,-50,-5,5,-3,0,0,-10,1,-1
KR_7767804556,15303,14842,258,249,5,5,5,5,9,7,1,0,0,0,17,92,2,3,0,0,1,0,1,0,0,0,10,540199,461,9,0,0,2,1,0,-75,-1,0
KR_7767804917,15076,15490,264,273,5,6,6,5,4,4,0,1,0,0,16,34,3,4,0,0,0,1,0,1,0,0,10,540206,-414,-9,-1,1,0,-1,0,-18,-1,0
KR_7767805891,13145,14478,273,314,0,1,1,0,0,2,0,0,0,0,17,37,6,3,1,0,0,1,0,0,0,0,10,540239,-1333,-41,-1,1,-2,0,0,-20,3,1
KR_7767813448,18968,15167,214,214,17,6,6,17,22,7,1,0,0,0,18,66,1,1,2,2,1,0,1,0,0,0,10,540209,3801,0,11,-11,15,1,0,-48,0,0
KR_7767825866,17750,15840,261,227,10,9,9,10,17,12,0,1,0,0,16,17,1,3,1,0,0,1,0,1,0,0,10,540235,1910,34,1,-1,5,-1,0,-1,-2,1
KR_7767827203,14774,15932,238,254,6,6,6,6,9,9,0,0,0,0,13,18,6,1,0,2,1,0,0,0,0,0,10,540253,-1158,-16,0,0,0,0,0,-5,5,-2
KR_7767831141,15753,15912,292,277,5,5,5,5,6,5,1,0,0,0,21,14,5,2,0,1,0,1,1,0,0,0,10,540290,-159,15,0,0,1,1,0,7,3,-1
KR_7767836357,16417,13733,272,253,5,2,2,5,8,4,0,1,0,0,35,31,7,2,5,1,1,0,0,1,1,0,10,540261,2684,19,3,-3,4,-1,0,4,5,4
KR_7767840649,14502,13456,232,266,6,1,1,6,5,0,1,0,0,0,15,13,3,8,0,2,1,0,1,0,0,0,10,540239,1046,-34,5,-5,5,1,0,2,-5,-2
KR_7767846514,15547,16804,275,253,5,9,9,5,5,14,0,0,0,0,17,19,2,1,2,0,0,1,0,0,0,0,10,540240,-1257,22,-4,4,-9,0,0,-2,1,2
KR_7767848640,16398,15219,282,225,7,6,7,7,9,6,0,0,0,0,16,30,5,2,1,0,1,0,0,0,0,0,10,540201,1179,57,1,0,3,0,0,-14,3,1
KR_7767851007,14186,17647,225,282,3,9,9,3,7,11,0,0,0,0,19,20,4,7,0,0,0,1,0,0,0,0,10,540183,-3461,-57,-6,6,-4,0,0,-1,-3,0
KR_7767861124,16528,16489,225,242,10,9,9,10,10,6,0,0,0,0,12,16,2,1,0,3,0,1,0,0,0,0,10,540226,39,-17,1,-1,4,0,0,-4,1,-3
KR_7767861245,14779,14758,293,233,2,5,6,2,3,5,0,0,0,0,12,34,3,1,0,0,1,0,0,0,0,0,10,540202,21,60,-3,4,-2,0,0,-22,2,0
KR_7767865069,15753,14645,291,250,5,4,4,5,4,3,0,1,0,0,16,19,2,2,1,1,0,1,0,1,0,0,10,540210,1108,41,1,-1,1,-1,0,-3,0,0
KR_7767865523,15341,14495,263,262,6,5,5,6,7,6,0,0,0,0,16,33,4,2,0,0,0,1,0,0,0,0,10,540232,846,1,1,-1,1,0,0,-17,2,0
KR_7767870827,15713,15539,278,275,6,6,6,6,6,3,0,0,0,0,99,11,0,1,0,1,0,1,0,0,0,0,10,540068,174,3,0,0,3,0,0,88,-1,-1
KR_7767876176,17238,14245,264,211,9,5,5,9,9,5,0,0,0,0,29,14,6,3,1,0,0,1,0,0,0,0,10,540290,2993,53,4,-4,4,0,0,15,3,1
KR_7767879278,15336,15522,261,235,7,7,8,7,3,8,0,0,0,0,17,12,2,2,1,0,0,1,0,0,0,0,10,540222,-186,26,0,1,-5,0,0,5,0,1
KR_7767882634,16065,13421,252,272,8,0,0,8,10,0,0,0,0,0,18,19,4,2,1,1,1,0,0,0,0,0,10,540118,2644,-20,8,-8,10,0,0,-1,2,0
KR_7767883069,14719,15125,263,255,4,5,5,4,8,7,0,0,0,0,20,15,5,0,1,0,0,1,0,0,0,0,10,540184,-406,8,-1,1,1,0,0,5,5,1
KR_7767884523,14057,15103,264,292,3,4,4,3,3,2,0,0,0,0,17,36,1,4,1,1,0,1,0,0,0,0,10,540248,-1046,-28,-1,1,1,0,0,-19,-3,0
KR_7767897068,14181,18609,217,257,5,12,12,5,5,18,0,0,0,0,86,17,2,6,0,1,1,0,0,0,0,0,10,540201,-4428,-40,-7,7,-13,0,0,69,-4,-1
KR_7767902009,14509,13688,281,220,3,3,3,3,4,4,0,1,0,0,14,17,0,1,0,0,0,1,0,1,0,0,10,540226,821,61,0,0,0,-1,0,-3,-1,0
KR_7767902413,15848,13463,262,224,7,3,3,7,4,3,0,0,0,0,16,17,5,2,3,0,1,0,0,0,0,0,10,540199,2385,38,4,-4,1,0,0,-1,3,3
KR_7767906170,15378,15396,281,256,6,5,5,6,6,6,1,0,0,0,14,16,3,6,1,2,1,0,1,0,0,0,10,540265,-18,25,1,-1,0,1,0,-2,-3,-1
KR_7767909966,20501,15996,208,210,21,7,7,21,32,7,0,0,0,0,22,16,5,3,2,3,1,0,0,0,0,0,10,540284,4505,-2,14,-14,25,0,0,6,2,-1
KR_7767910100,7255,6509,117,88,1,1,1,1,1,0,0,0,0,0,7,5,0,0,0,0,0,1,0,0,0,0,6,284212,746,29,0,0,1,0,0,2,0,0
KR_7767912727,14338,17455,240,262,4,11,11,4,3,16,0,0,0,0,53,114,1,6,0,0,0,1,0,0,0,0,10,540199,-3117,-22,-7,7,-13,0,0,-61,-5,0
KR_7767915592,15319,14224,261,273,6,2,3,6,3,3,0,0,0,0,17,17,3,3,1,0,1,0,0,0,0,0,10,540216,1095,-12,4,-3,0,0,0,0,0,1
KR_7767925620,18231,15927,244,228,11,8,8,11,20,9,0,0,0,0,17,16,1,1,2,0,1,0,0,0,1,0,10,540184,2304,16,3,-3,11,0,0,1,0,2
KR_7767933394,17016,14229,264,277,10,2,2,10,8,2,0,0,0,0,19,17,5,3,1,0,1,0,0,0,0,0,10,540255,2787,-13,8,-8,6,0,0,2,2,1
KR_7767936065,16061,13310,292,267,6,1,1,6,15,1,1,0,0,0,17,19,4,5,1,0,1,0,1,0,0,0,10,540192,2751,25,5,-5,14,1,0,-2,-1,1
KR_7767950010,17095,16957,244,225,10,9,9,11,13,8,1,0,0,0,20,12,1,0,2,0,0,1,1,0,0,0,10,540194,138,19,1,-2,5,1,0,8,1,2
KR_7767966151,16482,14434,239,242,10,5,5,10,11,4,0,0,0,0,18,16,3,1,0,0,0,1,0,0,0,0,10,540208,2048,-3,5,-5,7,0,0,2,2,0
KR_7767972478,16868,15554,276,260,9,6,6,9,4,6,0,0,0,0,14,18,3,1,2,0,1,0,0,0,0,0,10,540180,1314,16,3,-3,-2,0,0,-4,2,2
KR_7767975168,14035,20639,197,265,4,17,17,4,5,20,0,1,0,0,17,107,1,2,0,5,0,1,0,1,0,0,10,540232,-6604,-68,-13,13,-15,-1,0,-90,-1,-5
KR_7767993016,15089,14768,278,292,5,4,4,5,6,4,0,1,0,0,111,20,2,3,0,0,1,0,0,1,0,0,10,540178,321,-14,1,-1,2,-1,0,91,-1,0
KR_7767998383,14174,19400,242,273,4,15,15,4,4,18,0,0,0,0,12,14,0,2,0,2,0,1,0,0,0,0,10,540228,-5226,-31,-11,11,-14,0,0,-2,-2,-2
KR_7767998574,13829,13645,269,238,2,3,3,2,1,2,0,0,0,0,22,43,1,5,0,0,1,0,0,0,0,0,10,540217,184,31,-1,1,-1,0,0,-21,-4,0
KR_7768010299,16183,15473,262,269,7,5,5,7,8,3,1,0,0,0,48,14,5,6,0,1,1,0,1,0,0,0,10,540231,710,-7,2,-2,5,1,0,34,-1,-1
KR_7768017659,17663,14635,276,245,9,4,4,9,13,7,0,0,0,0,13,15,4,0,0,0,0,1,0,0,0,0,10,540197,3028,31,5,-5,6,0,0,-2,4,0
KR_7768020162,13846,15545,247,249,4,8,8,4,2,10,0,0,0,0,14,112,6,1,0,0,1,0,0,0,0,0,10,540224,-1699,-2,-4,4,-8,0,0,-98,5,0
KR_7768035787,15758,15011,240,261,8,5,5,8,11,6,0,0,0,0,228,13,2,5,0,0,1,0,0,0,0,0,10,540291,747,-21,3,-3,5,0,0,215,-3,0
KR_7768035861,14894,17641,238,272,5,11,11,5,3,7,0,1,0,0,16,17,3,2,1,2,0,1,0,1,0,0,10,540192,-2747,-34,-6,6,-4,-1,0,-1,1,-1
KR_7768053395,15263,13740,255,277,5,2,2,5,7,3,0,0,0,0,17,102,4,5,0,0,0,1,0,0,0,0,10,540206,1523,-22,3,-3,4,0,0,-85,-1,0
KR_7768058665,16875,16623,246,241,9,10,10,9,7,11,0,1,0,0,15,16,0,1,1,1,1,0,0,1,0,0,10,540236,252,5,-1,1,-4,-1,0,-1,-1,0
KR_7768061861,14370,17188,256,237,3,11,11,3,4,18,0,1,0,0,11,16,3,0,0,3,0,1,0,1,0,0,10,540236,-2818,19,-8,8,-14,-1,0,-5,3,-3
KR_7768068984,15420,14654,257,271,7,3,3,7,9,5,0,0,0,0,35,39,4,4,0,0,1,0,0,0,0,0,10,540209,766,-14,4,-4,4,0,0,-4,0,0
KR_7768082166,14314,14559,250,279,3,3,3,3,4,6,0,0,0,0,23,17,5,6,0,0,1,0,0,0,0,0,10,540254,-245,-29,0,0,-2,0,0,6,-1,0
KR_7768086582,14696,15243,271,257,4,5,5,4,3,7,0,1,0,0,12,63,2,2,1,0,0,1,0,1,0,0,10,540233,-547,14,-1,1,-4,-1,0,-51,0,1
KR_7768087017,16161,17306,189,239,11,12,12,12,10,13,0,0,0,0,34,12,1,3,0,1,0,1,0,0,0,0,10,540267,-1145,-50,-1,0,-3,0,0,22,-2,-1
KR_7768107451,16538,14636,255,254,10,4,4,10,15,9,1,0,0,0,15,39,3,2,2,0,0,1,1,0,0,0,10,540261,1902,1,6,-6,6,1,0,-24,1,2
KR_7768108259,15966,15965,254,242,8,8,8,8,4,8,0,0,0,0,13,10,0,1,0,1,0,1,0,0,0,0,10,540214,1,12,0,0,-4,0,0,3,-1,-1
KR_7768115329,16616,14271,267,241,10,3,3,10,9,2,1,0,0,0,13,12,1,0,1,1,1,0,1,0,0,0,10,540183,2345,26,7,-7,7,1,0,1,1,0
KR_7768118253,14709,15409,265,275,3,5,5,3,3,5,1,0,0,0,18,50,2,3,0,0,0,1,1,0,0,0,10,540202,-700,-10,-2,2,-2,1,0,-32,-1,0
KR_7768122379,19046,14756,283,247,14,5,5,14,12,3,1,0,0,0,11,13,5,4,2,0,1,0,1,0,0,0,10,540216,4290,36,9,-9,9,1,0,-2,1,2
KR_7768122907,13455,16532,236,272,3,9,9,3,1,8,0,0,0,0,11,14,1,2,1,2,0,1,0,0,0,0,10,540261,-3077,-36,-6,6,-7,0,0,-3,-1,-1
KR_7768131208,15713,14225,247,252,7,3,3,7,10,2,1,0,0,0,40,13,2,3,1,2,1,0,1,0,0,0,10,540233,1488,-5,4,-4,8,1,0,27,-1,-1
KR_7768136101,15798,15959,267,294,6,5,5,6,7,3,0,1,0,0,34,14,1,1,1,3,1,0,0,1,0,0,10,540232,-161,-27,1,-1,4,-1,0,20,0,-2
KR_7768138798,16145,14187,283,238,6,4,4,6,3,5,0,0,0,0,15,16,2,5,0,0,0,1,0,0,0,0,10,540172,1958,45,2,-2,-2,0,0,-1,-3,0
KR_7768139659,13427,16484,243,267,2,8,8,2,2,12,1,0,0,0,11,15,4,4,0,1,1,0,1,0,0,0,10,540206,-3057,-24,-6,6,-10,1,0,-4,0,-1
KR_7768146676,13782,18192,196,271,5,12,12,5,3,10,0,0,0,0,16,27,3,1,0,2,1,0,0,0,0,0,10,540221,-4410,-75,-7,7,-7,0,0,-11,2,-2
KR_7768152031,16869,16157,247,262,9,7,7,9,8,12,0,1,0,0,19,18,4,4,1,1,1,0,0,1,0,0,10,540218,712,-15,2,-2,-4,-1,0,1,0,0
KR_7768152892,16233,15529,288,244,7,6,6,7,5,7,0,0,0,0,19,16,3,5,0,0,1,0,0,0,0,0,10,540193,704,44,1,-1,-2,0,0,3,-2,0
KR_7768159709,14302,15382,268,257,3,5,5,3,2,10,1,0,0,0,29,19,6,2,0,1,0,1,1,0,0,0,10,540234,-1080,11,-2,2,-8,1,0,10,4,-1
KR_7768166441,16974,18122,210,220,10,11,11,10,15,18,0,0,0,0,16,20,4,3,1,0,0,1,0,0,0,0,10,540263,-1148,-10,-1,1,-3,0,0,-4,1,1
KR_7768180119,14259,14062,197,231,8,4,4,8,11,4,0,0,0,0,15,18,2,4,0,1,1,0,0,0,0,0,10,540244,197,-34,4,-4,7,0,0,-3,-2,-1
KR_7768185087,12921,17078,251,280,1,7,7,1,0,7,0,0,0,0,15,60,2,5,0,2,0,1,0,0,0,0,10,540086,-4157,-29,-6,6,-7,0,0,-45,-3,-2
KR_7768186382,14158,14009,260,293,3,1,1,3,4,2,0,0,0,0,19,12,1,5,0,0,1,0,0,0,0,0,10,540227,149,-33,2,-2,2,0,0,7,-4,0
KR_7768187416,13482,14549,232,250,3,5,6,4,2,2,1,0,0,0,48,17,4,3,0,0,1,0,1,0,0,0,10,540237,-1067,-18,-2,2,0,1,0,31,1,0
KR_7768189542,14541,15645,254,282,4,5,5,4,3,5,0,0,0,0,24,85,3,2,0,0,1,0,0,0,0,0,10,540250,-1104,-28,-1,1,-2,0,0,-61,1,0
KR_7768193810,15334,15621,231,262,7,4,4,7,5,6,0,0,0,0,31,105,2,5,0,2,0,1,0,0,0,0,10,540221,-287,-31,3,-3,-1,0,0,-74,-3,-2
KR_7768197679,14100,13807,304,296,1,1,1,1,2,0,0,1,0,0,11,13,2,6,0,0,0,1,0,1,0,0,10,540238,293,8,0,0,2,-1,0,-2,-4,0
KR_7768198639,17859,13852,237,217,11,5,5,11,13,4,0,0,0,0,14,12,0,1,2,1,0,1,0,0,0,0,10,540256,4007,20,6,-6,9,0,0,2,-1,1
KR_7768209686,14342,13964,245,229,4,4,4,4,7,5,0,0,0,0,145,14,2,2,0,0,1,0,0,0,0,0,10,540178,378,16,0,0,2,0,0,131,0,0
KR_7768210757,16156,15332,237,254,8,5,5,8,11,4,1,0,0,0,19,15,4,1,2,1,1,0,1,0,0,0,10,540210,824,-17,3,-3,7,1,0,4,3,1
KR_7768220644,16281,13563,277,236,7,3,3,7,12,3,0,0,0,0,16,14,4,3,1,0,0,1,0,0,0,0,10,540227,2718,41,4,-4,9,0,0,2,1,1
KR_7768225698,15924,16056,273,250,5,8,8,5,8,16,0,0,0,0,89,36,5,1,1,0,1,0,0,0,0,0,10,540275,-132,23,-3,3,-8,0,0,53,4,1
KR_7768228825,15138,15103,250,261,6,5,5,6,4,6,0,1,0,0,19,13,0,5,0,2,0,1,0,1,0,0,10,540267,35,-11,1,-1,-2,-1,0,6,-5,-2
KR_7768233805,14746,14147,241,237,6,3,3,6,1,4,0,0,0,0,12,13,0,1,0,1,0,1,0,0,0,0,10,540172,599,4,3,-3,-3,0,0,-1,-1,-1
KR_7768236050,14037,14430,264,289,2,2,2,2,2,2,0,0,0,0,11,27,0,2,1,0,0,1,0,0,0,0,10,540196,-393,-25,0,0,0,0,0,-16,-2,1
KR_7768249464,15743,13960,286,252,6,3,3,6,2,4,0,0,0,0,39,26,1,5,0,0,1,0,0,0,0,0,10,540270,1783,34,3,-3,-2,0,0,13,-4,0
KR_7768249669,15611,14304,279,263,6,3,3,6,8,3,0,0,0,0,35,17,3,1,0,2,0,1,0,0,0,0,10,540258,1307,16,3,-3,5,0,0,18,2,-2
KR_7768257173,18000,14858,282,248,11,4,4,11,13,6,0,0,0,0,17,126,4,3,0,0,1,0,0,0,0,0,10,540265,3142,34,7,-7,7,0,0,-109,1,0
KR_7768261032,15548,14685,283,273,5,4,4,5,5,4,0,1,0,0,113,41,4,2,0,0,0,1,0,1,0,0,10,540256,863,10,1,-1,1,-1,0,72,2,0
KR_7768261296,14634,13863,288,251,5,3,3,5,3,3,0,1,0,0,33,14,4,3,0,0,1,0,0,1,0,0,10,540227,771,37,2,-2,0,-1,0,19,1,0
KR_7768266298,16350,16392,231,227,10,11,11,10,8,13,0,0,0,0,16,22,0,2,3,1,0,1,0,0,0,0,10,540186,-42,4,-1,1,-5,0,0,-6,-2,2
KR_7768266809,14870,15880,241,253,5,8,8,5,7,5,0,0,0,0,34,32,1,2,1,1,0,1,0,0,0,0,10,540247,-1010,-12,-3,3,2,0,0,2,-1,0
KR_7768270766,18564,14239,216,217,19,4,4,19,15,4,0,0,0,0,18,13,3,2,1,3,1,0,0,0,0,0,10,540083,4325,-1,15,-15,11,0,0,5,1,-2
KR_7768278050,16205,15539,280,290,6,4,4,6,8,5,1,0,0,0,22,13,1,5,1,0,0,1,1,0,0,0,10,540224,666,-10,2,-2,3,1,0,9,-4,1
KR_7768282537,15568,14363,286,247,5,4,4,5,2,4,0,0,0,0,36,13,3,3,1,0,1,0,0,0,0,0,10,540265,1205,39,1,-1,-2,0,0,23,0,1
KR_7768283874,15889,14948,265,240,6,6,6,6,9,5,0,0,0,0,38,16,1,2,1,0,1,0,0,0,0,0,10,540244,941,25,0,0,4,0,0,22,-1,1
KR_7768289882,15612,14775,265,282,7,4,4,7,6,2,1,0,0,0,173,26,5,1,0,2,1,0,1,0,0,0,10,540220,837,-17,3,-3,4,1,0,147,4,-2
KR_7768297576,15212,15203,304,264,5,5,5,5,2,4,1,0,0,0,37,16,3,2,0,0,1,0,1,0,0,0,10,540228,9,40,0,0,-2,1,0,21,1,0
KR_7768297683,13835,15617,262,264,2,7,7,2,3,9,1,0,0,0,16,14,2,4,0,0,0,1,1,0,0,0,10,540272,-1782,-2,-5,5,-6,1,0,2,-2,0
KR_7768308920,14841,14037,254,223,5,6,6,5,2,4,0,0,0,0,12,14,1,0,1,1,1,0,0,0,0,0,10,540233,804,31,-1,1,-2,0,0,-2,1,0
KR_7768309295,17658,15998,270,246,10,8,8,10,13,8,0,0,0,0,17,16,2,2,0,0,1,0,0,0,0,0,10,540252,1660,24,2,-2,5,0,0,1,0,0
KR_7768312832,14335,15571,285,294,2,5,5,2,1,6,0,1,0,0,17,43,7,2,1,0,0,1,0,1,0,0,10,540189,-1236,-9,-3,3,-5,-1,0,-26,5,1
KR_7768320529,16791,13094,279,214,9,3,3,9,10,0,0,0,0,0,19,34,1,4,1,1,1,0,0,0,0,0,10,540278,3697,65,6,-6,10,0,0,-15,-3,0
KR_7768323294,14110,15821,271,256,2,7,7,2,2,8,0,1,0,0,12,18,4,2,0,2,1,0,0,1,0,0,10,540171,-1711,15,-5,5,-6,-1,0,-6,2,-2
KR_7768325797,16204,14915,263,254,8,5,5,8,11,2,0,0,0,0,50,102,5,5,0,0,1,0,0,0,0,0,10,540236,1289,9,3,-3,9,0,0,-52,0,0
KR_7768332734,14672,14788,218,234,7,6,6,8,2,3,0,0,0,0,14,15,3,1,0,1,1,0,0,0,0,0,10,540224,-116,-16,1,-2,-1,0,0,-1,2,-1
KR_7768344724,14772,16404,287,288,3,7,7,3,3,8,0,1,0,0,19,28,3,9,0,0,0,1,0,1,0,0,10,540225,-1632,-1,-4,4,-5,-1,0,-9,-6,0
KR_7768348871,14798,14663,230,251,6,4,4,6,9,4,0,0,0,0,33,103,4,1,0,1,1,0,0,0,0,0,10,540234,135,-21,2,-2,5,0,0,-70,3,-1
KR_7768352028,15937,14496,272,242,7,5,5,7,6,6,0,0,0,0,16,12,2,4,0,0,0,1,0,0,0,0,10,540122,1441,30,2,-2,0,0,0,4,-2,0
KR_7768354288,15183,14505,257,273,5,3,3,5,9,5,0,0,0,0,17,18,6,1,0,0,1,0,0,0,0,0,10,540261,678,-16,2,-2,4,0,0,-1,5,0
KR_7768358719,15678,15148,252,260,6,5,5,6,6,7,0,1,0,0,15,12,3,2,0,0,0,1,0,1,0,0,10,540289,530,-8,1,-1,-1,-1,0,3,1,0
KR_7768359452,15927,14717,261,275,6,4,4,6,8,5,0,1,0,0,14,10,1,3,0,2,0,1,0,1,0,0,10,540246,1210,-14,2,-2,3,-1,0,4,-2,-2
KR_7768383257,15833,15549,275,261,7,7,7,7,3,4,0,0,0,0,14,36,2,6,1,0,1,0,0,0,0,0,10,540231,284,14,0,0,-1,0,0,-22,-4,1
KR_7768389634,15458,14874,278,256,5,5,6,5,8,4,0,0,0,0,17,19,1,3,1,1,0,1,0,0,0,0,10,540237,584,22,0,1,4,0,0,-2,-2,0
KR_7768396475,15486,14741,246,235,6,7,7,6,6,3,0,0,0,0,15,16,5,2,0,0,0,1,0,0,0,0,10,540230,745,11,-1,1,3,0,0,-1,3,0
KR_7768399250,15654,15480,253,267,6,6,6,6,6,6,0,0,0,0,15,12,2,1,0,0,1,0,0,0,0,0,10,540201,174,-14,0,0,0,0,0,3,1,0
KR_7768400017,14720,17222,228,277,4,10,10,4,5,8,0,0,0,0,13,20,1,0,2,2,1,0,0,0,0,0,10,540222,-2502,-49,-6,6,-3,0,0,-7,1,0
KR_7768401533,15478,15560,266,254,6,7,7,6,2,6,0,0,0,0,14,15,4,2,2,1,0,1,0,0,0,0,10,540219,-82,12,-1,1,-4,0,0,-1,2,1
KR_7768402653,15984,15239,264,259,8,4,4,8,3,3,0,0,0,0,24,35,1,1,0,0,1,0,0,0,0,0,10,540254,745,5,4,-4,0,0,0,-11,0,0
KR_7768420362,15348,15400,270,235,5,7,7,5,7,14,0,0,0,0,17,16,6,4,1,0,0,1,0,0,0,0,10,540270,-52,35,-2,2,-7,0,0,1,2,1
KR_7768420397,17815,13385,239,236,12,2,2,12,14,1,0,1,0,0,117,25,3,3,1,1,1,0,0,1,0,0,10,540292,4430,3,10,-10,13,-1,0,92,0,0
KR_7768422988,17048,16459,259,257,9,9,9,9,9,6,0,0,0,0,15,15,1,4,1,0,1,0,0,0,0,0,10,540233,589,2,0,0,3,0,0,0,-3,1
KR_7768424209,13627,18217,222,279,3,13,13,3,3,13,1,0,0,0,31,13,1,4,0,1,1,0,1,0,0,0,10,540215,-4590,-57,-10,10,-10,1,0,18,-3,-1
KR_7768433713,17764,14511,269,252,9,5,5,9,11,4,0,1,0,0,17,12,2,5,1,0,1,0,0,1,0,0,10,540235,3253,17,4,-4,7,-1,0,5,-3,1
KR_7768441909,15161,13802,269,269,5,1,1,5,6,1,0,1,0,0,49,19,3,2,0,0,1,0,0,1,0,0,10,540199,1359,0,4,-4,5,-1,0,30,1,0
KR_7768446095,15558,16910,211,244,9,10,10,9,8,9,0,0,0,0,17,17,3,6,0,1,1,0,0,0,0,0,10,540228,-1352,-33,-1,1,-1,0,0,0,-3,-1
KR_7768452588,15591,13013,253,245,7,1,1,7,6,1,1,0,0,0,17,14,8,5,0,1,1,0,1,0,0,0,10,540214,2578,8,6,-6,5,1,0,3,3,-1
KR_7768453674,15754,15253,276,287,6,4,5,6,8,7,0,0,0,0,15,15,3,1,2,0,1,0,0,0,0,0,10,540298,501,-11,2,-1,1,0,0,0,2,2
KR_7768454828,16828,14348,250,218,9,6,6,9,11,5,0,1,0,0,15,18,5,2,1,1,1,0,0,1,0,0,10,540248,2480,32,3,-3,6,-1,0,-3,3,0
KR_7768460437,15755,15189,243,259,7,5,5,7,10,5,1,0,0,0,22,32,3,2,1,1,1,0,1,0,0,0,10,540257,566,-16,2,-2,5,1,0,-10,1,0
KR_7768478636,16523,14905,239,246,9,5,5,9,10,3,0,1,0,0,18,14,2,2,2,0,1,0,0,1,0,0,10,540255,1618,-7,4,-4,7,-1,0,4,0,2
KR_7768484237,15117,14493,258,267,5,3,3,6,7,7,0,0,0,0,23,111,2,1,0,1,1,0,0,0,0,0,10,540179,624,-9,2,-3,0,0,0,-88,1,-1
KR_7768495002,16755,15892,258,232,9,10,10,9,11,6,1,0,0,0,24,17,3,1,3,0,0,1,1,0,0,0,10,540248,863,26,-1,1,5,1,0,7,2,3
KR_7768502451,15149,15241,261,288,6,6,6,6,7,3,0,1,0,0,9,16,2,1,0,0,0,1,0,1,0,0,10,540267,-92,-27,0,0,4,-1,0,-7,1,0
KR_7768505494,14830,14089,298,279,4,2,2,4,2,2,1,0,0,0,20,11,4,2,0,0,1,0,1,0,0,0,10,540268,741,19,2,-2,0,1,0,9,2,0
KR_7768508574,15898,13887,286,246,6,3,3,6,12,5,1,0,0,0,13,13,3,3,1,0,1,0,1,0,0,0,10,540151,2011,40,3,-3,7,1,0,0,0,1
KR_7768525067,14766,13342,249,245,5,3,3,5,9,0,0,0,0,0,31,17,3,3,1,0,1,0,0,0,0,0,10,540250,1424,4,2,-2,9,0,0,14,0,1
KR_7768536582,15179,15852,281,245,4,8,8,4,3,11,0,0,0,0,15,35,1,5,1,0,1,0,0,0,0,0,10,540140,-673,36,-4,4,-8,0,0,-20,-4,1
KR_7768540654,14301,15293,277,281,2,4,4,2,1,3,0,1,0,0,12,32,2,4,1,1,0,1,0,1,0,0,10,540244,-992,-4,-2,2,-2,-1,0,-20,-2,0
KR_7768544465,16430,14596,230,214,10,6,6,11,10,4,0,1,0,0,46,13,0,1,1,1,1,0,0,1,0,0,10,540193,1834,16,4,-5,6,-1,0,33,-1,0
KR_7768549430,16183,15219,254,254,9,6,6,9,5,5,0,0,0,0,19,14,1,4,1,0,0,1,0,0,0,0,10,540185,964,0,3,-3,0,0,0,5,-3,1
KR_7768551849,15279,16082,258,300,5,5,5,5,9,4,1,0,0,0,30,13,3,4,1,3,0,1,1,0,0,0,10,540245,-803,-42,0,0,5,1,0,17,-1,-2
KR_7768578844,16888,14938,240,213,11,7,7,11,12,7,0,0,0,0,28,21,2,1,0,1,1,0,0,0,0,0,10,540223,1950,27,4,-4,5,0,0,7,1,-1
KR_7768583163,17192,14102,280,253,9,2,2,9,5,4,0,0,0,0,17,15,2,3,1,0,1,0,0,0,0,0,10,540088,3090,27,7,-7,1,0,0,2,-1,1
KR_7768586910,16888,16755,284,280,8,8,8,8,6,11,0,0,0,0,20,12,1,3,3,2,1,0,0,0,0,0,10,540239,133,4,0,0,-5,0,0,8,-2,1
KR_7768590151,18172,15914,276,206,11,9,9,11,22,16,1,0,0,0,14,17,2,3,2,0,0,1,1,0,0,0,10,540235,2258,70,2,-2,6,1,0,-3,-1,2
KR_7768590602,14599,15110,264,233,4,6,6,4,4,6,1,0,0,0,15,14,4,1,1,0,1,0,1,0,0,0,10,540212,-511,31,-2,2,-2,1,0,1,3,1
KR_7768605205,16199,15641,284,281,6,5,5,6,7,4,0,0,0,0,48,13,1,2,1,2,0,1,0,0,0,0,10,540160,558,3,1,-1,3,0,0,35,-1,-1
KR_7768614729,14935,16064,266,287,4,7,7,4,5,10,0,1,0,0,15,118,4,2,0,0,1,0,0,1,0,0,10,540238,-1129,-21,-3,3,-5,-1,0,-103,2,0
KR_7768616339,13712,16154,254,320,2,5,5,2,3,4,0,0,0,0,65,18,2,5,0,1,0,1,0,0,0,0,10,540298,-2442,-66,-3,3,-1,0,0,47,-3,-1
KR_7768616632,14528,17853,258,241,5,10,10,5,4,14,0,0,0,0,12,16,5,1,0,0,1,0,0,0,0,0,10,540196,-3325,17,-5,5,-10,0,0,-4,4,0
KR_7768622882,17530,12926,276,233,11,2,3,11,6,2,0,0,0,0,35,18,2,1,0,0,1,0,0,0,0,0,10,540231,4604,43,9,-8,4,0,0,17,1,0
KR_7768643946,17216,14408,256,263,11,3,3,11,9,3,1,0,0,0,16,13,2,0,2,0,1,0,1,0,0,0,10,540237,2808,-7,8,-8,6,1,0,3,2,2
KR_7768651026,16810,15415,242,201,11,8,8,11,15,5,0,0,0,0,16,48,2,4,0,0,1,0,0,0,0,0,10,540191,1395,41,3,-3,10,0,0,-32,-2,0
KR_7768653558,16868,16046,233,253,11,7,7,11,10,5,0,0,0,0,19,16,1,3,0,0,0,1,0,0,0,0,10,540221,822,-20,4,-4,5,0,0,3,-2,0
KR_7768658917,15972,15143,277,256,8,5,5,8,8,7,0,0,0,0,15,20,3,1,0,0,1,0,0,0,0,0,10,540085,829,21,3,-3,1,0,0,-5,2,0
KR_7768661773,14667,14518,268,286,3,2,2,3,4,3,0,0,0,0,17,19,6,3,0,1,0,1,0,0,0,0,10,540230,149,-18,1,-1,1,0,0,-2,3,-1
KR_7768679252,14441,15318,301,310,2,3,3,2,1,5,0,1,0,0,13,15,3,1,0,0,1,0,0,1,0,0,10,540225,-877,-9,-1,1,-4,-1,0,-2,2,0
KR_7768695362,14499,17471,232,276,5,8,8,5,3,9,0,1,0,0,23,16,5,7,0,2,0,1,0,1,0,0,10,540215,-2972,-44,-3,3,-6,-1,0,7,-2,-2
KR_7768700506,14439,15798,265,285,3,5,5,3,4,6,1,0,0,0,31,88,6,2,0,0,0,1,1,0,0,0,10,540254,-1359,-20,-2,2,-2,1,0,-57,4,0
KR_7768704401,15592,16341,254,255,7,8,8,7,9,5,0,0,0,0,15,20,4,2,1,1,1,0,0,0,0,0,10,540261,-749,-1,-1,1,4,0,0,-5,2,0
KR_7768709398,15603,16088,275,258,5,8,8,5,6,7,0,0,0,0,37,28,4,1,0,0,1,0,0,0,0,0,10,540198,-485,17,-3,3,-1,0,0,9,3,0
KR_7768713539,15731,16162,256,256,7,7,7,8,13,10,0,0,0,0,17,14,5,2,0,1,1,0,0,0,0,0,10,540261,-431,0,0,-1,3,0,0,3,3,-1
KR_7768733169,15036,15352,223,272,6,4,4,6,6,5,0,0,0,0,14,17,7,2,1,1,1,0,0,0,0,0,10,540274,-316,-49,2,-2,1,0,0,-3,5,0
KR_7768736074,17512,15181,239,232,10,6,6,10,13,9,0,0,0,0,12,13,5,1,3,0,0,1,0,0,0,0,10,540047,2331,7,4,-4,4,0,0,-1,4,3
KR_7768740109,15293,15169,252,255,5,5,5,6,5,4,0,0,0,0,14,39,6,3,0,1,0,1,0,0,0,0,10,540211,124,-3,0,-1,1,0,0,-25,3,-1
KR_7768758523,14910,13333,285,255,5,2,2,5,2,1,1,0,0,0,126,18,1,1,0,0,1,0,1,0,0,0,10,540202,1577,30,3,-3,1,1,0,108,0,0
KR_7768760931,15226,15338,266,303,5,4,4,5,10,4,0,0,0,0,25,15,1,5,0,1,0,1,0,0,0,0,10,540230,-112,-37,1,-1,6,0,0,10,-4,-1
KR_7768762490,18898,14880,296,298,12,3,3,12,23,3,0,0,0,0,19,105,0,2,0,0,1,0,0,0,0,0,10,540219,4018,-2,9,-9,20,0,0,-86,-2,0
KR_7768777124,14836,15381,284,290,3,5,5,3,5,4,0,0,0,0,36,17,2,2,0,0,0,1,0,0,0,0,10,540259,-545,-6,-2,2,1,0,0,19,0,0
KR_7768784439,16080,16407,250,257,8,7,7,8,9,9,1,0,0,0,14,14,5,2,2,1,0,1,1,0,0,0,10,540183,-327,-7,1,-1,0,1,0,0,3,1
KR_7768787504,16468,17913,291,272,6,11,11,6,9,15,0,1,0,0,111,15,7,2,0,0,1,0,0,1,0,0,10,540257,-1445,19,-5,5,-6,-1,0,96,5,0
KR_7768800540,14270,14133,209,228,5,5,5,5,5,5,0,0,0,0,24,18,1,3,0,2,1,0,0,0,0,0,10,540192,137,-19,0,0,0,0,0,6,-2,-2
KR_7768803065,19061,14583,281,237,14,5,5,14,15,4,0,0,0,0,15,10,1,3,0,0,1,0,0,0,0,0,10,540201,4478,44,9,-9,11,0,0,5,-2,0
KR_7768806011,15085,15651,236,265,7,6,6,7,8,10,0,1,0,0,13,39,3,5,0,1,1,0,0,1,0,0,10,540261,-566,-29,1,-1,-2,-1,0,-26,-2,-1
KR_7768810343,15030,17132,251,262,4,9,9,4,6,16,0,1,0,0,10,19,5,1,0,1,1,0,0,1,0,0,10,540256,-2102,-11,-5,5,-10,-1,0,-9,4,-1
KR_7768811169,14185,14203,232,251,5,4,4,5,2,3,0,1,0,0,55,16,2,4,0,1,1,0,0,1,0,0,10,540241,-18,-19,1,-1,-1,-1,0,39,-2,-1
KR_7768816504,15389,14903,258,221,7,6,6,7,3,7,0,0,0,0,14,25,2,4,3,2,0,1,0,0,0,0,10,540234,486,37,1,-1,-4,0,0,-11,-2,1
KR_7768818628,14950,15458,247,195,6,9,9,6,6,10,0,0,0,0,14,28,3,1,1,0,1,0,0,0,0,0,10,540238,-508,52,-3,3,-4,0,0,-14,2,1
KR_7768821545,16603,14096,276,261,7,3,3,7,7,6,0,1,0,0,15,108,1,2,3,0,1,0,0,1,0,0,10,540222,2507,15,4,-4,1,-1,0,-93,-1,3
KR_7768835807,15636,15023,271,235,6,6,6,6,5,9,0,0,0,0,16,16,2,2,2,0,1,0,0,0,0,0,10,540251,613,36,0,0,-4,0,0,0,0,2
KR_7768857580,15246,13335,268,265,6,2,2,6,9,2,0,1,0,0,22,14,1,2,0,0,0,1,0,1,0,0,10,540269,1911,3,4,-4,7,-1,0,8,-1,0
KR_7768865893,15269,14103,277,228,4,4,4,4,6,7,1,0,0,0,16,15,3,3,3,0,0,1,1,0,0,0,10,540241,1166,49,0,0,-1,1,0,1,0,3
KR_7768869626,16361,15154,246,235,8,5,5,9,12,10,0,0,0,0,28,18,5,6,0,1,0,1,0,0,0,0,10,540230,1207,11,3,-4,2,0,0,10,-1,-1
KR_7768870936,14172,17189,241,288,3,9,9,3,1,10,0,0,0,0,53,18,5,4,2,0,1,0,0,0,0,0,10,540222,-3017,-47,-6,6,-9,0,0,35,1,2
KR_7768872988,14000,14537,224,231,5,6,6,5,4,4,0,0,0,0,17,22,4,3,0,0,1,0,0,0,0,0,10,540256,-537,-7,-1,1,0,0,0,-5,1,0
KR_7768878662,15066,13678,292,251,4,2,2,4,1,1,0,0,0,0,15,37,3,2,0,0,1,0,0,0,0,0,10,540228,1388,41,2,-2,0,0,0,-22,1,0
KR_7768879558,15787,15588,263,239,6,8,8,6,3,12,0,1,0,0,19,29,3,3,0,2,0,1,0,1,0,0,10,540219,199,24,-2,2,-9,-1,0,-10,0,-2
KR_7768882462,14861,15674,239,266,5,6,6,5,5,5,0,0,0,0,14,15,2,2,1,1,1,0,0,0,0,0,10,540204,-813,-27,-1,1,0,0,0,-1,0,0
KR_7768882654,15706,18065,269,298,6,12,12,6,9,12,0,1,0,0,14,21,3,3,0,3,0,1,0,1,0,0,10,540219,-2359,-29,-6,6,-3,-1,0,-7,0,-3
KR_7768898920,13696,15664,225,264,4,6,6,4,5,4,0,0,0,0,15,29,3,3,0,1,0,1,0,0,0,0,10,540217,-1968,-39,-2,2,1,0,0,-14,0,-1
KR_7768904105,14290,17114,248,263,3,11,11,3,5,13,0,0,0,0,32,13,5,3,0,0,1,0,0,0,0,0,10,540261,-2824,-15,-8,8,-8,0,0,19,2,0
KR_7768922515,14704,17799,222,255,6,8,8,6,9,11,0,0,0,0,14,27,1,3,0,1,1,0,0,0,0,0,10,540242,-3095,-33,-2,2,-2,0,0,-13,-2,-1
KR_7768922673,15338,14330,274,252,5,3,3,5,3,3,0,0,0,0,14,20,2,0,2,0,1,0,0,0,0,0,10,540305,1008,22,2,-2,0,0,0,-6,2,2
KR_7768940906,17264,14841,269,233,9,6,6,9,6,4,0,0,0,0,10,15,2,0,3,0,0,1,0,0,0,0,10,540238,2423,36,3,-3,2,0,0,-5,2,3
KR_7768949862,15816,15021,259,243,6,6,6,6,6,9,0,0,0,0,146,17,3,1,0,0,1,0,0,0,0,0,10,540237,795,16,0,0,-3,0,0,129,2,0
KR_7768952423,15286,14889,235,220,7,6,7,7,7,12,0,0,0,0,18,15,2,2,0,0,1,0,0,0,0,0,10,540267,397,15,1,0,-5,0,0,3,0,0
KR_7768954236,13941,16011,251,264,3,6,6,3,4,11,0,1,0,0,12,15,7,4,0,2,0,1,0,1,0,0,10,540189,-2070,-13,-3,3,-7,-1,0,-3,3,-2
KR_7768958507,16975,16616,222,235,11,9,9,11,11,12,0,0,0,0,15,16,3,2,2,2,1,0,0,0,0,0,10,540238,359,-13,2,-2,-1,0,0,-1,1,0
KR_7768962624,15321,14999,238,249,7,7,7,7,7,3,0,0,0,0,15,14,4,3,1,0,1,0,0,0,0,0,10,540231,322,-11,0,0,4,0,0,1,1,1
KR_7768982337,14985,17034,263,259,5,10,10,5,9,12,1,0,0,0,12,12,4,1,0,2,1,0,1,0,0,0,10,540273,-2049,4,-5,5,-3,1,0,0,3,-2
KR_7768989613,16351,16864,248,226,8,9,9,8,9,15,0,0,0,0,18,39,1,1,2,1,1,0,0,0,0,0,10,540272,-513,22,-1,1,-6,0,0,-21,0,1
KR_7768997386,15342,15496,268,276,5,5,5,5,5,6,0,0,0,0,17,13,1,4,0,1,0,1,0,0,0,0,10,540219,-154,-8,0,0,-1,0,0,4,-3,-1
KR_7769008560,15204,16432,264,275,5,6,6,5,8,10,0,0,0,0,14,16,6,0,1,1,1,0,0,0,0,0,10,540260,-1228,-11,-1,1,-2,0,0,-2,6,0
KR_7769028152,14317,14175,275,271,3,3,3,3,3,3,0,1,0,0,14,16,2,0,0,0,1,0,0,1,0,0,10,540272,142,4,0,0,0,-1,0,-2,2,0
KR_7769029790,14610,14972,254,261,5,5,5,5,2,3,0,0,0,0,15,14,0,1,1,1,1,0,0,0,0,0,10,540284,-362,-7,0,0,-1,0,0,1,-1,0
KR_7769031901,14765,12980,238,261,5,1,1,5,7,2,0,1,0,0,20,14,2,4,1,0,1,0,0,1,0,0,10,540279,1785,-23,4,-4,5,-1,0,6,-2,1
KR_7769064154,14970,12606,255,194,5,3,3,5,3,2,0,0,0,0,27,15,5,3,2,0,0,1,0,0,0,0,10,540099,2364,61,2,-2,1,0,0,12,2,2
KR_7769065145,13852,17366,221,245,3,13,13,3,6,15,0,1,0,0,16,20,4,3,0,0,0,1,0,1,0,0,10,540240,-3514,-24,-10,10,-9,-1,0,-4,1,0
KR_7769076331,15387,14282,278,284,4,2,2,4,4,4,0,0,0,0,13,16,2,4,1,1,0,1,0,0,0,0,10,540210,1105,-6,2,-2,0,0,0,-3,-2,0
KR_7769077582,17902,14601,278,277,11,3,3,11,16,6,0,0,0,0,35,15,5,1,0,0,0,1,0,0,0,0,10,540200,3301,1,8,-8,10,0,0,20,4,0
KR_7769080083,14867,18078,236,269,4,12,12,4,4,11,0,0,0,0,14,16,1,2,0,1,0,1,0,0,0,0,10,540188,-3211,-33,-8,8,-7,0,0,-2,-1,-1
KR_7769083022,14312,16417,262,252,4,9,9,4,3,12,0,0,0,0,16,21,2,1,0,0,0,1,0,0,0,0,10,540231,-2105,10,-5,5,-9,0,0,-5,1,0
KR_7769083341,15187,15410,230,253,6,5,5,6,9,9,0,0,0,0,43,106,3,3,0,0,0,1,0,0,0,0,10,540234,-223,-23,1,-1,0,0,0,-63,0,0
KR_7769088196,17184,15193,285,260,9,4,4,9,7,4,0,0,0,0,15,14,7,4,2,1,1,0,0,0,0,0,10,540238,1991,25,5,-5,3,0,0,1,3,1
KR_7769090899,16489,17276,229,258,9,11,11,9,16,13,0,0,0,0,19,15,2,3,0,1,0,1,0,0,0,0,10,540210,-787,-29,-2,2,3,0,0,4,-1,-1
KR_7769094439,16422,15071,291,292,7,4,4,7,6,3,0,0,0,0,14,15,1,3,0,1,0,1,0,0,0,0,10,540114,1351,-1,3,-3,3,0,0,-1,-2,-1
KR_7769101882,16836,15047,257,289,9,4,4,9,11,2,0,0,0,0,14,17,4,4,1,1,0,1,0,0,0,0,10,540271,1789,-32,5,-5,9,0,0,-3,0,0
KR_7769106842,14426,15257,273,291,3,4,4,3,4,4,1,0,0,0,33,25,7,2,0,0,0,1,1,0,0,0,10,540242,-831,-18,-1,1,0,1,0,8,5,0
KR_7769117033,12744,14514,238,241,2,5,5,2,0,6,0,0,0,0,10,17,6,1,0,0,0,1,0,0,0,0,10,540197,-1770,-3,-3,3,-6,0,0,-7,5,0
KR_7769118417,16847,17052,236,216,10,13,13,10,11,21,0,0,0,0,16,23,2,2,0,0,0,1,0,0,0,0,10,540236,-205,20,-3,3,-10,0,0,-7,0,0
KR_7769121661,14622,17066,258,283,4,8,8,4,6,7,0,0,0,0,18,16,4,1,0,0,1,0,0,0,0,0,10,540239,-2444,-25,-4,4,-1,0,0,2,3,0
KR_7769137601,15402,16820,270,259,5,10,10,5,4,8,0,1,0,0,106,15,3,2,0,0,0,1,0,1,0,0,10,540263,-1418,11,-5,5,-4,-1,0,91,1,0
KR_7769144012,15702,13424,260,260,5,1,1,5,7,2,1,0,0,0,19,12,2,2,2,0,1,0,1,0,1,0,10,540235,2278,0,4,-4,5,1,0,7,0,2
KR_7769148296,16433,15517,287,288,8,4,4,8,11,4,0,0,0,0,16,103,2,4,1,0,1,0,0,0,0,0,10,540219,916,-1,4,-4,7,0,0,-87,-2,1
KR_7769159285,14658,13562,297,256,3,2,2,3,3,3,0,0,0,0,15,17,2,2,0,0,1,0,0,0,0,0,10,540185,1096,41,1,-1,0,0,0,-2,0,0
KR_7769163161,16127,18057,213,228,9,15,15,9,9,20,0,0,0,0,20,17,0,4,1,0,1,0,0,0,0,0,10,540262,-1930,-15,-6,6,-11,0,0,3,-4,1
KR_7769167251,15210,14538,289,266,4,3,3,4,7,6,0,0,0,0,17,35,4,2,0,1,0,1,0,0,0,0,10,540284,672,23,1,-1,1,0,0,-18,2,-1
KR_7769172092,17113,13019,280,228,9,3,3,9,16,4,1,0,0,0,14,15,5,1,0,0,1,0,1,0,0,0,10,540282,4094,52,6,-6,12,1,0,-1,4,0
KR_7769173718,15807,14813,275,266,5,3,3,5,7,3,0,0,0,0,35,17,6,4,1,1,1,0,0,0,0,0,10,540184,994,9,2,-2,4,0,0,18,2,0
KR_7769183659,15606,15339,265,255,6,6,6,6,7,5,0,1,0,0,12,15,1,2,0,0,0,1,0,1,0,0,10,540237,267,10,0,0,2,-1,0,-3,-1,0
KR_7769186127,16537,14622,253,247,9,3,3,9,9,3,0,0,0,0,14,14,3,4,0,0,1,0,0,0,0,0,10,540230,1915,6,6,-6,6,0,0,0,-1,0
KR_7769189572,14925,13898,291,289,3,1,1,3,4,0,0,0,0,0,31,17,7,1,0,0,1,0,0,0,0,0,10,540235,1027,2,2,-2,4,0,0,14,6,0
KR_7769199295,15066,16400,246,262,5,9,9,5,4,7,1,0,0,0,49,16,5,2,1,1,0,1,1,0,0,0,10,540252,-1334,-16,-4,4,-3,1,0,33,3,0
KR_7769203727,16707,15494,233,244,10,7,7,10,6,5,0,1,0,0,37,13,4,6,2,2,1,0,0,1,0,0,10,540240,1213,-11,3,-3,1,-1,0,24,-2,0
KR_7769216292,15136,15282,236,243,5,5,5,5,13,6,1,0,0,0,14,16,2,3,2,0,0,1,1,0,0,0,10,540221,-146,-7,0,0,7,1,0,-2,-1,2
KR_7769217480,17553,13856,292,271,9,1,2,9,9,1,0,0,0,0,18,18,2,5,4,0,1,0,0,0,0,0,10,540124,3697,21,8,-7,8,0,0,0,-3,4
KR_7769225732,14437,14506,268,271,3,3,3,3,2,5,1,0,0,0,16,38,4,4,2,0,1,0,1,0,0,0,10,540208,-69,-3,0,0,-3,1,0,-22,0,2
KR_7769229289,16293,14902,268,281,8,3,3,8,5,3,0,0,0,0,13,16,6,4,1,0,1,0,0,0,0,0,10,540221,1391,-13,5,-5,2,0,0,-3,2,1
KR_7769232400,15707,16307,237,279,6,8,9,6,8,10,0,1,0,0,14,115,3,4,0,1,0,1,0,1,0,0,10,540127,-600,-42,-2,3,-2,-1,0,-101,-1,-1
KR_7769235947,15763,15131,292,307,5,3,3,5,6,2,0,0,0,0,16,16,2,2,0,0,1,0,0,0,0,0,10,540262,632,-15,2,-2,4,0,0,0,0,0
KR_7769236523,16862,17202,227,255,9,9,9,9,11,11,0,0,0,0,17,20,5,3,1,0,1,0,0,0,0,0,10,540218,-340,-28,0,0,0,0,0,-3,2,1
KR_7769241648,16453,14208,276,278,8,3,3,9,10,1,1,0,0,0,24,17,3,2,0,0,0,1,1,0,0,0,10,540234,2245,-2,5,-6,9,1,0,7,1,0
KR_7769244571,16995,15362,241,256,11,7,7,11,10,7,0,0,0,0,13,14,2,1,1,0,0,1,0,0,0,0,10,540222,1633,-15,4,-4,3,0,0,-1,1,1
KR_7769246083,15672,15526,303,250,5,5,5,5,10,9,0,1,0,0,17,20,3,5,0,0,1,0,0,1,0,0,10,540181,146,53,0,0,1,-1,0,-3,-2,0
KR_7769257848,12953,17780,244,267,1,13,13,1,0,17,0,1,0,0,14,16,1,0,0,0,0,1,0,1,0,0,10,540275,-4827,-23,-12,12,-17,-1,0,-2,1,0
KR_7769260749,15893,17031,276,272,7,9,9,7,11,11,0,0,0,0,36,28,7,3,0,1,1,0,0,0,0,0,10,540184,-1138,4,-2,2,0,0,0,8,4,-1
KR_7769261333,14852,16024,289,263,3,5,5,3,2,5,0,0,0,0,15,17,1,3,0,0,0,1,0,0,0,0,10,540235,-1172,26,-2,2,-3,0,0,-2,-2,0
KR_7769267337,14331,14620,267,256,3,5,5,3,1,6,0,0,0,0,13,19,5,0,2,0,1,0,0,0,0,0,10,540259,-289,11,-2,2,-5,0,0,-6,5,2
KR_7769271506,15405,16215,267,270,5,7,8,5,5,6,0,1,0,0,16,19,4,4,2,1,1,0,0,1,0,0,10,540233,-810,-3,-2,3,-1,-1,0,-3,0,1
KR_7769274723,15360,15957,270,270,4,6,6,4,5,9,0,0,0,0,17,17,3,5,0,1,0,1,0,0,0,0,10,540273,-597,0,-2,2,-4,0,0,0,-2,-1
KR_7769279423,14341,16181,247,271,4,6,6,4,10,10,1,0,0,0,16,21,1,4,0,2,0,1,1,0,0,0,10,540227,-1840,-24,-2,2,0,1,0,-5,-3,-2
KR_7769281410,16419,15746,267,243,7,7,7,7,9,6,0,0,0,0,19,21,4,2,1,2,1,0,0,0,0,0,10,540188,673,24,0,0,3,0,0,-2,2,-1
KR_7769282102,13535,14144,246,278,2,3,3,2,2,2,0,1,0,0,16,18,3,2,0,1,1,0,0,1,0,0,10,540218,-609,-32,-1,1,0,-1,0,-2,1,-1
KR_7769286256,14888,15746,256,255,4,8,8,4,5,10,0,0,0,0,17,20,2,3,0,0,0,1,0,0,0,0,10,540197,-858,1,-4,4,-5,0,0,-3,-1,0
KR_7769287286,15861,15133,306,273,6,4,4,6,2,6,0,0,0,0,19,15,2,4,1,1,1,0,0,0,0,0,10,540242,728,33,2,-2,-4,0,0,4,-2,0
KR_7769291182,12730,16071,221,277,2,6,6,2,3,9,0,1,0,0,14,17,4,3,0,0,1,0,0,1,0,0,10,540223,-3341,-56,-4,4,-6,-1,0,-3,1,0
KR_7769291712,16769,13421,247,232,11,2,2,11,6,0,0,0,0,0,17,41,2,3,0,0,1,0,0,0,0,0,10,540272,3348,15,9,-9,6,0,0,-24,-1,0
KR_7769292420,15126,15194,300,289,4,3,3,4,2,3,0,0,0,0,36,15,3,6,0,2,1,0,0,0,0,0,10,540221,-68,11,1,-1,-1,0,0,21,-3,-2
KR_7769292701,14209,15676,262,284,3,5,5,3,2,6,0,1,0,0,21,19,2,5,0,0,0,1,0,1,0,0,10,540164,-1467,-22,-2,2,-4,-1,0,2,-3,0
KR_7769295629,14895,16745,242,256,5,9,9,5,4,12,0,1,0,0,16,19,3,4,0,0,1,0,0,1,0,0,10,540255,-1850,-14,-4,4,-8,-1,0,-3,-1,0
KR_7769303492,15702,15759,243,238,8,7,7,8,10,12,1,0,0,0,36,18,2,3,0,0,0,1,1,0,0,0,10,540233,-57,5,1,-1,-2,1,0,18,-1,0
KR_7769308215,16162,15867,264,274,6,6,6,6,10,5,0,0,0,0,12,48,4,4,1,0,0,1,0,0,0,0,10,540220,295,-10,0,0,5,0,0,-36,0,1
KR_7769308506,13853,14264,269,293,2,2,2,3,3,1,0,1,0,0,20,20,1,2,0,1,0,1,0,1,0,0,10,540255,-411,-24,0,-1,2,-1,0,0,-1,-1
KR_7769309611,15379,15275,277,264,6,5,5,6,4,5,0,0,0,0,17,12,0,6,0,0,1,0,0,0,0,0,10,540105,104,13,1,-1,-1,0,0,5,-6,0
KR_7769314210,13978,14351,261,271,3,4,4,3,2,1,0,0,0,0,14,44,3,1,0,0,1,0,0,0,0,0,10,540225,-373,-10,-1,1,1,0,0,-30,2,0
KR_7769316776,17093,14044,292,246,9,3,3,9,9,4,0,0,0,0,18,104,1,3,1,0,1,0,0,0,0,0,10,540218,3049,46,6,-6,5,0,0,-86,-2,1
KR_7769319444,15820,15478,298,231,5,7,7,5,6,9,0,1,0,0,19,15,3,3,2,0,1,0,0,1,0,0,10,540225,342,67,-2,2,-3,-1,0,4,0,2
KR_7769324212,13995,15468,281,246,2,7,7,2,1,6,0,1,0,0,15,16,2,2,0,2,0,1,0,1,0,0,10,540225,-1473,35,-5,5,-5,-1,0,-1,0,-2
KR_7769325804,15240,15468,275,274,4,5,5,4,6,4,0,1,0,0,20,15,2,3,1,2,1,0,0,1,0,0,10,540188,-228,1,-1,1,2,-1,0,5,-1,-1
KR_7769329834,16220,14990,257,240,8,5,5,8,5,7,0,0,0,0,102,41,4,0,2,0,1,0,0,0,0,0,10,540267,1230,17,3,-3,-2,0,0,61,4,2
KR_7769332077,16676,16305,252,222,8,9,9,9,6,10,0,0,0,0,15,38,2,2,1,0,1,0,0,0,0,0,10,540250,371,30,-1,0,-4,0,0,-23,0,1
KR_7769334483,14881,15155,259,266,4,4,4,5,5,5,0,0,0,0,29,111,2,5,3,2,0,1,0,0,0,0,10,540134,-274,-7,0,-1,0,0,0,-82,-3,1
KR_7769340358,14965,14732,261,255,5,5,5,5,6,4,0,0,0,0,16,16,2,1,0,1,1,0,0,0,0,0,10,540169,233,6,0,0,2,0,0,0,1,-1
KR_7769344127,16289,13451,280,264,7,2,2,7,7,1,0,1,0,0,29,36,6,7,1,1,0,1,0,1,0,0,10,540212,2838,16,5,-5,6,-1,0,-7,-1,0
KR_7769344161,15223,15765,256,281,6,5,5,6,6,9,0,0,0,0,15,23,2,0,0,2,0,1,0,0,0,0,10,540178,-542,-25,1,-1,-3,0,0,-8,2,-2
KR_7769344712,15511,15118,254,281,6,4,4,7,4,4,0,0,0,0,14,34,0,5,0,1,1,0,0,0,0,0,10,540178,393,-27,2,-3,0,0,0,-20,-5,-1
KR_7769351998,13491,18405,230,267,3,12,12,3,1,24,0,0,0,0,37,20,3,2,0,1,1,0,0,0,0,0,10,540250,-4914,-37,-9,9,-23,0,0,17,1,-1
KR_7769352185,14351,14640,243,239,5,5,6,5,2,7,0,1,0,0,15,22,1,4,0,0,0,1,0,1,0,0,10,540236,-289,4,0,1,-5,-1,0,-7,-3,0
KR_7769353646,15543,15359,263,278,6,5,5,6,7,1,0,0,0,0,17,18,4,5,0,2,1,0,0,0,0,0,10,540268,184,-15,1,-1,6,0,0,-1,-1,-2
KR_7769355024,14106,15154,211,208,5,8,8,5,4,7,0,0,0,0,16,14,4,4,0,0,0,1,0,0,0,0,10,540198,-1048,3,-3,3,-3,0,0,2,0,0
KR_7769358849,15535,15388,273,277,5,4,4,5,7,5,1,0,0,0,14,36,2,3,1,1,1,0,1,0,0,0,10,540216,147,-4,1,-1,2,1,0,-22,-1,0
KR_7769361084,15102,16084,256,267,5,6,6,5,7,14,0,0,0,0,107,16,2,2,1,1,1,0,0,0,0,0,10,540200,-982,-11,-1,1,-7,0,0,91,0,0
KR_7769362073,13325,14939,251,239,2,6,6,2,2,8,1,0,0,0,13,25,3,0,0,0,0,1,1,0,0,0,10,540232,-1614,12,-4,4,-6,1,0,-12,3,0
KR_7769370105,13679,17533,248,239,3,13,13,3,2,11,0,0,0,0,11,16,1,4,0,2,1,0,0,0,0,0,10,540198,-3854,9,-10,10,-9,0,0,-5,-3,-2
KR_7769370909,14685,15372,265,244,4,8,8,5,3,9,0,1,0,0,22,13,1,8,0,0,0,1,0,1,0,0,10,540267,-687,21,-4,3,-6,-1,0,9,-7,0
KR_7769371858,13641,15887,252,270,3,6,6,3,2,6,0,0,0,0,16,15,1,1,0,0,1,0,0,0,0,0,10,540238,-2246,-18,-3,3,-4,0,0,1,0,0
KR_7769374521,13880,15681,267,283,3,6,6,3,0,5,0,1,0,0,18,33,2,3,0,1,0,1,0,1,0,0,10,540211,-1801,-16,-3,3,-5,-1,0,-15,-1,-1
KR_7769377224,12863,16546,230,268,2,8,8,2,1,8,0,1,0,0,34,12,3,5,0,1,0,1,0,1,0,0,10,540221,-3683,-38,-6,6,-7,-1,0,22,-2,-1
KR_7769377702,15968,16067,264,255,7,8,8,7,6,5,0,0,0,0,16,107,2,5,0,1,1,0,0,0,0,0,10,540273,-99,9,-1,1,1,0,0,-91,-3,-1
KR_7769378844,15499,15484,271,271,4,6,6,4,4,5,0,0,0,0,19,17,1,2,1,0,0,1,0,0,0,0,10,540230,15,0,-2,2,-1,0,0,2,-1,1
KR_7769388281,16148,15454,255,286,8,4,4,8,7,4,0,0,0,0,16,19,4,0,0,0,1,0,0,0,0,0,10,540217,694,-31,4,-4,3,0,0,-3,4,0
KR_7769388835,13690,15761,278,281,2,5,5,2,3,6,0,1,0,0,23,34,3,7,0,0,1,0,0,1,0,0,10,540246,-2071,-3,-3,3,-3,-1,0,-11,-4,0
KR_7769391310,15209,15708,265,259,5,7,7,5,4,7,0,0,0,0,15,13,2,2,1,0,0,1,0,0,0,0,10,540253,-499,6,-2,2,-3,0,0,2,0,1
KR_7769391703,16292,14734,256,229,8,6,6,8,10,6,0,0,0,0,17,17,0,3,0,0,1,0,0,0,0,0,10,540185,1558,27,2,-2,4,0,0,0,-3,0
KR_7769392347,12359,14257,250,275,0,3,3,0,0,2,0,0,0,0,13,13,1,1,0,0,0,1,0,0,0,0,10,540197,-1898,-25,-3,3,-2,0,0,0,0,0
KR_7769397139,14875,15209,247,242,4,7,7,4,9,7,0,1,0,0,13,15,3,2,1,2,0,1,0,1,0,0,10,540240,-334,5,-3,3,2,-1,0,-2,1,-1
KR_7769397510,15193,15031,279,254,5,5,5,5,5,5,0,0,0,0,17,19,5,5,0,0,1,0,0,0,0,0,10,540261,162,25,0,0,0,0,0,-2,0,0
KR_7769399988,15958,14025,270,268,8,3,3,8,8,1,1,0,0,0,16,16,2,2,0,0,1,0,1,0,0,0,10,540257,1933,2,5,-5,7,1,0,0,0,0
KR_7769401041,16848,13644,280,246,9,2,2,9,8,3,0,0,0,0,17,32,2,4,1,0,0,1,0,0,0,0,10,540224,3204,34,7,-7,5,0,0,-15,-2,1
KR_7769404079,12609,14455,252,287,0,2,2,0,0,4,0,0,0,0,34,15,1,2,0,1,0,1,0,0,0,0,10,540245,-1846,-35,-2,2,-4,0,0,19,-1,-1
KR_7769409444,15339,16946,223,226,6,11,11,6,7,12,0,0,0,0,15,18,2,3,0,0,1,0,0,0,0,0,10,540197,-1607,-3,-5,5,-5,0,0,-3,-1,0
KR_7769410935,14435,15201,268,283,3,5,5,3,4,5,0,0,0,0,14,27,1,2,0,0,1,0,0,0,0,0,10,540234,-766,-15,-2,2,-1,0,0,-13,-1,0
KR_7769411850,16854,14094,298,245,8,3,3,8,5,2,0,0,0,0,39,16,2,5,0,0,0,1,0,0,0,0,10,540259,2760,53,5,-5,3,0,0,23,-3,0
KR_7769415266,13643,14815,234,242,4,6,6,4,1,6,0,1,0,0,14,20,1,1,0,1,1,0,0,1,0,0,10,540222,-1172,-8,-2,2,-5,-1,0,-6,0,-1
KR_7769418650,16804,15952,263,233,9,9,9,9,9,6,0,0,0,0,102,14,3,2,1,0,1,0,0,0,0,0,10,540213,852,30,0,0,3,0,0,88,1,1
KR_7769426414,11095,14488,188,215,2,9,9,2,2,10,1,0,0,0,11,14,3,2,0,2,0,1,1,0,0,0,9,443303,-3393,-27,-7,7,-8,1,0,-3,1,-2
KR_7769429143,16184,15236,257,259,8,5,5,8,8,6,1,0,0,0,33,17,1,1,1,0,1,0,1,0,0,0,10,540159,948,-2,3,-3,2,1,0,16,0,1
KR_7769429470,18456,14974,258,248,12,5,5,12,16,4,0,0,0,0,16,17,4,1,0,0,1,0,0,0,0,0,10,540192,3482,10,7,-7,12,0,0,-1,3,0
KR_7769437156,13855,13883,226,218,5,6,6,6,5,5,0,0,0,0,14,13,2,2,0,0,0,1,0,0,0,0,10,488986,-28,8,-1,0,0,0,0,1,0,0
KR_7769445482,13726,14808,266,273,2,6,6,2,2,3,0,1,0,0,15,19,2,2,0,0,0,1,0,1,0,0,10,540218,-1082,-7,-4,4,-1,-1,0,-4,0,0
KR_7769454633,14286,16608,272,266,2,10,10,2,1,8,0,1,0,0,128,16,3,2,0,0,0,1,0,1,0,0,10,540230,-2322,6,-8,8,-7,-1,0,112,1,0
KR_7769460243,15127,15958,262,266,6,6,6,6,6,9,1,0,0,0,14,31,6,2,0,0,1,0,1,0,0,0,10,540228,-831,-4,0,0,-3,1,0,-17,4,0
KR_7769471812,14549,15919,275,257,3,7,7,3,3,7,0,1,0,0,15,15,2,1,0,2,1,0,0,1,0,0,10,540224,-1370,18,-4,4,-4,-1,0,0,1,-2
KR_7769490283,16703,14406,291,281,8,3,3,8,8,2,0,0,0,0,12,13,2,4,1,3,0,1,0,0,0,0,10,540264,2297,10,5,-5,6,0,0,-1,-2,-2
KR_7769530787,16169,14958,235,266,9,5,5,9,12,4,1,0,0,0,14,29,2,4,0,0,1,0,1,0,0,0,10,540238,1211,-31,4,-4,8,1,0,-15,-2,0
KR_7769556552,15768,14970,233,236,7,5,5,7,8,5,0,1,0,0,39,15,4,4,0,1,0,1,0,1,0,0,10,540104,798,-3,2,-2,3,-1,0,24,0,-1
KR_7769566789,18462,18701,228,249,13,12,12,13,16,14,0,0,0,0,18,14,0,1,0,0,1,0,0,0,0,0,10,540272,-239,-21,1,-1,2,0,0,4,-1,0
KR_7769567149,16028,15992,240,267,8,7,7,8,11,4,0,1,0,0,15,218,2,1,2,0,0,1,0,1,0,0,10,540201,36,-27,1,-1,7,-1,0,-203,1,2
KR_7769584015,14953,14318,238,253,5,4,4,5,6,3,0,0,0,0,17,17,4,0,0,1,1,0,0,0,0,0,10,540237,635,-15,1,-1,3,0,0,0,4,-1
KR_7769592124,14960,19925,245,248,6,14,14,6,7,23,0,1,0,0,17,14,0,3,1,3,1,0,0,1,0,0,10,540236,-4965,-3,-8,8,-16,-1,0,3,-3,-2
KR_7769612168,13497,14628,223,242,4,4,4,4,4,4,0,0,0,0,12,14,3,1,0,2,1,0,0,0,0,0,10,540257,-1131,-19,0,0,0,0,0,-2,2,-2
KR_7769612293,14426,15643,273,298,3,5,5,3,3,6,0,0,0,0,10,18,2,2,1,0,1,0,0,0,0,0,10,540222,-1217,-25,-2,2,-3,0,0,-8,0,1
KR_7769620221,16923,14705,272,255,9,4,4,9,23,8,1,0,0,0,17,17,4,2,1,1,0,1,1,0,0,0,10,540257,2218,17,5,-5,15,1,0,0,2,0
KR_7769628944,15754,15809,295,266,4,6,6,4,8,6,0,0,0,0,17,18,0,1,2,1,1,0,0,0,0,0,10,540114,-55,29,-2,2,2,0,0,-1,-1,1
KR_7769651030,17538,14411,281,272,9,3,3,9,14,2,0,0,0,0,18,12,0,2,1,2,0,1,0,0,0,0,10,540266,3127,9,6,-6,12,0,0,6,-2,-1
KR_7769663542,16286,16355,254,234,8,8,8,8,9,11,1,0,0,0,16,32,5,3,0,1,1,0,1,0,0,0,10,540274,-69,20,0,0,-2,1,0,-16,2,-1
KR_7769673033,14675,17144,258,244,3,12,12,3,2,13,0,0,0,0,9,13,1,1,0,0,0,1,0,0,0,0,10,540249,-2469,14,-9,9,-11,0,0,-4,0,0
KR_7769673198,13309,13834,268,246,1,2,2,1,1,4,0,1,0,0,15,100,4,4,0,0,0,1,0,1,0,0,10,540221,-525,22,-1,1,-3,-1,0,-85,0,0
KR_7769678518,14535,14141,258,223,5,5,5,5,4,2,0,0,0,0,182,14,2,2,0,0,1,0,0,0,0,0,10,540266,394,35,0,0,2,0,0,168,0,0
KR_7769687830,14660,13478,215,267,7,1,1,7,7,0,0,0,0,0,17,39,3,1,0,0,1,0,0,0,0,0,10,540283,1182,-52,6,-6,7,0,0,-22,2,0
KR_7769697117,15363,16733,261,258,6,9,9,7,3,15,0,0,0,0,15,17,5,3,0,2,1,0,0,0,0,0,10,540246,-1370,3,-3,2,-12,0,0,-2,2,-2
KR_7769701644,14489,14622,236,248,5,6,6,5,3,3,0,1,0,0,33,14,4,1,1,0,0,1,0,1,0,0,10,540265,-133,-12,-1,1,0,-1,0,19,3,1
KR_7769715457,15324,15356,286,264,4,5,6,4,3,5,0,0,0,0,17,17,3,2,2,1,1,0,0,0,0,0,10,540271,-32,22,-1,2,-2,0,0,0,1,1
KR_7769717593,15869,14784,274,240,5,5,5,5,10,5,0,0,0,0,13,14,2,4,1,2,1,0,0,0,0,0,10,540218,1085,34,0,0,5,0,0,-1,-2,-1
KR_7769723434,14215,14410,278,260,3,4,4,3,1,1,0,0,0,0,17,16,2,3,0,2,1,0,0,0,0,0,10,540210,-195,18,-1,1,0,0,0,1,-1,-2
KR_7769729130,15129,14664,267,248,5,5,5,5,3,5,1,0,0,0,12,12,1,5,1,1,0,1,1,0,0,0,10,540237,465,19,0,0,-2,1,0,0,-4,0
KR_7769734975,14555,14441,290,282,2,3,3,2,2,2,0,1,0,0,17,18,3,3,2,0,1,0,0,1,0,0,10,540106,114,8,-1,1,0,-1,0,-1,0,2
KR_7769740710,14933,15327,238,243,5,7,7,5,3,5,0,1,0,0,17,65,4,7,0,2,0,1,0,1,0,0,10,540238,-394,-5,-2,2,-2,-1,0,-48,-3,-2
KR_7769743887,14209,14288,220,262,4,3,3,4,3,2,0,0,0,0,111,18,0,1,0,1,1,0,0,0,0,0,10,540269,-79,-42,1,-1,1,0,0,93,-1,-1
KR_7769748383,14402,15931,276,298,2,5,5,2,4,5,1,0,0,0,17,34,3,4,1,0,0,1,1,0,0,0,10,540201,-1529,-22,-3,3,-1,1,0,-17,-1,1
KR_7769750899,16001,13459,272,264,6,2,2,6,5,1,0,1,0,0,16,13,5,4,0,0,1,0,0,1,0,0,10,540243,2542,8,4,-4,4,-1,0,3,1,0
KR_7769763830,13559,15210,247,257,2,5,5,2,2,6,1,0,0,0,16,15,4,4,0,2,0,1,1,0,0,0,10,540115,-1651,-10,-3,3,-4,1,0,1,0,-2
KR_7769774096,14651,16091,244,244,6,6,6,7,7,8,0,0,0,0,26,18,4,3,0,1,0,1,0,0,0,0,10,540265,-1440,0,0,-1,-1,0,0,8,1,-1
KR_7769774183,16218,14634,276,223,7,5,5,7,7,7,0,0,0,0,17,50,9,3,0,0,1,0,0,0,0,0,10,540239,1584,53,2,-2,0,0,0,-33,6,0
KR_7769782354,16946,17612,229,234,12,12,12,12,9,11,0,0,0,0,30,18,1,3,1,3,1,0,0,0,0,0,10,540211,-666,-5,0,0,-2,0,0,12,-2,-2
KR_7769786190,15249,16044,252,254,5,8,8,6,4,8,0,0,0,0,19,13,0,3,0,1,0,1,0,0,0,0,10,540221,-795,-2,-3,2,-4,0,0,6,-3,-1
KR_7769787407,15039,13457,254,265,6,1,1,6,5,1,0,0,0,0,15,16,5,4,0,0,1,0,0,0,0,0,10,540209,1582,-11,5,-5,4,0,0,-1,1,0
KR_7769788949,14612,14835,278,245,3,6,6,3,3,5,1,0,0,0,15,15,2,3,2,0,1,0,1,0,0,0,10,540214,-223,33,-3,3,-2,1,0,0,-1,2
KR_7769796557,13771,14800,249,248,3,6,6,3,1,6,0,0,0,0,34,27,5,2,2,0,0,1,0,0,0,0,10,540215,-1029,1,-3,3,-5,0,0,7,3,2
KR_7769799342,15484,15189,249,269,6,5,5,6,9,7,0,1,0,0,15,38,4,4,0,0,0,1,0,1,0,0,10,540226,295,-20,1,-1,2,-1,0,-23,0,0
KR_7769807067,17291,16360,258,237,10,11,11,10,10,5,0,0,0,0,12,18,3,2,1,0,0,1,0,0,0,0,10,540254,931,21,-1,1,5,0,0,-6,1,1
KR_7769818829,13802,15277,272,297,2,4,4,2,1,2,0,0,0,0,36,25,7,2,1,1,0,1,0,0,0,0,10,540260,-1475,-25,-2,2,-1,0,0,11,5,0
KR_7769821077,13672,17250,240,253,3,12,12,3,2,12,0,1,0,0,14,15,1,2,0,0,1,0,0,1,0,0,10,540288,-3578,-13,-9,9,-10,-1,0,-1,-1,0
KR_7769821294,18230,16208,271,262,11,8,8,11,15,8,0,0,0,0,15,15,1,3,0,1,0,1,0,0,0,0,10,540220,2022,9,3,-3,7,0,0,0,-2,-1
KR_7769824411,14528,16991,270,282,3,8,8,3,3,10,0,0,0,0,14,118,3,3,1,1,0,1,0,0,0,0,10,540235,-2463,-12,-5,5,-7,0,0,-104,0,0
KR_7769828338,14916,15135,263,266,5,6,6,5,4,1,0,1,0,0,18,18,4,3,0,1,0,1,0,1,0,0,10,540233,-219,-3,-1,1,3,-1,0,0,1,-1
KR_7769829980,15460,16461,286,255,6,10,10,6,3,8,0,0,0,0,14,16,4,2,0,0,0,1,0,0,0,0,10,540263,-1001,31,-4,4,-5,0,0,-2,2,0
KR_7769830378,15353,14160,258,259,6,2,2,6,7,3,1,0,0,0,122,14,5,3,3,2,0,1,1,0,0,0,10,540229,1193,-1,4,-4,4,1,0,108,2,1
KR_7769831627,14820,15235,281,284,4,4,5,4,8,7,0,1,0,0,20,21,1,4,0,0,0,1,0,1,0,0,10,540239,-415,-3,0,1,1,-1,0,-1,-3,0
KR_7769836841,15408,13391,293,280,4,1,1,4,4,0,0,0,0,0,21,18,5,6,1,0,0,1,0,0,0,0,10,540225,2017,13,3,-3,4,0,0,3,-1,1
KR_7769840961,15365,17195,231,236,6,9,9,6,6,15,0,0,0,0,17,14,1,2,2,1,0,1,0,0,0,0,10,540231,-1830,-5,-3,3,-9,0,0,3,-1,1
KR_7769845419,18520,14519,275,232,13,5,5,13,6,6,0,0,0,0,14,30,4,1,4,0,1,0,0,0,0,0,10,540228,4001,43,8,-8,0,0,0,-16,3,4
KR_7769849731,15956,15456,301,267,5,5,5,5,5,7,0,0,0,0,107,16,3,2,0,0,1,0,0,0,0,0,10,540270,500,34,0,0,-2,0,0,91,1,0
KR_7769851212,15786,15021,248,256,7,4,4,7,9,4,0,0,0,0,13,13,2,1,1,0,1,0,0,0,0,0,10,540237,765,-8,3,-3,5,0,0,0,1,1
KR_7769860729,18009,15430,257,232,13,6,6,13,13,4,0,0,0,0,17,13,0,1,0,0,1,0,0,0,0,0,10,540225,2579,25,7,-7,9,0,0,4,-1,0
KR_7769867926,16493,15342,219,259,9,6,6,9,12,8,0,0,0,0,15,12,2,2,2,0,0,1,0,0,0,0,10,540225,1151,-40,3,-3,4,0,0,3,0,2
KR_7769868439,13983,14063,246,266,3,3,3,3,5,4,0,1,0,0,14,16,5,2,0,0,0,1,0,1,0,0,10,540181,-80,-20,0,0,1,-1,0,-2,3,0
KR_7769872659,17220,17427,251,258,10,9,9,10,12,12,0,1,0,0,16,15,3,3,1,1,0,1,0,1,0,0,10,540258,-207,-7,1,-1,0,-1,0,1,0,0
KR_7769875323,16017,16739,287,273,6,8,8,6,7,9,0,0,0,0,17,13,1,6,0,0,1,0,0,0,0,0,10,540211,-722,14,-2,2,-2,0,0,4,-5,0
KR_7769884738,14124,16861,251,274,2,7,7,2,3,9,0,1,0,0,18,16,2,3,1,2,1,0,0,1,0,0,10,540229,-2737,-23,-5,5,-6,-1,0,2,-1,-1
KR_7769884855,17462,17617,230,237,14,8,8,14,11,15,0,0,0,0,16,14,1,3,0,1,1,0,0,0,0,0,10,540297,-155,-7,6,-6,-4,0,0,2,-2,-1
KR_7769890672,15155,15613,271,252,4,8,8,4,6,11,0,1,0,0,12,43,5,4,1,0,0,1,0,1,0,0,10,540268,-458,19,-4,4,-5,-1,0,-31,1,1
KR_7769902648,12628,16060,255,271,0,7,7,0,0,8,0,1,0,0,17,23,0,3,0,1,0,1,0,1,0,0,10,540195,-3432,-16,-7,7,-8,-1,0,-6,-3,-1
KR_7769906366,15045,15513,298,246,3,6,6,4,4,8,0,0,0,0,14,17,3,3,1,0,0,1,0,0,0,0,10,540209,-468,52,-3,2,-4,0,0,-3,0,1
KR_7769908220,16867,15598,289,295,8,4,4,8,9,6,0,0,0,0,17,31,3,4,0,0,1,0,0,0,0,0,10,540238,1269,-6,4,-4,3,0,0,-14,-1,0
KR_7769914747,16033,16872,279,260,6,9,10,6,4,9,0,0,0,0,12,10,1,2,0,1,1,0,0,0,0,0,10,540230,-839,19,-3,4,-5,0,0,2,-1,-1
KR_7769919226,13698,15014,241,283,3,4,4,3,2,2,0,0,0,0,14,14,3,6,0,2,0,1,0,0,0,0,10,540181,-1316,-42,-1,1,0,0,0,0,-3,-2
KR_7769919899,16920,15651,297,273,8,5,5,8,8,9,0,0,0,0,19,12,2,4,0,1,0,1,0,0,0,0,10,540241,1269,24,3,-3,-1,0,0,7,-2,-1
KR_7769927912,14978,15277,264,277,5,5,5,5,8,9,0,0,0,0,16,14,2,4,0,3,0,1,0,0,0,0,10,540266,-299,-13,0,0,-1,0,0,2,-2,-3
KR_7769930798,14019,14913,239,270,4,4,4,4,2,2,0,0,0,0,115,11,1,4,0,1,1,0,0,0,0,0,10,540219,-894,-31,0,0,0,0,0,104,-3,-1
KR_7769940195,13224,15604,244,242,2,8,8,2,2,10,0,1,0,0,13,15,4,2,0,1,0,1,0,1,0,0,10,540084,-2380,2,-6,6,-8,-1,0,-2,2,-1
KR_7769963396,15896,15510,253,239,8,7,7,8,9,6,0,0,0,0,39,13,1,6,0,0,0,1,0,0,0,0,10,540227,386,14,1,-1,3,0,0,26,-5,0
KR_7769964172,15567,13650,309,236,5,3,3,5,3,3,0,0,0,0,34,15,2,3,0,0,1,0,0,0,0,0,10,540242,1917,73,2,-2,0,0,0,19,-1,0
KR_7769965928,15880,15117,252,290,7,4,4,8,6,9,0,1,0,0,35,17,3,1,0,0,0,1,0,1,0,0,10,540268,763,-38,3,-4,-3,-1,0,18,2,0
KR_7769966924,15004,15492,282,286,4,5,6,4,7,4,1,0,0,0,15,15,1,3,1,1,1,0,1,0,0,0,10,540254,-488,-4,-1,2,3,1,0,0,-2,0
KR_7769969358,15892,13460,280,240,6,2,2,6,11,0,0,0,0,0,13,60,2,1,3,1,0,1,0,0,0,0,10,540231,2432,40,4,-4,11,0,0,-47,1,2
KR_7769972787,15103,14944,263,263,5,5,5,5,7,5,1,0,0,0,16,17,9,5,0,0,1,0,1,0,0,0,10,540243,159,0,0,0,2,1,0,-1,4,0
KR_7769975802,16345,16787,265,274,6,9,9,6,7,11,0,0,0,0,20,21,1,6,2,0,0,1,0,0,0,0,10,540101,-442,-9,-3,3,-4,0,0,-1,-5,2
KR_7769989522,14092,17514,252,263,3,11,11,3,5,14,1,0,0,0,38,14,3,2,0,0,1,0,1,0,0,0,10,540235,-3422,-11,-8,8,-9,1,0,24,1,0
KR_7770005708,15625,14615,323,281,3,3,3,3,5,4,0,0,0,0,15,22,4,3,2,0,0,1,0,0,0,0,10,540260,1010,42,0,0,1,0,0,-7,1,2
KR_7770022907,15669,16908,256,295,6,8,8,6,7,9,0,1,0,0,14,19,1,4,0,3,0,1,0,1,0,0,10,540235,-1239,-39,-2,2,-2,-1,0,-5,-3,-3
KR_7770036752,15363,18781,287,265,4,13,13,5,4,12,0,0,0,0,39,35,1,4,0,1,0,1,0,0,0,0,10,540266,-3418,22,-9,8,-8,0,0,4,-3,-1
KR_7770050394,14817,14066,272,242,4,4,4,5,3,3,0,1,0,0,12,12,1,5,0,0,0,1,0,1,0,0,10,540226,751,30,0,-1,0,-1,0,0,-4,0
KR_7770073740,13798,14487,259,279,2,3,3,2,2,6,0,1,0,0,39,20,4,4,0,0,1,0,0,1,0,0,10,540237,-689,-20,-1,1,-4,-1,0,19,0,0
KR_7770076443,14729,13083,258,259,5,1,1,5,7,1,0,1,0,0,13,15,2,1,0,0,0,1,0,1,0,0,10,540222,1646,-1,4,-4,6,-1,0,-2,1,0
KR_7770077913,13496,17806,245,265,2,12,12,2,3,13,0,1,0,0,13,13,0,2,0,0,0,1,0,1,0,0,10,540221,-4310,-20,-10,10,-10,-1,0,0,-2,0
KR_7770087496,15752,17789,225,258,8,12,12,8,9,15,0,0,0,0,11,32,4,2,0,1,1,0,0,0,0,0,10,540221,-2037,-33,-4,4,-6,0,0,-21,2,-1
KR_7770093459,14477,15055,277,270,2,4,4,2,2,6,0,0,0,0,17,16,3,0,1,1,0,1,0,0,0,0,10,540237,-578,7,-2,2,-4,0,0,1,3,0
KR_7770106464,13794,16077,260,292,2,6,6,2,2,4,0,0,0,0,36,14,0,4,0,1,0,1,0,0,0,0,10,540254,-2283,-32,-4,4,-2,0,0,22,-4,-1
KR_7770113683,15508,15112,257,275,7,5,5,7,8,5,0,0,0,0,14,35,6,4,1,0,0,1,0,0,0,0,10,540274,396,-18,2,-2,3,0,0,-21,2,1
KR_7770114714,16533,14391,248,237,8,5,5,8,10,3,0,0,0,0,145,219,3,2,1,0,0,1,0,0,0,0,10,540150,2142,11,3,-3,7,0,0,-74,1,1
KR_7770116989,15879,16747,292,264,5,9,9,6,7,15,0,1,0,0,16,16,3,3,0,0,0,1,0,1,0,0,10,540251,-868,28,-4,3,-8,-1,0,0,0,0
KR_7770123227,15200,16484,237,292,6,7,7,6,7,6,1,0,0,0,12,13,1,3,2,1,0,1,1,0,0,0,10,540193,-1284,-55,-1,1,1,1,0,-1,-2,1
KR_7770124520,15502,15299,260,263,6,6,6,7,9,4,0,0,0,0,17,17,3,1,0,0,1,0,0,0,0,0,10,540210,203,-3,0,-1,5,0,0,0,2,0
KR_7770134236,15709,14976,277,284,5,3,3,5,5,3,0,0,0,0,24,13,2,3,2,1,1,0,0,0,0,0,10,540092,733,-7,2,-2,2,0,0,11,-1,1
KR_7770137529,12362,18077,246,282,0,11,11,0,0,14,0,0,0,0,26,61,2,1,1,0,0,1,0,0,0,0,10,540232,-5715,-36,-11,11,-14,0,0,-35,1,1
KR_7770139679,14681,13725,287,277,3,1,1,3,2,1,1,0,0,0,15,14,5,2,0,0,1,0,1,0,0,0,10,540211,956,10,2,-2,1,1,0,1,3,0
KR_7770151142,16215,14570,273,248,7,6,8,8,6,3,0,1,0,0,14,12,6,2,1,1,0,1,0,1,0,0,10,540186,1645,25,1,0,3,-1,0,2,4,0
KR_7770155695,15348,16562,255,263,6,7,7,6,4,6,0,0,0,0,36,18,4,0,0,4,1,0,0,0,0,0,10,540263,-1214,-8,-1,1,-2,0,0,18,4,-4
KR_7770176101,17130,17615,244,263,9,10,10,9,16,12,0,0,0,0,14,11,1,4,0,0,0,1,0,0,0,0,10,540054,-485,-19,-1,1,4,0,0,3,-3,0
KR_7770177399,14988,14599,252,261,5,4,4,5,4,6,0,1,0,0,11,15,3,4,1,1,1,0,0,1,0,0,10,540175,389,-9,1,-1,-2,-1,0,-4,-1,0
KR_7770178557,14328,14451,269,245,3,6,7,3,0,5,0,0,0,0,19,15,3,4,0,0,0,1,0,0,0,0,10,540195,-123,24,-3,4,-5,0,0,4,-1,0
KR_7770184565,17958,15480,265,231,10,7,7,10,16,11,1,0,0,0,25,16,6,5,3,0,1,0,1,0,0,0,10,540210,2478,34,3,-3,5,1,0,9,1,3
KR_7770193194,17324,14736,275,234,9,5,5,9,12,3,0,1,0,0,17,15,3,2,1,0,1,0,0,1,0,0,10,540202,2588,41,4,-4,9,-1,0,2,1,1
KR_7770210805,15041,16068,234,244,8,9,9,8,14,15,0,0,0,0,19,34,4,3,2,0,0,1,0,0,0,0,10,540280,-1027,-10,-1,1,-1,0,0,-15,1,2
KR_7770213721,15961,14644,288,270,6,5,5,6,6,2,0,1,0,0,14,25,2,1,0,0,0,1,0,1,0,0,10,540203,1317,18,1,-1,4,-1,0,-11,1,0
KR_7770216733,16315,16020,283,280,6,7,7,6,5,8,0,0,0,0,16,17,3,1,2,2,0,1,0,0,0,0,10,540214,295,3,-1,1,-3,0,0,-1,2,0
KR_7770228477,16460,14656,257,264,9,4,4,9,11,3,0,1,0,0,15,16,0,3,0,2,1,0,0,1,0,0,10,540211,1804,-7,5,-5,8,-1,0,-1,-3,-2
KR_7770240634,16622,15395,238,254,10,5,6,10,13,4,0,0,0,0,19,14,1,4,1,1,0,1,0,0,0,0,10,540097,1227,-16,5,-4,9,0,0,5,-3,0
KR_7770241143,14882,14331,261,263,5,4,4,5,1,2,0,1,0,0,16,13,3,4,1,0,1,0,0,1,0,0,10,540288,551,-2,1,-1,-1,-1,0,3,-1,1
KR_7770245765,14075,16051,281,240,2,8,8,2,1,9,0,0,0,0,13,14,3,2,2,0,1,0,0,0,0,0,10,540088,-1976,41,-6,6,-8,0,0,-1,1,2
KR_7770257359,13658,15523,247,281,2,6,6,2,4,5,0,0,0,0,15,24,1,3,0,0,0,1,0,0,0,0,10,540262,-1865,-34,-4,4,-1,0,0,-9,-2,0
KR_7770263111,13790,15141,271,293,2,5,5,2,2,3,0,0,0,0,15,16,3,4,1,0,0,1,0,0,0,0,10,540206,-1351,-22,-3,3,-1,0,0,-1,-1,1
KR_7770266922,14092,14510,280,265,2,4,4,2,0,5,0,0,0,0,26,32,2,2,2,0,0,1,0,0,0,0,10,540199,-418,15,-2,2,-5,0,0,-6,0,2
KR_7770290387,17268,15728,292,238,9,7,7,9,8,5,1,0,0,0,15,15,1,4,2,0,1,0,1,0,0,0,10,540234,1540,54,2,-2,3,1,0,0,-3,2
KR_7770291885,16051,15691,247,249,9,6,6,9,6,5,0,0,0,0,16,38,3,2,1,1,1,0,0,0,0,0,10,540108,360,-2,3,-3,1,0,0,-22,1,0
KR_7770294211,15994,14605,281,223,7,6,6,7,3,8,0,0,0,0,19,24,3,0,1,0,1,0,0,0,0,0,10,540220,1389,58,1,-1,-5,0,0,-5,3,1
KR_7770297299,16601,14197,300,305,6,1,1,6,5,0,0,0,0,0,14,16,3,2,1,1,1,0,0,0,0,0,10,540226,2404,-5,5,-5,5,0,0,-2,1,0
KR_7770298864,12592,16186,241,273,1,6,6,1,0,8,0,0,0,0,12,17,2,0,0,0,0,1,0,0,0,0,10,540243,-3594,-32,-5,5,-8,0,0,-5,2,0
KR_7770309595,15071,12892,273,267,4,0,0,4,6,0,0,1,0,0,20,17,2,4,0,0,1,0,0,1,0,0,10,540183,2179,6,4,-4,6,-1,0,3,-2,0
KR_7770309960,15457,15745,223,258,9,8,8,9,10,4,0,1,0,0,31,14,2,0,2,2,0,1,0,1,0,0,10,540223,-288,-35,1,-1,6,-1,0,17,2,0
KR_7770333204,15664,14379,272,275,6,4,4,6,8,2,0,1,0,0,19,35,4,3,0,0,1,0,0,1,0,0,10,540221,1285,-3,2,-2,6,-1,0,-16,1,0
KR_7770343106,14037,17188,255,270,3,9,9,3,2,13,1,0,0,0,15,20,3,4,1,0,0,1,1,0,0,0,10,540221,-3151,-15,-6,6,-11,1,0,-5,-1,1
KR_7770349509,16361,16764,232,262,9,8,8,9,16,9,0,0,0,0,18,14,1,2,1,2,0,1,0,0,0,0,10,540293,-403,-30,1,-1,7,0,0,4,-1,-1
KR_7770372007,14816,13690,284,286,3,1,1,3,4,0,0,0,0,0,18,13,2,3,0,1,0,1,0,0,0,0,10,540213,1126,-2,2,-2,4,0,0,5,-1,-1
KR_7770377413,15059,16349,267,252,4,9,9,4,4,6,0,1,0,0,14,16,4,4,1,1,0,1,0,1,0,0,10,540243,-1290,15,-5,5,-2,-1,0,-2,0,0
KR_7770380940,14664,15214,221,252,6,6,6,7,3,4,0,0,0,0,16,33,0,1,0,0,0,1,0,0,0,0,10,540279,-550,-31,0,-1,-1,0,0,-17,-1,0
KR_7770382602,15715,14808,279,272,5,4,4,5,7,4,0,0,0,0,24,16,4,2,0,0,1,0,0,0,0,0,10,540245,907,7,1,-1,3,0,0,8,2,0
KR_7770387593,15125,16861,268,261,4,9,9,4,4,11,0,0,0,0,17,24,3,3,0,1,0,1,0,0,0,0,10,540222,-1736,7,-5,5,-7,0,0,-7,0,-1
KR_7770414151,15817,14239,272,247,6,3,3,6,10,5,0,0,0,0,16,13,2,3,1,1,1,0,0,0,0,0,10,540208,1578,25,3,-3,5,0,0,3,-1,0
KR_7770429011,13460,16568,233,278,3,8,8,3,2,5,0,0,0,0,15,26,4,3,0,0,0,1,0,0,0,0,10,540210,-3108,-45,-5,5,-3,0,0,-11,1,0
KR_7770439280,14024,17317,281,275,1,11,11,1,0,9,0,0,0,0,117,38,3,4,0,1,0,1,0,0,0,0,10,540175,-3293,6,-10,10,-9,0,0,79,-1,-1
KR_7770447430,14761,15416,259,258,5,6,6,5,6,4,0,0,0,0,15,16,1,2,0,0,1,0,0,0,0,0,10,540221,-655,1,-1,1,2,0,0,-1,-1,0
KR_7770450316,13706,17034,264,283,2,9,9,2,2,12,0,0,0,0,14,18,6,3,0,1,0,1,0,0,0,0,10,540094,-3328,-19,-7,7,-10,0,0,-4,3,-1
KR_7770459578,17849,14937,268,237,12,5,5,12,10,7,1,0,0,0,14,15,1,3,1,0,1,0,1,0,0,0,10,540143,2912,31,7,-7,3,1,0,-1,-2,1
KR_7770463213,14797,16284,263,282,4,7,7,4,6,8,0,0,0,0,17,39,8,2,0,0,0,1,0,0,0,0,10,540200,-1487,-19,-3,3,-2,0,0,-22,6,0
KR_7770472219,14114,14039,251,267,4,2,2,4,6,2,0,0,0,0,13,17,5,3,0,0,1,0,0,0,0,0,10,540197,75,-16,2,-2,4,0,0,-4,2,0
KR_7770490732,14571,15839,248,300,6,5,5,6,6,3,1,0,0,0,16,35,0,3,0,0,0,1,1,0,0,0,10,540203,-1268,-52,1,-1,3,1,0,-19,-3,0
KR_7770494678,15038,16845,276,299,4,8,8,4,5,6,0,0,0,0,18,17,1,5,1,0,0,1,0,0,0,0,10,540208,-1807,-23,-4,4,-1,0,0,1,-4,1
KR_7770499399,14626,14150,266,257,4,4,4,4,1,2,0,0,0,0,18,12,2,5,1,1,0,1,0,0,0,0,10,540225,476,9,0,0,-1,0,0,6,-3,0
KR_7770509111,17908,15560,242,268,13,7,7,13,17,2,1,0,0,0,17,16,2,4,0,1,1,0,1,0,0,0,10,540233,2348,-26,6,-6,15,1,0,1,-2,-1
KR_7770510172,15229,16943,248,266,6,10,10,6,7,13,0,1,0,0,11,17,1,3,0,1,0,1,0,1,0,0,10,540232,-1714,-18,-4,4,-6,-1,0,-6,-2,-1
KR_7770521160,16795,14571,258,257,9,4,4,9,9,6,0,0,0,0,14,39,4,3,0,1,1,0,0,0,0,0,10,540213,2224,1,5,-5,3,0,0,-25,1,-1
KR_7770523530,16647,15180,252,277,8,5,5,8,10,3,0,0,0,0,14,17,2,2,1,0,0,1,0,0,0,0,10,540235,1467,-25,3,-3,7,0,0,-3,0,1
KR_7770527214,17432,15183,256,254,10,6,6,10,15,8,0,0,0,0,15,16,3,2,0,0,1,0,0,0,0,0,10,540249,2249,2,4,-4,7,0,0,-1,1,0
KR_7770527390,14402,15269,279,293,2,3,3,2,3,5,0,0,0,0,12,37,1,1,0,0,1,0,0,0,0,0,10,540244,-867,-14,-1,1,-2,0,0,-25,0,0
KR_7770538865,14549,15722,289,249,2,8,8,2,1,14,0,1,0,0,13,44,0,0,3,0,0,1,0,1,0,0,10,540191,-1173,40,-6,6,-13,-1,0,-31,0,3
KR_7770545059,15950,14696,276,275,6,2,2,6,8,3,0,1,0,0,74,19,5,3,1,0,1,0,0,1,0,0,10,540205,1254,1,4,-4,5,-1,0,55,2,1
KR_7770549782,15675,13961,279,248,6,3,3,6,5,2,0,0,0,0,20,36,2,2,0,0,1,0,0,0,0,0,10,540197,1714,31,3,-3,3,0,0,-16,0,0
KR_7770565685,15445,13637,257,265,7,2,2,7,4,3,0,0,0,0,15,14,3,3,0,0,0,1,0,0,0,0,10,540245,1808,-8,5,-5,1,0,0,1,0,0
KR_7770567393,5560,6268,52,95,1,1,1,1,1,1,0,0,0,0,7,17,0,0,0,0,0,1,0,0,0,0,6,242006,-708,-43,0,0,0,0,0,-10,0,0
KR_7770568534,15089,16150,254,263,5,9,9,5,5,9,0,0,0,0,15,107,1,0,1,0,0,1,0,0,0,0,10,540222,-1061,-9,-4,4,-4,0,0,-92,1,1
KR_7770589366,15821,14457,303,260,5,4,4,5,5,4,0,0,0,0,16,16,4,3,0,0,0,1,0,0,0,0,10,540208,1364,43,1,-1,1,0,0,0,1,0
KR_7770592232,15079,14337,234,281,6,3,3,6,9,1,0,1,0,0,16,37,8,3,0,1,1,0,0,1,0,0,10,540085,742,-47,3,-3,8,-1,0,-21,5,-1
KR_7770598456,15782,14365,283,273,6,3,3,6,7,5,0,0,0,0,15,15,4,4,1,0,0,1,0,0,0,0,10,540191,1417,10,3,-3,2,0,0,0,0,1
KR_7770600102,14811,14895,286,281,3,4,4,3,3,3,0,1,0,0,23,17,3,3,0,3,0,1,0,1,0,0,10,540183,-84,5,-1,1,0,-1,0,6,0,-3
KR_7770608442,15160,14768,287,274,3,3,3,3,3,3,0,1,0,0,19,13,2,4,0,1,0,1,0,1,0,0,10,540284,392,13,0,0,0,-1,0,6,-2,-1
KR_7770614032,15183,16199,261,285,6,7,7,6,4,6,1,0,0,0,11,16,3,2,0,0,0,1,1,0,0,0,10,540221,-1016,-24,-1,1,-2,1,0,-5,1,0
KR_7770615424,16455,15604,278,280,8,4,4,8,9,7,0,0,0,0,17,13,1,3,0,0,1,0,0,0,0,0,10,540281,851,-2,4,-4,2,0,0,4,-2,0
KR_7770618550,15189,14967,248,246,6,6,7,6,6,4,0,0,0,0,14,20,4,3,0,0,0,1,0,0,0,0,10,540223,222,2,0,1,2,0,0,-6,1,0
KR_7770625829,17858,14266,249,229,12,5,5,12,18,6,0,0,0,0,16,20,3,3,1,0,1,0,0,0,0,0,10,540207,3592,20,7,-7,12,0,0,-4,0,1
KR_7770635751,16075,15635,293,271,6,5,5,6,8,5,0,0,0,0,16,17,6,3,0,2,0,1,0,0,0,0,10,540227,440,22,1,-1,3,0,0,-1,3,-2
KR_7770638113,14691,14040,299,253,2,3,3,2,1,1,0,0,0,0,16,18,2,1,1,0,0,1,0,0,0,0,10,540218,651,46,-1,1,0,0,0,-2,1,1
KR_7770639971,15242,13126,304,256,3,1,1,3,5,2,0,0,0,0,22,35,1,5,1,0,0,1,0,0,0,0,10,540236,2116,48,2,-2,3,0,0,-13,-4,1
KR_7770644256,14501,15996,249,285,4,5,5,4,5,4,0,0,0,0,12,19,7,3,0,4,1,0,0,0,0,0,10,540132,-1495,-36,-1,1,1,0,0,-7,4,-4
KR_7770650918,14650,15144,254,247,5,5,5,5,3,6,0,0,0,0,15,15,5,5,1,0,0,1,0,0,0,0,10,540280,-494,7,0,0,-3,0,0,0,0,1
KR_7770659784,14933,13187,301,280,3,0,0,3,3,0,0,0,0,0,18,38,6,4,0,0,1,0,0,0,0,0,10,540254,1746,21,3,-3,3,0,0,-20,2,0
KR_7770669213,16329,14024,279,289,6,2,2,6,6,2,0,0,0,0,18,21,4,0,2,0,1,0,0,0,0,0,10,540215,2305,-10,4,-4,4,0,0,-3,4,2
KR_7770678533,13969,16207,258,295,3,7,7,3,1,4,0,1,0,0,13,106,5,3,0,0,0,1,0,1,0,0,10,540239,-2238,-37,-4,4,-3,-1,0,-93,2,0
KR_7770679420,15206,13528,306,298,4,0,0,4,6,0,1,0,0,0,21,34,4,8,0,0,1,0,1,0,0,0,10,540276,1678,8,4,-4,6,1,0,-13,-4,0
KR_7770680856,15044,14790,257,252,5,5,5,5,4,4,0,1,0,0,107,13,3,0,2,0,1,0,0,1,0,0,10,540190,254,5,0,0,0,-1,0,94,3,2
KR_7770683422,16254,14242,259,223,9,4,4,9,6,8,1,0,0,0,17,130,3,4,1,0,1,0,1,0,0,0,10,540265,2012,36,5,-5,-2,1,0,-113,-1,1
KR_7770685842,16668,15106,261,275,9,4,4,9,7,4,0,0,0,0,17,14,3,3,0,1,1,0,0,0,0,0,10,540202,1562,-14,5,-5,3,0,0,3,0,-1
KR_7770690125,14698,15517,274,263,4,5,5,4,2,9,0,0,0,0,37,15,4,2,0,0,1,0,0,0,0,0,10,540249,-819,11,-1,1,-7,0,0,22,2,0
KR_7770699005,13379,17397,241,271,2,8,8,2,2,9,0,0,0,0,33,28,4,2,0,1,0,1,0,0,0,0,10,540222,-4018,-30,-6,6,-7,0,0,5,2,-1
KR_7770700168,14008,15242,259,282,3,5,6,3,3,3,0,1,0,0,19,19,3,2,0,0,0,1,0,1,0,0,10,540088,-1234,-23,-2,3,0,-1,0,0,1,0
KR_7770701185,14340,15051,249,278,4,3,3,4,3,6,0,0,0,0,15,19,6,2,0,1,1,0,0,0,0,0,10,540157,-711,-29,1,-1,-3,0,0,-4,4,-1
KR_7770701855,14738,15662,248,236,5,8,8,5,4,9,0,1,0,0,18,15,5,3,2,1,0,1,0,1,0,0,10,540172,-924,12,-3,3,-5,-1,0,3,2,1
KR_7770703759,14147,16098,280,279,3,8,8,3,1,4,1,0,0,0,13,21,2,5,1,1,0,1,1,0,0,0,10,540219,-1951,1,-5,5,-3,1,0,-8,-3,0
KR_7770705751,15553,15020,261,232,7,5,5,7,9,7,0,0,0,0,19,14,1,2,0,0,1,0,0,0,0,0,10,540263,533,29,2,-2,2,0,0,5,-1,0
KR_7770712519,16330,13551,293,269,6,2,2,6,8,0,0,1,0,0,20,15,3,4,0,0,1,0,0,1,0,0,10,540198,2779,24,4,-4,8,-1,0,5,-1,0
KR_7770713014,17493,16793,264,262,9,9,9,9,10,13,0,1,0,0,13,31,3,5,1,0,0,1,0,1,0,0,10,540232,700,2,0,0,-3,-1,0,-18,-2,1
KR_7770715543,16559,13859,280,252,7,3,3,7,7,6,0,0,0,0,15,50,4,6,3,0,0,1,0,0,0,0,10,540189,2700,28,4,-4,1,0,0,-35,-2,3
KR_7770723000,17685,15365,290,228,10,6,6,10,12,6,0,0,0,0,13,16,0,2,2,0,1,0,0,0,0,0,10,540200,2320,62,4,-4,6,0,0,-3,-2,2
KR_7770727138,15126,14091,280,254,4,2,2,4,3,2,0,0,0,0,19,35,6,2,0,2,0,1,0,0,0,0,10,540257,1035,26,2,-2,1,0,0,-16,4,-2
KR_7770732549,14699,13582,260,284,5,0,0,5,4,0,0,0,0,0,15,13,1,2,0,2,1,0,0,0,0,0,10,540195,1117,-24,5,-5,4,0,0,2,-1,-2
KR_7770735957,16837,13571,297,278,8,1,1,8,10,0,1,0,0,0,26,20,5,3,1,0,1,0,1,0,0,0,10,540203,3266,19,7,-7,10,1,0,6,2,1
KR_7770736709,15076,15416,274,279,5,5,5,5,8,2,1,0,0,0,11,16,2,3,0,0,1,0,1,0,0,0,10,540255,-340,-5,0,0,6,1,0,-5,-1,0
KR_7770737687,17451,15907,277,263,8,5,5,8,9,6,0,0,0,0,123,36,3,5,0,0,0,1,0,0,0,0,10,540174,1544,14,3,-3,3,0,0,87,-2,0
KR_7770738150,14544,15516,289,276,2,6,6,2,2,7,0,0,0,0,21,15,3,3,0,0,0,1,0,0,0,0,10,540277,-972,13,-4,4,-5,0,0,6,0,0
KR_7770742091,15662,15231,253,289,7,4,4,8,6,4,0,0,0,0,18,36,4,2,0,1,1,0,0,0,0,0,10,540262,431,-36,3,-4,2,0,0,-18,2,-1
KR_7770752880,14734,17225,237,260,5,9,9,5,5,9,0,1,0,0,16,15,2,6,0,2,0,1,0,1,0,0,10,540241,-2491,-23,-4,4,-4,-1,0,1,-4,-2
KR_7770752989,18563,14445,282,263,13,4,4,13,13,2,0,0,0,0,17,20,3,3,1,0,1,0,0,0,0,0,10,540230,4118,19,9,-9,11,0,0,-3,0,1
KR_7770754211,15506,14069,264,277,5,3,3,5,4,1,0,0,0,0,17,16,1,2,2,0,0,1,0,0,0,0,10,540222,1437,-13,2,-2,3,0,0,1,-1,2
KR_7770759050,13799,17704,257,283,2,11,11,3,2,11,0,1,0,0,13,22,3,1,1,2,0,1,0,1,0,0,10,540109,-3905,-26,-9,8,-9,-1,0,-9,2,-1
KR_7770763653,14746,14311,272,275,5,3,3,5,5,2,0,1,0,0,17,18,4,6,0,0,1,0,0,1,0,0,10,540198,435,-3,2,-2,3,-1,0,-1,-2,0
KR_7770774896,13889,15152,260,261,2,5,5,2,3,6,0,0,0,0,15,16,3,1,3,0,0,1,0,0,0,0,10,540241,-1263,-1,-3,3,-3,0,0,-1,2,3
KR_7770776162,16564,17801,288,268,6,12,12,6,8,18,1,0,0,0,18,15,4,4,0,0,0,1,1,0,0,0,10,540256,-1237,20,-6,6,-10,1,0,3,0,0
KR_7770779697,14398,16651,263,252,3,10,10,3,5,10,0,1,0,0,17,16,0,3,0,0,0,1,0,1,0,0,10,540236,-2253,11,-7,7,-5,-1,0,1,-3,0
KR_7770781917,17650,15803,261,247,10,6,6,10,11,7,0,0,0,0,18,20,4,4,0,1,0,1,0,0,0,0,10,540298,1847,14,4,-4,4,0,0,-2,0,-1
KR_7770782492,14852,15718,273,256,3,7,7,3,5,8,0,0,0,0,30,15,3,7,0,1,0,1,0,0,0,0,10,540297,-866,17,-4,4,-3,0,0,15,-4,-1
KR_7770786723,16528,14345,259,273,10,2,2,10,9,3,0,0,0,0,18,20,1,2,0,1,1,0,0,0,0,0,10,540187,2183,-14,8,-8,6,0,0,-2,-1,-1
KR_7770789746,14766,15940,239,269,5,7,7,5,8,6,0,0,0,0,18,19,3,4,0,1,0,1,0,0,0,0,10,540200,-1174,-30,-2,2,2,0,0,-1,-1,-1
KR_7770793250,15473,16326,221,243,7,9,9,7,7,7,0,0,0,0,44,18,1,2,0,1,0,1,0,0,0,0,10,540264,-853,-22,-2,2,0,0,0,26,-1,-1
KR_7770798248,14842,16097,269,254,3,8,8,4,4,7,0,0,0,0,19,12,2,4,1,1,0,1,0,0,0,0,10,540255,-1255,15,-5,4,-3,0,0,7,-2,0
KR_7770801932,15665,13283,279,269,5,1,1,5,3,1,0,0,0,0,16,39,5,2,2,0,1,0,0,0,0,0,10,540245,2382,10,4,-4,2,0,0,-23,3,2
KR_7770803366,13771,14691,282,272,1,3,3,1,2,4,0,0,0,0,16,20,3,0,0,0,1,0,0,0,0,0,10,540245,-920,10,-2,2,-2,0,0,-4,3,0
KR_7770803935,14820,15050,268,263,4,5,5,4,5,5,0,1,0,0,37,18,2,6,0,0,0,1,0,1,0,0,10,540214,-230,5,-1,1,0,-1,0,19,-4,0
KR_7770805254,16225,14729,236,278,9,4,5,9,9,5,0,0,0,0,21,18,2,5,0,0,1,0,0,0,0,0,10,540273,1496,-42,5,-4,4,0,0,3,-3,0
KR_7770805517,15527,16602,254,245,6,9,9,6,6,12,0,0,0,0,17,16,3,2,0,0,1,0,0,0,0,0,10,540208,-1075,9,-3,3,-6,0,0,1,1,0
KR_7770816058,13545,15912,283,313,1,4,4,1,0,5,0,0,0,0,17,16,3,6,0,1,0,1,0,0,0,0,10,540249,-2367,-30,-3,3,-5,0,0,1,-3,-1
KR_7770819259,14837,15019,252,293,5,3,3,5,9,3,0,0,0,0,19,15,4,5,0,2,1,0,0,0,0,0,10,540246,-182,-41,2,-2,6,0,0,4,-1,-2
KR_7770819945,14641,17088,266,240,4,12,12,4,1,14,0,0,0,0,16,20,4,4,0,0,0,1,0,0,0,0,10,540176,-2447,26,-8,8,-13,0,0,-4,0,0
KR_7770820861,14438,15725,247,251,4,7,7,4,4,8,0,0,0,0,16,18,3,4,0,0,1,0,0,0,0,0,10,540223,-1287,-4,-3,3,-4,0,0,-2,-1,0
KR_7770823995,13871,14759,258,252,3,5,5,3,2,3,0,0,0,0,15,26,1,2,0,0,1,0,0,0,0,0,10,540231,-888,6,-2,2,-1,0,0,-11,-1,0
KR_7770825265,15066,15949,254,285,5,6,7,5,7,5,0,1,0,0,19,16,2,4,0,0,1,0,0,1,0,0,10,540232,-883,-31,-1,2,2,-1,0,3,-2,0
KR_7770826046,15391,15259,265,248,5,6,6,5,7,6,0,0,0,0,12,16,1,5,3,1,0,1,0,0,0,0,10,540229,132,17,-1,1,1,0,0,-4,-4,2
KR_7770832383,15343,16552,258,250,5,9,9,5,6,12,0,0,0,0,26,17,1,2,0,1,1,0,0,0,0,0,10,540262,-1209,8,-4,4,-6,0,0,9,-1,-1
KR_7770837105,15293,15534,268,284,5,6,6,5,2,5,0,0,0,0,18,20,2,2,1,0,0,1,0,0,0,0,10,540230,-241,-16,-1,1,-3,0,0,-2,0,1
KR_7770837446,14716,14701,268,261,4,4,4,5,6,2,0,0,0,0,12,34,1,3,1,2,1,0,0,0,0,0,10,540203,15,7,0,-1,4,0,0,-22,-2,-1
KR_7770841835,15347,15626,294,259,4,6,6,4,3,7,0,0,0,0,16,24,3,2,1,0,1,0,0,0,0,0,10,540252,-279,35,-2,2,-4,0,0,-8,1,1
KR_7770842778,15036,15201,296,271,4,4,4,4,4,4,0,0,0,0,16,35,5,3,0,0,0,1,0,0,0,0,10,540223,-165,25,0,0,0,0,0,-19,2,0
KR_7770848069,14505,14801,239,232,4,7,7,4,4,5,0,0,0,0,13,18,5,2,1,0,0,1,0,0,0,0,10,540202,-296,7,-3,3,-1,0,0,-5,3,1
KR_7770848338,14045,15411,225,286,4,6,6,4,5,5,0,0,0,0,17,12,2,7,0,1,1,0,0,0,0,0,10,540259,-1366,-61,-2,2,0,0,0,5,-5,-1
KR_7770851529,14691,13929,270,264,3,2,2,3,3,3,0,0,0,0,18,72,5,3,2,1,0,1,0,0,0,0,10,540208,762,6,1,-1,0,0,0,-54,2,1
KR_7770852248,15448,15217,258,248,6,5,5,6,5,11,0,1,0,0,10,15,3,4,0,0,0,1,0,1,0,0,10,540192,231,10,1,-1,-6,-1,0,-5,-1,0
KR_7770852648,16214,15311,251,253,8,7,7,8,7,3,0,1,0,0,19,17,6,1,1,0,0,1,0,1,0,0,10,540304,903,-2,1,-1,4,-1,0,2,5,1
KR_7770855130,15638,14234,220,246,9,4,4,9,6,1,0,0,0,0,18,15,0,3,3,0,0,1,0,0,0,0,10,540213,1404,-26,5,-5,5,0,0,3,-3,3
KR_7770856964,14021,18082,249,267,3,12,12,3,4,12,0,0,0,0,17,16,1,1,0,1,1,0,0,0,0,0,10,540264,-4061,-18,-9,9,-8,0,0,1,0,-1
KR_7770857442,16926,15494,278,269,9,6,6,9,8,9,0,0,0,0,11,13,1,1,0,0,0,1,0,0,0,0,10,540205,1432,9,3,-3,-1,0,0,-2,0,0
KR_7770865433,16434,15696,262,249,10,7,7,10,5,5,0,0,0,0,14,15,3,1,1,0,0,1,0,0,0,0,10,540222,738,13,3,-3,0,0,0,-1,2,1
KR_7770869048,13228,14453,257,284,2,3,3,2,1,2,0,1,0,0,11,19,2,2,0,0,0,1,0,1,0,0,10,540183,-1225,-27,-1,1,-1,-1,0,-8,0,0
KR_7770875796,14491,13547,274,253,3,3,3,3,1,4,0,0,0,0,23,14,5,3,0,0,0,1,0,0,0,0,10,540215,944,21,0,0,-3,0,0,9,2,0
KR_7770885179,14627,16524,241,253,4,8,8,4,3,11,0,0,0,0,17,15,1,3,0,4,0,1,0,0,0,0,10,540245,-1897,-12,-4,4,-8,0,0,2,-2,-4
KR_7770886378,14405,17749,220,278,4,10,10,4,9,10,0,0,0,0,21,84,2,2,1,4,0,1,0,0,0,0,10,540225,-3344,-58,-6,6,-1,0,0,-63,0,-3
KR_7770996379,16141,15576,266,255,6,6,7,6,6,7,0,0,0,0,25,15,4,3,2,3,0,1,0,0,0,0,10,540234,565,11,0,1,-1,0,0,10,1,-1
KR_7771016678,16306,13590,240,222,10,4,4,10,13,3,0,0,0,0,15,25,2,0,0,0,1,0,0,0,0,0,10,540192,2716,18,6,-6,10,0,0,-10,2,0
KR_7771031225,13405,15652,273,271,1,7,7,1,1,6,0,0,0,0,15,17,3,2,0,1,0,1,0,0,0,0,10,540253,-2247,2,-6,6,-5,0,0,-2,1,-1
KR_7771038667,12745,15597,252,266,0,5,5,0,0,8,0,0,0,0,16,35,3,7,0,2,0,1,0,0,0,0,10,540238,-2852,-14,-5,5,-8,0,0,-19,-4,-2
KR_7771064667,14490,14122,289,264,3,3,3,3,3,4,1,0,0,0,14,39,6,1,0,0,1,0,1,0,0,0,10,540245,368,25,0,0,-1,1,0,-25,5,0
KR_7771079586,12792,14540,248,257,1,4,4,1,2,7,0,1,0,0,22,16,2,6,0,1,1,0,0,1,0,0,10,540240,-1748,-9,-3,3,-5,-1,0,6,-4,-1
KR_7771094934,15189,15914,270,285,5,7,7,5,3,5,0,0,0,0,17,16,1,1,0,2,0,1,0,0,0,0,10,540267,-725,-15,-2,2,-2,0,0,1,0,-2
KR_7771104426,15811,14259,272,280,6,1,1,6,8,2,0,0,0,0,104,8,0,1,0,1,1,0,0,0,0,0,10,540246,1552,-8,5,-5,6,0,0,96,-1,-1
KR_7771119096,15697,13960,291,275,5,2,2,6,8,1,0,1,0,0,19,11,2,3,0,0,1,0,0,1,0,0,10,540193,1737,16,3,-4,7,-1,0,8,-1,0
KR_7771140564,15322,13941,256,291,6,1,1,6,4,1,0,0,0,0,15,16,4,4,0,1,0,1,0,0,0,0,10,540303,1381,-35,5,-5,3,0,0,-1,0,-1
KR_7771142549,15079,15158,294,274,3,5,5,3,3,5,0,1,0,0,16,15,4,4,1,1,0,1,0,1,0,0,10,540232,-79,20,-2,2,-2,-1,0,1,0,0
KR_7771144793,17642,14702,236,242,11,5,5,11,12,6,0,0,0,0,16,14,4,6,0,0,0,1,0,0,0,0,10,540224,2940,-6,6,-6,6,0,0,2,-2,0
KR_7771148110,15812,14405,268,266,6,3,3,6,5,6,0,1,0,0,18,8,0,4,2,0,1,0,0,1,0,0,10,540246,1407,2,3,-3,-1,-1,0,10,-4,2
KR_7771163477,15178,16400,255,273,6,7,7,6,8,8,0,0,0,0,17,20,3,4,0,2,1,0,0,0,0,0,10,540244,-1222,-18,-1,1,0,0,0,-3,-1,-2
KR_7771173789,15711,16424,278,269,6,9,9,6,5,6,0,0,0,0,14,18,4,0,0,0,0,1,0,0,0,0,10,540225,-713,9,-3,3,-1,0,0,-4,4,0
KR_7771176700,13331,14532,263,310,1,1,1,1,1,1,0,1,0,0,22,20,4,2,0,1,0,1,0,1,0,0,10,540211,-1201,-47,0,0,0,-1,0,2,2,-1
KR_7771177341,15346,16249,264,272,5,7,7,5,4,7,1,0,0,0,21,13,3,5,2,0,0,1,1,0,0,0,10,540250,-903,-8,-2,2,-3,1,0,8,-2,2
KR_7771185463,14427,16952,215,259,5,10,11,5,5,10,0,1,0,0,16,17,2,3,1,0,0,1,0,1,0,0,10,540170,-2525,-44,-5,6,-5,-1,0,-1,-1,1
KR_7771189781,13222,14867,236,273,2,4,4,2,3,3,0,0,0,0,17,18,1,2,0,0,0,1,0,0,0,0,10,540196,-1645,-37,-2,2,0,0,0,-1,-1,0
KR_7771194417,13915,16987,244,293,3,9,9,3,3,8,0,1,0,0,12,18,3,5,0,2,0,1,0,1,0,0,10,540232,-3072,-49,-6,6,-5,-1,0,-6,-2,-2
KR_7771198452,15991,15106,282,247,7,6,6,7,4,5,1,0,0,0,27,16,3,1,1,0,1,0,1,0,0,0,10,540224,885,35,1,-1,-1,1,0,11,2,1
KR_7771215015,17146,13733,270,238,8,3,3,8,8,5,0,0,0,0,15,17,2,5,0,0,1,0,0,0,0,0,10,540225,3413,32,5,-5,3,0,0,-2,-3,0
KR_7771217679,16388,15758,258,257,8,7,7,8,8,5,0,0,0,0,16,17,2,5,3,1,0,1,0,0,0,0,10,540231,630,1,1,-1,3,0,0,-1,-3,2
KR_7771219984,14251,13575,281,273,2,1,2,2,4,2,0,0,0,0,40,11,0,4,3,0,1,0,0,0,0,0,10,540189,676,8,1,0,2,0,0,29,-4,3
KR_7771220716,15254,16983,262,247,4,11,11,4,6,12,0,1,0,0,38,20,2,4,1,0,0,1,0,1,0,0,10,540191,-1729,15,-7,7,-6,-1,0,18,-2,1
KR_7771223959,17134,15578,245,266,10,6,6,10,11,3,0,0,0,0,12,106,2,2,2,2,1,0,0,0,0,0,10,540228,1556,-21,4,-4,8,0,0,-94,0,0
KR_7771224568,15088,14148,297,280,5,2,2,5,4,1,0,0,0,0,14,16,5,3,0,0,1,0,0,0,0,0,10,540262,940,17,3,-3,3,0,0,-2,2,0
KR_7771252853,17110,17618,219,263,12,10,10,12,13,7,0,0,0,0,29,23,2,5,0,0,1,0,0,0,0,0,10,540223,-508,-44,2,-2,6,0,0,6,-3,0
KR_7771258195,17319,13477,290,230,10,2,3,10,10,3,1,0,0,0,22,12,1,6,0,0,1,0,1,0,0,0,10,540244,3842,60,8,-7,7,1,0,10,-5,0
KR_7771274349,15627,14461,298,318,5,1,1,5,7,1,0,0,0,0,17,16,3,6,0,1,1,0,0,0,0,0,10,540254,1166,-20,4,-4,6,0,0,1,-3,-1
KR_7771274707,17282,14329,303,218,9,5,5,9,12,6,0,0,0,0,20,16,2,3,2,0,0,1,0,0,0,0,10,540185,2953,85,4,-4,6,0,0,4,-1,2
KR_7771275223,13884,14325,280,291,2,1,1,2,1,2,0,1,0,0,12,12,2,1,0,1,1,0,0,1,0,0,10,540234,-441,-11,1,-1,-1,-1,0,0,1,-1
KR_7771277236,16301,17690,243,283,8,9,9,8,8,11,0,1,0,0,13,19,2,2,0,1,0,1,0,1,0,0,10,540264,-1389,-40,-1,1,-3,-1,0,-6,0,-1
KR_7771278136,15707,14806,297,286,6,4,4,6,3,2,0,0,0,0,18,13,4,3,0,0,1,0,0,0,0,0,10,540218,901,11,2,-2,1,0,0,5,1,0
KR_7771281212,13212,17555,227,254,2,11,11,2,2,13,0,1,0,0,36,13,2,3,1,1,0,1,0,1,0,0,10,540248,-4343,-27,-9,9,-11,-1,0,23,-1,0
KR_7771286281,15043,14430,284,280,4,2,2,4,4,3,0,0,0,0,15,36,4,3,0,1,0,1,0,0,0,0,10,540263,613,4,2,-2,1,0,0,-21,1,-1
KR_7771289197,18035,15090,264,262,11,7,7,11,12,2,0,1,0,0,16,18,3,1,0,0,1,0,0,1,0,0,10,540170,2945,2,4,-4,10,-1,0,-2,2,0
KR_7771293406,14807,15024,296,275,3,3,3,3,3,5,0,0,0,0,19,15,1,4,0,0,1,0,0,0,0,0,10,540247,-217,21,0,0,-2,0,0,4,-3,0
KR_7771300234,16281,14776,280,260,6,4,4,6,5,7,0,0,0,0,20,14,2,6,2,0,1,0,0,0,0,0,10,540129,1505,20,2,-2,-2,0,0,6,-4,2
KR_7771311003,15221,15186,276,254,4,6,6,4,5,4,0,0,0,0,16,18,3,3,0,0,0,1,0,0,0,0,10,540150,35,22,-2,2,1,0,0,-2,0,0
KR_7771315577,16977,14568,251,294,10,3,3,10,17,3,0,1,0,0,16,111,2,1,1,0,1,0,0,1,0,0,10,540237,2409,-43,7,-7,14,-1,0,-95,1,1
KR_7771323237,16388,17310,265,214,8,13,13,8,5,12,1,0,0,0,14,36,2,3,2,1,0,1,1,0,0,0,10,540256,-922,51,-5,5,-7,1,0,-22,-1,1
KR_7771325523,14879,13315,259,275,4,1,1,4,9,1,0,1,0,0,76,13,1,5,0,0,0,1,0,1,0,0,10,540229,1564,-16,3,-3,8,-1,0,63,-4,0
KR_7771334582,16490,14238,255,271,6,4,4,6,9,3,0,0,0,0,15,19,4,2,3,0,0,1,0,0,0,0,10,540271,2252,-16,2,-2,6,0,0,-4,2,3
KR_7771344090,14890,16615,267,281,5,8,8,5,4,6,1,0,0,0,18,24,2,1,0,1,1,0,1,0,0,0,10,540278,-1725,-14,-3,3,-2,1,0,-6,1,-1
KR_7771346368,14862,15392,262,319,4,3,3,4,6,5,0,0,0,0,15,17,3,2,0,0,1,0,0,0,0,0,10,540202,-530,-57,1,-1,1,0,0,-2,1,0
KR_7771364029,15674,13669,269,235,7,4,5,7,7,6,0,0,0,0,15,13,2,0,0,0,1,0,0,0,0,0,10,540220,2005,34,3,-2,1,0,0,2,2,0
KR_7771368789,16234,13455,231,216,8,3,3,8,9,6,0,0,0,0,16,20,3,2,2,0,0,1,0,0,0,0,10,540198,2779,15,5,-5,3,0,0,-4,1,2
KR_7771383829,16925,14797,264,263,9,5,5,9,6,2,0,0,0,0,19,15,2,3,0,0,0,1,0,0,0,0,10,540278,2128,1,4,-4,4,0,0,4,-1,0
KR_7771401881,14782,15826,263,261,4,7,7,4,4,8,0,0,0,0,112,18,3,4,1,1,1,0,0,0,0,0,10,540302,-1044,2,-3,3,-4,0,0,94,-1,0
KR_7771402176,15639,16311,243,255,7,9,9,7,7,13,1,0,0,0,17,16,2,5,0,2,0,1,1,0,0,0,10,540206,-672,-12,-2,2,-6,1,0,1,-3,-2
KR_7771405097,16478,14903,283,231,7,7,7,7,5,4,0,0,0,0,18,104,2,1,0,0,1,0,0,0,0,0,10,540232,1575,52,0,0,1,0,0,-86,1,0
KR_7771408252,15086,14941,267,229,5,6,7,5,2,7,0,1,0,0,13,16,4,0,1,0,0,1,0,1,0,0,10,540264,145,38,-1,2,-5,-1,0,-3,4,1
KR_7771410688,17392,15171,277,244,9,5,6,9,6,5,0,1,0,0,14,19,5,4,1,0,1,0,0,1,0,0,10,540253,2221,33,4,-3,1,-1,0,-5,1,1
KR_7771412700,17155,14006,279,271,9,2,2,10,12,2,0,0,0,0,40,15,4,3,0,1,0,1,0,0,0,0,10,540219,3149,8,7,-8,10,0,0,25,1,-1
KR_7771425214,15336,14320,251,286,6,2,2,6,9,2,1,0,0,0,20,14,5,5,0,1,1,0,1,0,0,0,10,540075,1016,-35,4,-4,7,1,0,6,0,-1
KR_7771435466,17139,16236,298,254,7,10,11,7,6,15,0,0,0,0,203,37,1,2,2,0,0,1,0,0,0,0,10,540262,903,44,-3,4,-9,0,0,166,-1,2
KR_7771446514,13842,14403,249,274,3,1,1,3,5,0,0,0,0,0,20,15,4,7,1,4,1,0,0,0,0,1,10,540226,-561,-25,2,-2,5,0,0,5,-3,-3
KR_7771463083,13982,13736,268,272,2,2,2,2,3,3,0,1,0,0,42,16,5,4,1,0,1,0,0,1,0,0,10,540236,246,-4,0,0,0,-1,0,26,1,1
KR_7771467104,14037,14692,282,290,2,4,4,2,3,0,0,1,0,0,19,36,4,7,0,0,1,0,0,1,0,0,10,540263,-655,-8,-2,2,3,-1,0,-17,-3,0
KR_7771468059,15695,16204,257,259,7,8,8,7,5,11,0,0,0,0,16,12,1,3,0,0,0,1,0,0,0,0,10,540204,-509,-2,-1,1,-6,0,0,4,-2,0
KR_7771468255,18154,14822,284,265,9,4,4,9,13,5,0,0,0,0,14,14,5,3,1,1,1,0,0,0,0,0,10,540236,3332,19,5,-5,8,0,0,0,2,0
KR_7771489540,15895,13780,289,263,5,2,2,5,6,2,0,0,0,0,14,44,1,2,1,0,1,0,0,0,0,0,10,540213,2115,26,3,-3,4,0,0,-30,-1,1
KR_7771499651,16059,14335,275,218,6,4,4,6,5,5,0,0,0,0,20,20,4,3,1,0,1,0,0,0,0,0,10,540199,1724,57,2,-2,0,0,0,0,1,1
KR_7771505852,15052,14798,256,255,4,6,6,4,2,2,0,1,0,0,13,19,2,1,1,0,1,0,0,1,0,0,10,540186,254,1,-2,2,0,-1,0,-6,1,1
KR_7771510372,15101,16826,250,325,6,5,5,6,4,5,0,1,0,0,19,19,5,5,0,2,0,1,0,1,0,0,10,540114,-1725,-75,1,-1,-1,-1,0,0,0,-2
KR_7771519473,15976,16309,281,243,6,8,8,6,8,18,0,1,0,0,15,12,1,2,2,0,0,1,0,1,0,0,10,540235,-333,38,-2,2,-10,-1,0,3,-1,2
KR_7771536784,16054,16401,224,263,9,7,7,9,10,8,0,0,0,0,20,15,1,4,1,1,0,1,0,0,0,0,10,540080,-347,-39,2,-2,2,0,0,5,-3,0
KR_7771544915,15918,14434,267,289,7,3,3,7,9,1,0,0,0,0,15,12,2,3,0,1,1,0,0,0,0,0,10,540225,1484,-22,4,-4,8,0,0,3,-1,-1
KR_7771546899,15961,17760,229,228,8,12,12,8,17,25,0,1,0,0,17,26,4,2,0,0,1,0,0,1,0,0,10,540083,-1799,1,-4,4,-8,-1,0,-9,2,0
KR_7771552094,18088,14925,262,230,12,5,5,12,22,10,1,0,0,0,14,45,3,4,2,0,1,0,1,0,0,0,10,540189,3163,32,7,-7,12,1,0,-31,-1,2
KR_7771563199,15498,15988,277,277,5,7,7,5,2,9,0,0,0,0,15,118,4,3,0,0,0,1,0,0,0,0,10,540119,-490,0,-2,2,-7,0,0,-103,1,0
KR_7771568796,14714,13142,282,295,5,0,0,5,1,0,0,1,0,0,21,17,1,1,0,0,1,0,0,1,0,0,10,540253,1572,-13,5,-5,1,-1,0,4,0,0
KR_7771580449,13458,18598,245,275,2,11,11,2,3,11,1,0,0,0,36,127,4,1,1,4,0,1,1,0,0,1,10,540291,-5140,-30,-9,9,-8,1,0,-91,3,-3
KR_7771586455,19497,13873,293,252,13,3,3,13,13,3,0,0,0,0,17,227,1,3,4,0,0,1,0,0,0,0,10,540252,5624,41,10,-10,10,0,0,-210,-2,4
KR_7771588703,14326,15972,221,250,5,9,9,5,7,4,0,0,0,0,12,17,4,4,0,2,0,1,0,0,0,0,10,540087,-1646,-29,-4,4,3,0,0,-5,0,-2
KR_7771603974,14853,14308,235,232,5,4,4,5,8,8,0,0,0,0,20,36,3,4,1,0,1,0,0,0,0,0,10,540237,545,3,1,-1,0,0,0,-16,-1,1
KR_7771610778,13898,13789,270,255,2,3,3,2,2,1,0,0,0,0,18,17,3,3,0,0,0,1,0,0,0,0,10,540282,109,15,-1,1,1,0,0,1,0,0
KR_7771617328,16048,15748,237,255,8,7,7,8,10,3,0,1,0,0,19,13,1,3,0,2,1,0,0,1,0,0,10,540179,300,-18,1,-1,7,-1,0,6,-2,-2
KR_7771631425,13905,16660,268,279,2,7,7,2,1,10,0,1,0,0,17,16,2,3,0,0,0,1,0,1,0,0,10,540181,-2755,-11,-5,5,-9,-1,0,1,-1,0
KR_7771640345,15009,13772,284,282,4,1,1,4,4,2,0,1,0,0,35,20,1,4,1,0,1,0,0,1,0,0,10,540236,1237,2,3,-3,2,-1,0,15,-3,1
KR_7771658609,14869,15967,266,306,6,5,5,6,1,3,0,0,0,0,15,13,3,4,0,2,0,1,0,0,0,0,10,540261,-1098,-40,1,-1,-2,0,0,2,-1,-2
KR_7771678121,13794,16476,250,284,3,7,7,3,2,9,0,1,0,0,15,20,2,5,0,1,0,1,0,1,0,0,10,540218,-2682,-34,-4,4,-7,-1,0,-5,-3,-1
KR_7771679322,15713,15136,241,246,8,5,5,8,6,7,0,0,0,0,14,14,1,7,2,1,1,0,0,0,0,0,10,540246,577,-5,3,-3,-1,0,0,0,-6,1
KR_7771689262,15750,18072,280,261,5,10,10,5,5,11,0,0,0,0,15,113,4,4,1,1,0,1,0,0,0,0,10,540288,-2322,19,-5,5,-6,0,0,-98,0,0
KR_7771696865,15606,15678,284,275,5,6,7,5,5,5,0,0,0,0,23,18,7,2,1,0,1,0,0,0,0,0,10,540214,-72,9,-1,2,0,0,0,5,5,1
KR_7771705459,14180,16473,291,269,1,7,7,1,2,9,0,0,0,0,16,15,4,1,0,1,0,1,0,0,0,0,10,540223,-2293,22,-6,6,-7,0,0,1,3,-1
KR_7771706631,13256,17247,248,273,2,11,11,2,1,6,0,0,0,0,14,26,1,8,0,0,0,1,0,0,0,0,10,540257,-3991,-25,-9,9,-5,0,0,-12,-7,0
KR_7771712063,13343,15287,273,319,1,3,3,1,1,4,0,1,0,0,45,17,4,4,0,1,0,1,0,1,0,0,10,540235,-1944,-46,-2,2,-3,-1,0,28,0,-1
KR_7771730091,15053,14971,254,263,5,6,6,5,6,3,0,1,0,0,14,14,3,3,2,0,1,0,0,1,0,0,10,540257,82,-9,-1,1,3,-1,0,0,0,2
KR_7771740256,14485,14876,241,250,6,5,5,6,5,4,0,0,0,0,26,15,2,2,1,1,1,0,0,0,0,0,10,540201,-391,-9,1,-1,1,0,0,11,0,0
KR_7771749176,16243,14837,240,246,8,4,4,8,7,6,0,0,0,0,38,21,6,4,2,1,1,0,0,0,0,0,10,540227,1406,-6,4,-4,1,0,0,17,2,1
KR_7771749513,16017,14049,232,259,8,3,3,8,18,2,0,1,0,0,15,18,3,4,0,0,1,0,0,1,0,0,10,540236,1968,-27,5,-5,16,-1,0,-3,-1,0
KR_7771751380,14463,15447,239,280,5,5,5,5,5,5,0,0,0,0,17,17,3,1,0,0,1,0,0,0,0,0,10,540200,-984,-41,0,0,0,0,0,0,2,0
KR_7771763648,15665,14646,284,265,6,4,4,6,5,4,0,0,0,0,117,15,4,1,0,0,1,0,0,0,0,0,10,540243,1019,19,2,-2,1,0,0,102,3,0
KR_7771766573,15848,14337,273,257,7,3,3,7,8,6,0,0,0,0,16,21,6,0,1,0,1,0,0,0,0,0,10,540237,1511,16,4,-4,2,0,0,-5,6,1
KR_7771774516,14595,13700,270,262,3,2,2,3,4,3,0,1,0,0,11,59,5,2,1,1,0,1,0,1,0,0,10,540212,895,8,1,-1,1,-1,0,-48,3,0
KR_7771776722,15691,17104,218,269,7,10,10,7,15,12,0,1,0,0,14,15,3,0,0,1,0,1,0,1,0,0,10,540204,-1413,-51,-3,3,3,-1,0,-1,3,-1
KR_7771777356,16664,18053,244,252,9,11,11,9,11,13,0,0,0,0,14,16,3,2,0,2,1,0,0,0,0,0,10,540199,-1389,-8,-2,2,-2,0,0,-2,1,-2
KR_7771779743,15834,15728,263,254,8,6,6,8,9,11,0,0,0,0,14,13,2,1,0,0,0,1,0,0,0,0,10,540266,106,9,2,-2,-2,0,0,1,1,0
KR_7771781298,15605,15110,261,284,5,4,4,5,10,5,0,0,0,0,28,21,6,2,1,3,0,1,0,0,0,0,10,540187,495,-23,1,-1,5,0,0,7,4,-2
KR_7771793116,13766,17193,243,265,3,11,11,3,3,17,0,0,0,0,12,15,1,3,1,2,0,1,0,0,0,0,10,540240,-3427,-22,-8,8,-14,0,0,-3,-2,-1
KR_7771799759,15215,15142,258,241,5,6,6,5,8,6,0,0,0,0,18,18,2,0,0,0,0,1,0,0,0,0,10,540233,73,17,-1,1,2,0,0,0,2,0
KR_7771809813,15371,18109,249,266,5,11,11,5,5,7,0,0,0,0,13,16,3,2,1,5,1,0,0,0,0,0,10,540122,-2738,-17,-6,6,-2,0,0,-3,1,-4
KR_7771830244,14721,14232,228,259,6,4,4,6,5,1,0,0,0,0,14,20,5,3,0,1,0,1,0,0,0,0,10,540230,489,-31,2,-2,4,0,0,-6,2,-1
KR_7771835953,14951,15231,271,294,5,5,5,5,6,5,0,0,0,0,16,19,2,3,0,0,1,0,0,0,0,0,10,540192,-280,-23,0,0,1,0,0,-3,-1,0
KR_7771836540,15246,14846,243,273,7,3,3,7,4,3,0,1,0,0,20,13,2,5,1,1,1,0,0,1,0,0,10,540190,400,-30,4,-4,1,-1,0,7,-3,0
KR_7771842127,15887,15495,262,261,6,7,7,6,6,6,0,1,0,0,16,16,1,1,1,1,0,1,0,1,0,0,10,540218,392,1,-1,1,0,-1,0,0,0,0
KR_7771846101,13365,16348,263,263,1,10,10,1,1,8,0,0,0,0,35,18,5,5,0,0,0,1,0,0,0,0,10,540255,-2983,0,-9,9,-7,0,0,17,0,0
KR_7771849175,16614,14111,295,278,5,2,2,5,8,2,1,0,0,0,30,16,4,3,2,3,1,0,1,0,0,0,10,540283,2503,17,3,-3,6,1,0,14,1,-1
KR_7771858697,13368,16621,247,260,1,7,7,1,2,11,0,0,0,0,15,19,3,1,1,1,0,1,0,0,0,0,10,540178,-3253,-13,-6,6,-9,0,0,-4,2,0
KR_7771873019,14614,15467,261,283,4,5,5,4,5,3,0,0,0,0,47,44,3,5,0,2,0,1,0,0,0,0,10,540226,-853,-22,-1,1,2,0,0,3,-2,-2
KR_7771882931,2609,2661,3,5,0,0,0,0,0,0,0,0,0,0,1,7,0,1,0,0,0,0,0,0,0,0,3,109269,-52,-2,0,0,0,0,0,-6,-1,0
KR_7771883313,14844,15399,271,248,5,7,7,5,2,3,0,0,0,0,14,14,2,5,1,0,0,1,0,0,0,0,10,540267,-555,23,-2,2,-1,0,0,0,-3,1
KR_7771894632,15830,15541,243,287,7,6,6,7,6,4,0,1,0,0,12,22,5,2,0,0,1,0,0,1,0,0,10,540183,289,-44,1,-1,2,-1,0,-10,3,0
KR_7771895340,13551,16842,239,268,3,9,9,3,5,7,0,0,0,0,22,46,2,3,0,2,0,1,0,0,0,0,10,540208,-3291,-29,-6,6,-2,0,0,-24,-1,-2
KR_7771901096,14425,14497,278,283,3,2,2,3,6,4,1,0,0,0,17,32,2,4,0,1,0,1,1,0,0,0,10,540274,-72,-5,1,-1,2,1,0,-15,-2,-1
KR_7771907158,15820,16449,220,256,8,8,8,8,11,8,0,0,0,0,29,19,5,1,0,0,0,1,0,0,0,0,10,540232,-629,-36,0,0,3,0,0,10,4,0
KR_7771908645,13063,16353,232,246,1,9,9,1,1,16,0,1,0,0,15,22,1,2,0,1,0,1,0,1,0,0,10,540223,-3290,-14,-8,8,-15,-1,0,-7,-1,-1
KR_7771920505,15574,13772,225,240,7,3,3,8,6,1,0,1,0,0,16,33,2,6,2,2,1,0,0,1,0,0,10,540230,1802,-15,4,-5,5,-1,0,-17,-4,0
KR_7771933423,14983,15630,260,262,4,7,7,4,5,4,0,1,0,0,13,19,6,3,0,0,0,1,0,1,0,0,10,540236,-647,-2,-3,3,1,-1,0,-6,3,0
KR_7771940061,17730,13967,269,241,12,3,3,12,11,4,0,0,0,0,25,19,6,1,0,0,1,0,0,0,0,0,10,540259,3763,28,9,-9,7,0,0,6,5,0
KR_7771946868,16280,14876,268,278,10,4,4,10,5,3,0,1,0,0,13,16,0,2,0,2,0,1,0,1,0,0,10,540239,1404,-10,6,-6,2,-1,0,-3,-2,-2
KR_7771947894,18506,16204,237,214,12,9,9,13,10,11,0,0,0,0,13,24,4,2,3,0,0,1,0,0,0,0,10,540255,2302,23,3,-4,-1,0,0,-11,2,3
KR_7771948328,13602,17345,274,298,2,8,8,2,0,9,0,0,0,0,27,18,3,0,0,0,0,1,0,0,0,0,10,540230,-3743,-24,-6,6,-9,0,0,9,3,0
KR_7771959738,14576,15843,232,261,6,6,6,6,3,8,1,0,0,0,21,20,5,5,0,1,0,1,1,0,0,0,10,540109,-1267,-29,0,0,-5,1,0,1,0,-1
KR_7771963542,16823,15862,242,223,12,7,7,12,8,6,0,0,0,0,22,21,6,7,0,0,1,0,0,0,0,0,10,540222,961,19,5,-5,2,0,0,1,-1,0
KR_7771972075,14753,16619,265,296,3,5,5,3,5,7,0,0,0,0,13,18,2,2,2,2,1,0,0,0,0,0,10,540240,-1866,-31,-2,2,-2,0,0,-5,0,0
KR_7771972989,13998,17203,281,267,1,10,10,1,1,13,0,0,0,0,11,17,4,1,1,1,0,1,0,0,0,0,10,540205,-3205,14,-9,9,-12,0,0,-6,3,0
KR_7771987170,15494,15563,279,283,4,5,5,4,4,5,0,1,0,0,18,54,2,2,1,0,1,0,0,1,0,0,10,540085,-69,-4,-1,1,-1,-1,0,-36,0,1
KR_7771989218,15555,14426,261,234,6,5,5,6,6,4,1,0,0,0,14,12,3,5,1,1,1,0,1,0,0,0,10,540278,1129,27,1,-1,2,1,0,2,-2,0
KR_7771994313,15947,15232,283,236,8,5,5,8,3,6,0,0,0,0,16,10,2,1,1,1,1,0,0,0,0,0,10,540253,715,47,3,-3,-3,0,0,6,1,0
KR_7772008098,14971,15036,256,273,5,4,4,5,5,3,1,0,0,0,26,13,3,4,1,2,1,0,1,0,0,0,10,540237,-65,-17,1,-1,2,1,0,13,-1,-1
KR_7772015028,17784,12832,292,252,9,1,1,9,9,0,0,0,0,0,116,20,4,1,1,0,1,0,0,0,0,0,10,540194,4952,40,8,-8,9,0,0,96,3,1
KR_7772021761,14178,15256,259,269,2,5,5,2,3,7,0,0,0,0,14,14,2,2,0,1,0,1,0,0,0,0,10,540242,-1078,-10,-3,3,-4,0,0,0,0,-1
KR_7772033299,14808,14864,274,283,4,4,4,4,2,2,0,0,0,0,13,17,4,5,0,1,1,0,0,0,0,0,10,540178,-56,-9,0,0,0,0,0,-4,-1,-1
KR_7772034139,13774,14618,262,259,2,4,4,2,3,4,0,0,0,0,14,14,1,3,0,0,1,0,0,0,0,0,10,540246,-844,3,-2,2,-1,0,0,0,-2,0
KR_7772046797,14696,13770,287,288,2,1,1,2,3,2,0,0,0,0,15,16,2,3,0,0,1,0,0,0,0,0,10,540221,926,-1,1,-1,1,0,0,-1,-1,0
KR_7772054234,16661,16820,258,232,9,11,11,9,10,12,0,0,0,0,12,13,1,2,0,0,0,1,0,0,0,0,10,540197,-159,26,-2,2,-2,0,0,-1,-1,0
KR_7772061434,15188,14613,262,240,6,5,5,6,4,8,0,0,0,0,21,16,2,6,1,0,0,1,0,0,0,0,10,540100,575,22,1,-1,-4,0,0,5,-4,1
KR_7772067868,15876,15508,279,270,6,4,4,7,4,6,0,0,0,0,16,39,2,2,0,0,0,1,0,0,0,0,10,540236,368,9,2,-3,-2,0,0,-23,0,0
KR_7772076119,14863,15353,270,282,5,5,5,5,3,6,1,0,0,0,16,14,2,0,0,0,1,0,1,0,0,0,10,540204,-490,-12,0,0,-3,1,0,2,2,0
KR_7772077489,15598,15010,278,283,4,5,5,4,4,1,0,0,0,0,15,13,4,0,2,0,0,1,0,0,0,0,10,540267,588,-5,-1,1,3,0,0,2,4,2
KR_7772078295,15914,15741,274,264,5,8,8,5,7,6,0,1,0,0,18,16,5,2,2,0,0,1,0,1,0,0,10,540255,173,10,-3,3,1,-1,0,2,3,2
KR_7772082733,14964,14460,278,246,5,4,4,5,1,4,0,0,0,0,37,15,4,2,1,1,1,0,0,0,0,0,10,540258,504,32,1,-1,-3,0,0,22,2,0
KR_7772092894,17598,15344,252,225,11,6,6,11,11,6,0,0,0,0,22,14,3,5,1,1,1,0,0,0,0,0,10,540225,2254,27,5,-5,5,0,0,8,-2,0
KR_7772092967,15240,15615,244,268,6,6,6,6,10,8,0,0,0,0,13,22,0,1,0,1,0,1,0,0,0,0,10,540200,-375,-24,0,0,2,0,0,-9,-1,-1
KR_7772100800,17070,16283,256,270,9,7,7,9,13,6,1,0,0,0,16,17,4,3,0,0,1,0,1,0,0,0,10,540253,787,-14,2,-2,7,1,0,-1,1,0
KR_7772106850,17483,14862,287,245,9,4,4,9,6,3,0,0,0,0,25,35,3,3,1,0,1,0,0,0,0,0,10,540243,2621,42,5,-5,3,0,0,-10,0,1
KR_7772113508,13637,14768,253,269,2,5,5,2,3,4,1,0,0,0,17,14,0,4,1,1,1,0,1,0,0,0,10,540255,-1131,-16,-3,3,-1,1,0,3,-4,0
KR_7772115915,15817,17403,243,279,7,10,10,7,8,10,0,0,0,0,15,16,2,0,0,0,0,1,0,0,0,0,10,540224,-1586,-36,-3,3,-2,0,0,-1,2,0
KR_7772120775,17681,14077,277,259,11,2,2,11,15,3,0,0,0,0,36,106,4,4,3,0,1,0,0,0,0,0,10,540240,3604,18,9,-9,12,0,0,-70,0,3
KR_7772124207,14250,15518,272,288,3,5,5,3,2,6,1,0,0,0,15,41,3,3,1,2,0,1,1,0,0,0,10,540254,-1268,-16,-2,2,-4,1,0,-26,0,-1
KR_7772128795,15990,15449,267,300,6,4,4,6,9,4,0,0,0,0,17,16,3,2,0,0,1,0,0,0,0,0,10,540252,541,-33,2,-2,5,0,0,1,1,0
KR_7772135282,14756,13953,300,289,2,1,1,2,3,2,0,1,0,0,19,20,3,6,0,0,1,0,0,1,0,0,10,540230,803,11,1,-1,1,-1,0,-1,-3,0
KR_7772137538,15499,16490,243,259,6,9,9,6,9,12,0,1,0,0,101,18,4,6,0,1,0,1,0,1,0,0,10,540226,-991,-16,-3,3,-3,-1,0,83,-2,-1
KR_7772138454,15931,14261,283,253,4,3,3,4,7,4,0,0,0,0,17,14,1,2,2,1,0,1,0,0,0,0,10,540189,1670,30,1,-1,3,0,0,3,-1,1
KR_7772140840,15414,15402,268,278,6,4,4,6,7,4,1,0,0,0,23,15,3,7,1,0,1,0,1,0,0,0,10,540246,12,-10,2,-2,3,1,0,8,-4,1
KR_7772150678,15582,15735,233,261,7,7,7,7,8,8,0,0,0,0,14,20,3,1,0,1,0,1,0,0,0,0,10,540221,-153,-28,0,0,0,0,0,-6,2,-1
KR_7772152053,15709,15163,245,277,7,3,3,7,8,4,0,0,0,0,12,20,2,2,0,1,0,1,0,0,0,0,10,540207,546,-32,4,-4,4,0,0,-8,0,-1
KR_7772153178,16513,13880,294,264,7,2,2,7,9,3,0,0,0,0,16,16,3,1,0,0,1,0,0,0,0,0,10,540264,2633,30,5,-5,6,0,0,0,2,0
KR_7772157875,16450,16186,258,248,8,8,8,8,16,8,0,0,0,0,13,14,3,4,0,0,1,0,0,0,0,0,10,540242,264,10,0,0,8,0,0,-1,-1,0
KR_7772165819,15696,18965,234,262,7,13,13,7,13,16,0,0,0,0,17,25,0,5,0,1,0,1,0,0,0,0,10,540253,-3269,-28,-6,6,-3,0,0,-8,-5,-1
KR_7772168041,13303,17020,210,281,3,10,10,3,2,8,0,0,0,0,15,17,1,0,0,1,0,1,0,0,0,0,10,540231,-3717,-71,-7,7,-6,0,0,-2,1,-1
KR_7772171868,15488,15137,272,250,6,6,6,6,6,3,0,0,0,0,163,11,2,3,2,0,1,0,0,0,0,0,10,540224,351,22,0,0,3,0,0,152,-1,2
KR_7772174145,16709,13072,308,269,7,1,1,7,7,0,0,1,0,0,18,13,4,3,0,0,1,0,0,1,0,0,10,540243,3637,39,6,-6,7,-1,0,5,1,0
KR_7772174912,16777,14956,303,264,8,4,5,8,4,6,0,1,0,0,17,13,1,3,0,0,1,0,0,1,0,0,10,540218,1821,39,4,-3,-2,-1,0,4,-2,0
KR_7772180288,14695,14882,285,277,4,4,4,4,3,8,0,0,0,0,36,15,4,0,0,0,0,1,0,0,0,0,10,540263,-187,8,0,0,-5,0,0,21,4,0
KR_7772185500,13078,15373,249,290,1,5,5,1,1,3,1,0,0,0,16,121,5,6,0,1,0,1,1,0,0,0,10,540203,-2295,-41,-4,4,-2,1,0,-105,-1,-1
KR_7772194213,13601,15167,263,286,2,4,4,2,3,9,1,0,0,0,16,37,3,3,0,0,1,0,1,0,0,0,10,540208,-1566,-23,-2,2,-6,1,0,-21,0,0
KR_7772196069,15445,15563,254,253,6,6,6,6,9,4,0,1,0,0,19,37,4,3,1,0,1,0,0,1,0,0,10,540234,-118,1,0,0,5,-1,0,-18,1,1
KR_7772200472,13891,14519,262,254,2,4,4,2,3,5,0,0,0,0,18,18,5,7,1,1,0,1,0,0,0,0,10,540230,-628,8,-2,2,-2,0,0,0,-2,0
KR_7772203271,15824,14868,247,266,6,4,4,6,9,5,0,1,0,0,20,37,2,3,0,0,1,0,0,1,0,0,10,540193,956,-19,2,-2,4,-1,0,-17,-1,0
KR_7772203421,14672,14833,261,261,5,4,4,5,3,2,0,0,0,0,17,37,3,3,0,3,1,0,0,0,0,0,10,540278,-161,0,1,-1,1,0,0,-20,0,-3
KR_7772205615,13491,14785,281,242,0,5,5,0,0,5,0,0,0,0,14,33,2,2,0,0,0,1,0,0,0,0,10,540266,-1294,39,-5,5,-5,0,0,-19,0,0
KR_7772208114,15673,16198,247,257,7,7,7,7,7,11,0,0,0,0,19,13,0,3,1,0,1,0,0,0,0,0,10,540193,-525,-10,0,0,-4,0,0,6,-3,1
KR_7772210031,14344,14815,255,301,4,4,4,4,3,3,0,1,0,0,16,19,3,1,0,1,0,1,0,1,0,0,10,540214,-471,-46,0,0,0,-1,0,-3,2,-1
KR_7772212567,15685,14869,253,264,6,3,3,6,9,4,0,0,0,0,13,39,3,3,1,3,0,1,0,0,0,0,10,540194,816,-11,3,-3,5,0,0,-26,0,-2
KR_7772219485,17097,15659,242,282,10,6,6,11,12,2,0,1,0,0,21,178,1,2,0,3,1,0,0,1,0,0,10,540249,1438,-40,4,-5,10,-1,0,-157,-1,-3
KR_7772228911,13734,15367,272,290,2,4,4,2,2,6,0,1,0,0,13,13,3,4,0,1,0,1,0,1,0,0,10,540303,-1633,-18,-2,2,-4,-1,0,0,-1,-1
KR_7772230424,14256,13802,305,272,2,2,2,2,2,4,0,0,0,0,17,31,0,1,0,0,0,1,0,0,0,0,10,540216,454,33,0,0,-2,0,0,-14,-1,0
KR_7772231282,16069,15027,295,260,5,6,6,5,6,7,0,0,0,0,15,15,3,0,0,1,0,1,0,0,0,0,10,540210,1042,35,-1,1,-1,0,0,0,3,-1
KR_7772235343,14667,17400,237,269,5,9,9,6,8,9,0,0,0,0,13,11,2,4,0,1,0,1,0,0,0,0,10,540200,-2733,-32,-4,3,-1,0,0,2,-2,-1
KR_7772237485,14492,16948,265,303,3,7,8,3,4,9,0,1,0,0,35,18,4,7,1,0,1,0,0,1,0,0,10,540214,-2456,-38,-4,5,-5,-1,0,17,-3,1
KR_7772237607,15659,15085,265,248,6,7,7,6,7,5,1,0,0,0,15,17,4,1,0,0,0,1,1,0,0,0,10,540226,574,17,-1,1,2,1,0,-2,3,0
KR_7772238411,14901,15319,267,237,4,7,7,4,3,8,0,0,0,0,13,21,3,3,1,2,1,0,0,0,0,0,10,540098,-418,30,-3,3,-5,0,0,-8,0,-1
KR_7772240586,17664,15181,273,257,9,5,6,9,9,4,0,0,0,0,14,101,3,4,3,0,0,1,0,0,0,0,10,540207,2483,16,4,-3,5,0,0,-87,-1,3
KR_7772241160,16428,15186,231,249,9,6,6,9,11,4,0,0,0,0,21,20,2,6,1,1,0,1,0,0,0,0,10,540252,1242,-18,3,-3,7,0,0,1,-4,0
KR_7772242021,15155,14653,296,285,4,3,3,4,1,7,0,0,0,0,36,35,3,5,0,1,0,1,0,0,0,0,10,540193,502,11,1,-1,-6,0,0,1,-2,-1
KR_7772249211,15787,16175,250,271,8,7,7,8,8,9,0,0,0,0,25,16,5,4,0,1,0,1,0,0,0,0,10,540251,-388,-21,1,-1,-1,0,0,9,1,-1
KR_7772252518,14732,14998,271,250,4,6,6,5,2,6,0,0,0,0,16,15,1,2,0,1,0,1,0,0,0,0,10,540237,-266,21,-2,1,-4,0,0,1,-1,-1
KR_7772253128,16816,13211,290,261,7,1,1,7,9,0,0,0,0,0,16,13,2,1,0,0,1,0,0,0,0,0,10,540234,3605,29,6,-6,9,0,0,3,1,0
KR_7772258471,15824,13748,243,257,7,2,2,7,7,2,0,0,0,0,19,24,1,6,1,0,0,1,0,0,0,0,10,540228,2076,-14,5,-5,5,0,0,-5,-5,1
KR_7772259406,16664,14925,259,293,9,3,3,9,14,3,0,0,0,0,15,14,2,3,0,1,1,0,0,0,0,0,10,540182,1739,-34,6,-6,11,0,0,1,-1,-1
KR_7772260006,16278,15169,275,277,7,5,5,7,6,2,0,1,0,0,12,16,4,0,2,1,0,1,0,1,0,0,10,540209,1109,-2,2,-2,4,-1,0,-4,4,1
KR_7772260433,17647,15148,284,266,9,5,5,9,10,3,0,1,0,0,15,15,1,2,0,0,1,0,0,1,0,0,10,540208,2499,18,4,-4,7,-1,0,0,-1,0
KR_7772263971,15007,16581,283,301,4,8,8,4,4,9,0,1,0,0,15,15,2,5,0,0,0,1,0,1,0,0,10,540203,-1574,-18,-4,4,-5,-1,0,0,-3,0
KR_7772264399,17748,13670,256,269,12,2,2,12,13,0,0,0,0,0,19,16,2,3,0,0,0,1,0,0,0,0,10,540281,4078,-13,10,-10,13,0,0,3,-1,0
KR_7772266059,15471,15429,243,271,5,5,6,5,6,5,0,1,0,0,27,22,4,6,0,2,0,1,0,1,0,0,10,540210,42,-28,0,1,1,-1,0,5,-2,-2
KR_7772268674,14044,14725,245,249,4,4,4,4,4,8,0,0,0,0,19,18,1,2,0,0,1,0,0,0,0,0,10,540115,-681,-4,0,0,-4,0,0,1,-1,0
KR_7772271164,17610,14941,258,245,11,5,5,11,11,3,1,0,0,0,21,15,2,3,1,0,0,1,1,0,0,0,10,540255,2669,13,6,-6,8,1,0,6,-1,1
KR_7772272701,12747,17593,190,279,3,11,11,3,4,6,0,0,0,0,15,16,1,1,0,1,1,0,0,0,0,0,10,540266,-4846,-89,-8,8,-2,0,0,-1,0,-1
KR_7772273514,14540,15183,285,267,3,5,5,3,3,4,0,0,0,0,44,17,4,4,0,0,0,1,0,0,0,0,10,540260,-643,18,-2,2,-1,0,0,27,0,0
KR_7772275320,14591,14793,276,279,4,3,3,4,4,6,0,0,0,0,14,19,3,2,0,0,1,0,0,0,0,0,10,540253,-202,-3,1,-1,-2,0,0,-5,1,0
KR_7772276171,15708,15416,278,272,6,5,5,6,4,5,0,0,0,0,15,17,4,1,0,0,0,1,0,0,0,0,10,540175,292,6,1,-1,-1,0,0,-2,3,0
KR_7772277544,17064,14326,283,255,8,4,4,8,8,3,0,0,0,0,16,32,3,3,0,0,0,1,0,0,0,0,10,540222,2738,28,4,-4,5,0,0,-16,0,0
KR_7772280999,13973,16670,231,259,4,10,10,4,4,11,0,0,0,0,36,19,2,3,0,0,0,1,0,0,0,0,10,540135,-2697,-28,-6,6,-7,0,0,17,-1,0
KR_7772282780,15742,13020,297,277,5,0,0,5,4,0,0,0,0,0,19,18,3,4,2,0,1,0,0,0,0,0,10,540250,2722,20,5,-5,4,0,0,1,-1,2
KR_7772287126,17595,15133,267,257,10,6,6,10,10,6,0,0,0,0,17,33,0,1,1,0,0,1,0,0,0,0,10,540238,2462,10,4,-4,4,0,0,-16,-1,1
KR_7772288157,14598,15421,223,219,6,9,9,6,9,9,1,0,0,0,16,21,4,3,0,0,1,0,1,0,0,0,10,540115,-823,4,-3,3,0,1,0,-5,1,0
KR_7772289236,17092,15672,263,254,12,5,5,12,7,8,0,0,0,0,37,29,6,4,1,0,1,0,0,0,0,0,10,540200,1420,9,7,-7,-1,0,0,8,2,1
KR_7772291478,15140,16121,225,249,7,9,9,7,8,6,0,0,0,0,15,44,5,3,0,0,1,0,0,0,0,0,10,540236,-981,-24,-2,2,2,0,0,-29,2,0
KR_7772294853,14859,15169,282,276,3,4,4,3,6,5,0,0,0,0,39,13,0,2,2,1,0,1,0,0,0,0,10,540209,-310,6,-1,1,1,0,0,26,-2,1
KR_7772295290,15184,15790,290,254,4,7,7,6,5,10,0,0,0,0,70,17,4,4,0,0,0,1,0,0,0,0,10,540194,-606,36,-3,1,-5,0,0,53,0,0
KR_7772297819,18023,15127,230,217,13,7,7,14,17,7,0,1,0,0,17,98,2,4,0,0,1,0,0,1,0,0,10,540221,2896,13,6,-7,10,-1,0,-81,-2,0
KR_7772297979,15480,15166,261,256,5,6,6,5,6,3,0,0,0,0,26,15,4,3,1,0,0,1,0,0,0,0,10,540284,314,5,-1,1,3,0,0,11,1,1
KR_7772299566,16356,13613,272,210,7,5,5,7,7,5,0,0,0,0,17,16,3,1,1,0,0,1,0,0,0,0,10,540171,2743,62,2,-2,2,0,0,1,2,1
KR_7772302451,13471,16029,274,288,1,6,6,1,0,8,0,1,0,0,18,42,4,4,0,1,1,0,0,1,0,0,10,540215,-2558,-14,-5,5,-8,-1,0,-24,0,-1
KR_7772303485,16236,14244,302,250,6,3,3,6,4,6,0,1,0,0,12,36,3,2,0,0,1,0,0,1,0,0,10,540269,1992,52,3,-3,-2,-1,0,-24,1,0
KR_7772305492,14135,16798,235,265,3,11,11,3,5,5,0,0,0,0,15,34,1,2,0,1,0,1,0,0,0,0,10,540225,-2663,-30,-8,8,0,0,0,-19,-1,-1
KR_7772308024,16335,17253,253,258,8,10,10,8,8,11,0,0,0,0,12,41,1,2,0,0,0,1,0,0,0,0,10,540254,-918,-5,-2,2,-3,0,0,-29,-1,0
KR_7772308453,16400,16999,254,268,8,7,7,8,11,7,0,1,0,0,136,19,3,4,1,1,1,0,0,1,0,0,10,540189,-599,-14,1,-1,4,-1,0,117,-1,0
KR_7772313333,16036,13557,267,282,7,1,1,9,10,3,0,1,0,0,41,13,3,7,0,0,1,0,0,1,0,0,10,540213,2479,-15,6,-8,7,-1,0,28,-4,0
KR_7772314337,15020,14636,290,290,3,3,3,3,2,1,0,1,0,0,20,20,2,4,1,1,0,1,0,1,0,0,10,540249,384,0,0,0,1,-1,0,0,-2,0
KR_7772319574,15240,14530,266,236,5,7,7,6,6,3,0,0,0,0,17,16,2,1,0,0,0,1,0,0,0,0,10,540261,710,30,-2,1,3,0,0,1,1,0
KR_7772321008,16484,15458,277,276,7,5,5,7,14,7,0,1,0,0,39,15,4,5,1,0,1,0,0,1,0,0,10,540223,1026,1,2,-2,7,-1,0,24,-1,1
KR_7772321887,14324,18789,242,237,4,14,14,5,4,20,1,0,0,0,13,14,1,1,3,4,1,0,1,0,0,0,10,540267,-4465,5,-10,9,-16,1,0,-1,0,-1
KR_7772321976,15214,14795,278,250,5,5,5,5,5,7,0,1,0,0,21,12,2,5,0,0,1,0,0,1,0,0,10,540235,419,28,0,0,-2,-1,0,9,-3,0
KR_7772322195,14326,17020,238,262,3,11,11,3,5,10,0,1,0,0,124,17,3,1,0,2,0,1,0,1,0,0,10,540234,-2694,-24,-8,8,-5,-1,0,107,2,-2
KR_7772325056,15242,14684,237,234,7,6,6,7,6,4,0,1,0,0,112,55,2,3,0,1,0,1,0,1,0,0,10,540203,558,3,1,-1,2,-1,0,57,-1,-1
KR_7772333681,14539,14415,260,263,5,3,4,5,5,3,0,0,0,0,17,143,3,3,0,1,1,0,0,0,0,0,10,540218,124,-3,2,-1,2,0,0,-126,0,-1
KR_7772334227,16930,16498,261,259,9,7,7,9,11,13,0,0,0,0,18,15,1,2,0,1,1,0,0,0,0,0,10,540277,432,2,2,-2,-2,0,0,3,-1,-1
KR_7772334652,15895,14873,252,244,8,5,5,8,11,6,0,0,0,0,14,13,1,2,1,0,1,0,0,0,0,0,10,540193,1022,8,3,-3,5,0,0,1,-1,1
KR_7772339164,13490,15192,278,307,0,3,3,0,0,1,1,0,0,0,48,17,3,6,1,0,0,1,1,0,0,0,10,540236,-1702,-29,-3,3,-1,1,0,31,-3,1
KR_7772339187,15939,15068,271,301,7,3,3,7,6,2,0,0,0,0,24,14,3,6,3,1,1,0,0,0,0,0,10,540222,871,-30,4,-4,4,0,0,10,-3,2
KR_7772340699,18877,15494,211,222,15,6,6,15,22,7,0,0,0,0,15,10,1,3,4,1,1,0,0,0,0,0,10,540187,3383,-11,9,-9,15,0,0,5,-2,3
KR_7772350501,15353,15439,232,269,7,5,5,7,6,6,0,0,0,0,21,19,5,1,0,2,0,1,0,0,0,0,10,540251,-86,-37,2,-2,0,0,0,2,4,-2
KR_7772352662,16522,15598,231,237,10,7,7,10,10,7,0,0,0,0,18,120,5,3,0,0,0,1,0,0,0,0,10,540236,924,-6,3,-3,3,0,0,-102,2,0
KR_7772353050,14450,16429,260,260,3,10,10,3,3,8,0,1,0,0,16,16,2,6,1,0,0,1,0,1,0,0,10,540289,-1979,0,-7,7,-5,-1,0,0,-4,1
KR_7772356218,14821,13862,264,270,5,2,2,5,3,3,0,1,0,0,16,106,2,2,1,0,1,0,0,1,0,0,10,540267,959,-6,3,-3,0,-1,0,-90,0,1
KR_7772358105,18606,15556,280,246,11,5,5,11,14,9,0,1,0,0,113,50,1,6,3,0,1,0,0,1,0,0,10,540224,3050,34,6,-6,5,-1,0,63,-5,3
