blue_gold,red_gold,blue_cs,red_cs,blue_kills,red_kills,blue_deaths,red_deaths,blue_assists,red_assists,blue_dragons,red_dragons,blue_wards_placed,red_wards_placed,blue_wards_killed,red_wards_killed,blue_towerplates,red_towerplates,first_blood_blue,first_blood_red,first_dragon_blue,first_dragon_red,first_tower_blue,first_tower_red,gold_diff,cs_diff,kill_diff,death_diff,assist_diff,herald_diff,wards_placed_diff,wards_killed_diff,towerplates_diff,blue_mean_level,red_mean_level,diff_mean_level,blue_level7_count,red_level7_count,diff_level7_count,target
15546,16015,236,245,6,8,8,7,6,7,0,0,16,17,3,1,1,3,0,1,0,0,0,0,-469,-9,-2,1,-1,0,-1,2,-2,37.4,95.8,-58.4,5,4,1,1
13928,14282,260,267,2,2,2,2,4,2,0,0,36,18,3,4,0,2,1,0,0,0,0,0,-354,-7,0,0,2,0,18,-1,-2,27.8,70,-42.2,5,4,1,1
16468,13916,276,267,8,2,2,9,14,2,0,0,15,17,2,2,2,0,1,0,0,0,0,0,2552,9,6,-7,12,0,-2,0,2,53.8,26.6,27.2,4,4,0,1
15741,16862,278,281,6,10,10,6,4,10,1,0,16,15,3,3,0,0,1,0,1,0,0,0,-1121,-3,-4,4,-6,0,1,0,0,65.4,25.8,39.6,4,4,0,1
16730,15794,263,233,9,7,7,9,9,13,0,1,19,18,3,1,2,1,1,0,0,1,0,0,936,30,2,-2,-4,0,1,2,1,114.6,25.6,89,5,5,0,0
17682,14627,292,261,7,5,5,7,7,3,0,0,112,15,3,3,2,0,1,0,0,0,0,0,3055,31,2,-2,4,0,97,0,2,66.2,35.8,30.4,5,3,2,0
16886,14375,278,278,7,2,2,7,8,1,0,0,21,21,4,5,0,4,1,0,0,0,0,0,2511,0,5,-5,7,0,0,-1,-4,81,96.4,-15.4,4,4,0,1
15075,14709,304,289,3,3,3,3,3,5,0,0,16,14,4,2,0,0,0,1,0,0,0,0,366,15,0,0,-2,0,2,2,0,88.4,19.8,68.6,3,3,0,1
13632,15298,267,300,2,4,4,2,3,5,0,1,15,12,2,1,0,0,1,0,0,1,0,0,-1666,-33,-2,2,-2,0,3,1,0,94.8,66.8,28,5,5,0,0
15876,13621,251,252,7,2,2,7,14,3,1,0,13,39,6,2,1,0,1,0,1,0,0,0,2255,-1,5,-5,11,0,-26,4,1,39.4,10.8,28.6,5,4,1,0
17475,14644,219,253,13,3,3,13,23,3,0,0,20,15,5,2,0,2,1,0,0,0,0,0,2831,-34,10,-10,20,0,5,3,-2,88.2,42.6,45.6,4,5,-1,0
15236,17316,289,278,4,10,10,4,5,14,0,1,14,14,1,6,1,1,0,1,0,1,0,0,-2080,11,-6,6,-9,0,0,-5,0,19,57.8,-38.8,3,5,-2,0
16179,13585,240,283,10,1,1,10,11,0,0,0,20,13,3,3,2,0,1,0,0,0,0,0,2594,-43,9,-9,11,0,7,0,2,106.4,14.2,92.2,4,4,0,1
16152,16678,246,229,8,10,10,8,10,11,0,0,11,24,3,2,1,1,1,0,0,0,0,0,-526,17,-2,2,-1,0,-13,1,0,37.6,28.2,9.4,4,5,-1,0
18467,13530,272,224,13,3,3,13,12,2,0,0,28,11,2,3,3,0,1,0,0,0,0,0,4937,48,10,-10,10,0,17,-1,3,79.8,35.2,44.6,5,5,0,1
13510,20449,234,261,3,18,18,3,7,31,1,0,17,20,2,2,0,2,1,0,1,0,0,0,-6939,-27,-15,15,-24,0,-3,0,-2,25.4,20.2,5.2,4,4,0,0
19145,13977,265,216,15,4,4,15,23,9,0,0,26,19,5,3,1,0,1,0,0,0,0,0,5168,49,11,-11,14,0,7,2,1,54.6,31.6,23,3,2,1,1
15886,15688,262,258,6,8,8,6,10,4,0,1,11,16,3,1,0,0,0,1,0,1,0,0,198,4,-2,2,6,0,-5,2,0,11.8,22.2,-10.4,5,5,0,1
16764,15593,274,234,9,7,7,9,8,8,0,0,18,19,3,5,1,0,1,0,0,0,0,0,1171,40,2,-2,0,0,-1,-2,1,30.4,12.2,18.2,5,3,2,1
15439,16696,268,224,4,10,10,4,3,17,0,0,16,47,4,4,3,0,0,1,0,0,0,0,-1257,44,-6,6,-14,0,-31,0,3,12.6,101.2,-88.6,4,3,1,0
13709,15016,300,303,1,3,3,1,0,3,1,0,18,18,7,7,0,0,0,1,1,0,0,0,-1307,-3,-2,2,-3,0,0,0,0,39.4,13.4,26,5,4,1,0
17641,14286,292,248,9,4,4,9,9,2,0,0,20,15,3,3,6,0,1,0,0,0,0,0,3355,44,5,-5,7,0,5,0,6,17.6,26.2,-8.6,4,3,1,1
13664,14326,279,282,1,2,2,1,1,2,0,0,16,18,4,5,0,0,1,0,0,0,0,0,-662,-3,-1,1,-1,0,-2,-1,0,51,23.8,27.2,3,4,-1,1
15196,14472,289,309,5,1,1,5,5,1,1,0,17,19,6,2,0,1,1,0,1,0,0,0,724,-20,4,-4,4,0,-2,4,-1,73.6,80,-6.4,5,5,0,1
14858,15104,269,280,3,4,4,3,4,5,0,0,22,20,6,5,0,2,1,0,0,0,0,0,-246,-11,-1,1,-1,0,2,1,-2,78.8,20.4,58.4,4,5,-1,0
16329,17004,260,241,10,9,9,10,10,17,0,1,16,14,4,3,0,2,0,1,0,1,0,0,-675,19,1,-1,-7,0,2,1,-2,26.6,12,14.6,3,2,1,0
16036,16146,251,247,9,6,6,9,5,7,0,0,17,16,2,7,0,1,1,0,0,0,0,0,-110,4,3,-3,-2,0,1,-5,-1,17.8,30.2,-12.4,4,3,1,1
17161,15478,224,215,12,7,7,12,10,4,0,0,16,36,4,6,2,0,1,0,0,0,0,0,1683,9,5,-5,6,0,-20,-2,2,25.4,32.8,-7.4,3,5,-2,1
14856,13810,234,254,7,2,2,7,8,1,0,0,17,24,5,2,0,0,1,0,0,0,0,0,1046,-20,5,-5,7,0,-7,3,0,59.4,67.4,-8,4,5,-1,1
15102,13788,307,276,2,2,2,2,2,1,0,1,21,20,6,2,1,0,1,0,0,1,0,0,1314,31,0,0,1,0,1,4,1,48.4,9.4,39,3,3,0,1
17696,16193,271,249,10,9,9,10,11,8,0,0,16,12,1,2,1,0,1,0,0,0,0,0,1503,22,1,-1,3,0,4,-1,1,52,24,28,3,5,-2,1
17637,15747,305,288,8,4,4,8,12,5,1,0,27,15,5,4,1,1,0,1,1,0,0,0,1890,17,4,-4,7,0,12,1,0,16.8,13.8,3,4,5,-1,1
15403,15474,277,242,5,6,6,5,3,5,1,0,15,14,3,1,2,0,1,0,1,0,0,0,-71,35,-1,1,-2,0,1,2,2,11.4,27,-15.6,4,4,0,0
17240,13394,269,249,10,2,2,10,10,1,0,0,17,14,4,5,3,0,1,0,0,0,0,0,3846,20,8,-8,9,0,3,-1,3,90.8,32.8,58,3,4,-1,1
14930,17268,243,238,4,10,10,4,4,14,0,0,17,14,1,5,0,1,0,1,0,0,0,0,-2338,5,-6,6,-10,0,3,-4,-1,13.4,41.6,-28.2,4,3,1,0
13953,14962,283,286,1,3,3,1,1,4,0,1,16,46,2,5,1,1,0,1,0,1,0,0,-1009,-3,-2,2,-3,0,-30,-3,0,30.4,15.8,14.6,4,3,1,0
17157,15075,274,292,8,3,3,8,11,3,0,0,17,31,6,4,1,0,1,0,0,0,0,0,2082,-18,5,-5,8,0,-14,2,1,50.4,84.2,-33.8,5,4,1,1
15774,15190,254,266,6,4,4,6,9,5,0,1,15,18,1,0,1,0,1,0,0,1,0,0,584,-12,2,-2,4,0,-3,1,1,39.8,21.6,18.2,5,4,1,1
16142,16655,263,265,7,8,8,7,10,12,0,0,19,14,2,2,0,0,0,1,0,0,0,0,-513,-2,-1,1,-2,0,5,0,0,31.6,75.8,-44.2,5,5,0,0
15078,16114,265,268,5,8,8,5,7,9,0,1,40,14,1,2,2,0,1,0,0,1,0,0,-1036,-3,-3,3,-2,0,26,-1,2,109,25.6,83.4,5,4,1,0
11987,16688,192,268,1,9,9,1,0,11,0,1,30,22,0,4,0,2,0,1,0,1,0,0,-4701,-76,-8,8,-11,0,8,-4,-2,32,63.4,-31.4,5,5,0,0
15571,16239,273,295,5,7,7,5,5,6,0,1,19,18,4,3,0,1,0,1,0,1,0,0,-668,-22,-2,2,-1,0,1,1,-1,82,21.2,60.8,5,2,3,0
15999,16044,252,227,7,8,8,7,11,13,0,0,38,20,4,2,0,0,0,1,0,0,0,0,-45,25,-1,1,-2,0,18,2,0,22.8,85.8,-63,5,4,1,1
15252,14576,294,273,4,3,3,4,6,4,0,0,15,15,4,3,0,0,0,1,0,0,0,0,676,21,1,-1,2,0,0,1,0,55.8,14.8,41,5,4,1,1
14677,15648,287,307,2,4,4,2,1,2,0,0,22,13,3,5,2,1,0,1,0,0,0,0,-971,-20,-2,2,-1,0,9,-2,1,61.8,22.4,39.4,4,3,1,0
14861,13196,284,253,3,1,1,3,2,1,1,0,16,14,3,3,1,0,1,0,1,0,0,0,1665,31,2,-2,1,0,2,0,1,36.6,19.2,17.4,4,5,-1,0
14636,15741,291,260,3,7,7,3,3,8,0,1,15,38,6,3,2,2,0,1,0,1,0,0,-1105,31,-4,4,-5,0,-23,3,0,61.6,77.6,-16,4,4,0,1
16400,14539,287,231,9,4,4,9,6,2,0,0,21,18,4,2,0,0,1,0,0,0,0,0,1861,56,5,-5,4,0,3,2,0,14,116.6,-102.6,1,5,-4,1
15880,15648,249,265,8,6,6,8,8,6,0,0,16,18,2,0,1,0,1,0,0,0,0,0,232,-16,2,-2,2,0,-2,2,1,47.4,15,32.4,4,3,1,1
14663,15523,269,266,5,6,6,5,2,6,0,0,17,16,8,4,0,0,1,0,0,0,0,0,-860,3,-1,1,-4,0,1,4,0,22.6,23.4,-0.8,4,5,-1,1
14616,14483,287,284,3,3,3,3,3,5,0,0,21,16,1,2,1,0,1,0,0,0,0,0,133,3,0,0,-2,0,5,-1,1,16.2,37,-20.8,4,4,0,0
15380,17707,257,271,5,9,9,6,5,10,0,1,19,31,2,4,1,2,0,1,0,1,0,0,-2327,-14,-4,3,-5,0,-12,-2,-1,25.4,24.2,1.2,4,5,-1,1
14146,15149,267,257,3,6,6,3,2,7,0,1,22,17,3,1,0,0,0,1,0,1,0,0,-1003,10,-3,3,-5,0,5,2,0,78.4,18.4,60,5,4,1,0
15266,16274,250,247,6,9,9,6,6,17,0,0,14,18,2,5,1,1,1,0,0,0,0,0,-1008,3,-3,3,-11,0,-4,-3,0,16,18.4,-2.4,4,4,0,0
14004,16203,244,271,3,6,6,3,3,5,1,0,19,17,1,4,2,3,1,0,1,0,0,0,-2199,-27,-3,3,-2,0,2,-3,-1,13.8,23.8,-10,3,5,-2,0
13940,15512,234,262,5,6,6,5,5,5,0,0,16,25,3,1,0,1,1,0,0,0,0,0,-1572,-28,-1,1,0,0,-9,2,-1,60.6,14.8,45.8,4,3,1,1
14959,14843,262,267,5,4,4,5,4,4,0,1,16,16,2,4,0,2,0,1,0,1,0,0,116,-5,1,-1,0,0,0,-2,-2,17.4,10.8,6.6,3,3,0,0
14763,16886,245,268,4,8,9,4,4,15,0,0,19,20,3,1,1,2,1,0,0,0,0,0,-2123,-23,-4,5,-11,0,-1,2,-1,24.4,19.4,5,4,5,-1,1
15538,14919,286,293,5,3,3,5,5,3,0,0,19,32,8,3,0,2,1,0,0,0,0,0,619,-7,2,-2,2,0,-13,5,-2,35.2,53.6,-18.4,5,4,1,1
16684,14896,285,285,7,4,4,7,11,2,1,0,19,18,2,4,2,0,0,1,1,0,0,0,1788,0,3,-3,9,0,1,-2,2,27,106.8,-79.8,3,4,-1,0
15341,17053,249,259,4,8,8,4,9,15,0,0,18,16,1,8,2,4,1,0,0,0,0,0,-1712,-10,-4,4,-6,0,2,-7,-2,24.8,135.6,-110.8,4,4,0,1
14631,15592,264,258,3,5,5,3,5,11,0,0,17,15,1,1,3,2,0,1,0,0,0,0,-961,6,-2,2,-6,0,2,0,1,51.2,26.4,24.8,4,5,-1,0
15851,15668,230,279,8,5,5,8,9,2,0,0,18,19,3,2,2,2,1,0,0,0,0,0,183,-49,3,-3,7,0,-1,1,0,31.8,14.8,17,3,4,-1,0
16119,15102,228,248,9,5,5,9,16,10,0,0,18,22,6,4,0,0,1,0,0,0,0,0,1017,-20,4,-4,6,0,-4,2,0,40,13.8,26.2,5,4,1,0
16164,14692,282,261,7,4,4,7,5,5,1,0,17,18,4,3,1,0,1,0,1,0,0,0,1472,21,3,-3,0,0,-1,1,1,89.6,27.6,62,5,4,1,0
17005,15038,294,274,5,4,4,5,7,9,0,1,113,23,4,2,4,0,1,0,0,1,1,0,1967,20,1,-1,-2,0,90,2,4,69.2,29.2,40,5,5,0,0
15053,14492,291,260,3,3,3,3,7,4,0,0,18,20,2,3,1,0,1,0,0,0,0,0,561,31,0,0,3,0,-2,-1,1,69,21.2,47.8,5,4,1,1
16948,14422,268,249,8,3,3,8,10,5,0,1,14,17,3,3,0,2,1,0,0,1,0,0,2526,19,5,-5,5,0,-3,0,-2,119.4,87.8,31.6,4,5,-1,1
13766,14486,290,269,1,3,3,1,2,3,1,0,33,13,2,2,0,1,0,1,1,0,0,0,-720,21,-2,2,-1,0,20,0,-1,16.4,21,-4.6,2,5,-3,1
15166,14464,228,274,7,3,3,7,6,2,0,0,16,13,1,2,0,0,1,0,0,0,0,0,702,-46,4,-4,4,0,3,-1,0,56.8,43.2,13.6,2,4,-2,0
15164,15416,253,278,5,5,5,5,5,4,0,1,13,9,2,4,0,4,0,1,0,1,0,0,-252,-25,0,0,1,0,4,-2,-4,24.4,39.2,-14.8,4,4,0,0
17189,15388,238,264,11,6,6,11,10,11,1,0,17,16,2,1,1,0,0,1,1,0,0,0,1801,-26,5,-5,-1,0,1,1,1,17.4,14,3.4,3,4,-1,1
16525,15098,276,260,8,5,5,8,6,8,1,0,17,12,1,2,2,0,1,0,1,0,0,0,1427,16,3,-3,-2,0,5,-1,2,36.8,21.2,15.6,4,4,0,1
6683,5432,91,68,2,1,1,2,4,0,0,0,7,3,0,0,1,0,1,0,0,0,0,0,1251,23,1,-1,4,0,4,0,1,57.4,15.8,41.6,5,4,1,1
17515,13688,247,235,12,3,3,12,13,2,0,0,15,14,3,1,3,0,1,0,0,0,0,0,3827,12,9,-9,11,0,1,2,3,13.2,50,-36.8,4,4,0,1
16164,15135,249,257,9,5,5,9,16,7,0,0,20,22,2,5,1,0,0,1,0,0,0,0,1029,-8,4,-4,9,0,-2,-3,1,73.8,11.2,62.6,5,4,1,1
17148,15620,274,239,10,6,6,10,15,7,1,0,16,17,6,2,0,0,1,0,1,0,0,0,1528,35,4,-4,8,0,-1,4,0,13,22,-9,5,4,1,1
14624,17092,265,296,5,6,6,5,5,10,0,1,16,16,1,5,0,2,1,0,0,1,0,0,-2468,-31,-1,1,-5,0,0,-4,-2,34.6,49,-14.4,5,5,0,0
16281,14259,259,227,8,4,4,8,14,6,0,0,16,13,2,2,3,2,1,0,0,0,0,0,2022,32,4,-4,8,0,3,0,1,41.4,49.8,-8.4,4,3,1,0
15922,14210,273,291,6,2,2,6,7,0,1,0,22,17,3,2,0,0,1,0,1,0,0,0,1712,-18,4,-4,7,0,5,1,0,87,12,75,4,3,1,1
16259,15131,270,254,8,6,6,8,8,6,0,0,15,14,5,1,0,1,1,0,0,0,0,0,1128,16,2,-2,2,0,1,4,-1,104.2,13.6,90.6,4,4,0,1
15356,14089,302,275,3,3,3,3,3,3,0,1,17,16,4,3,1,0,0,1,0,1,0,0,1267,27,0,0,0,0,1,1,1,50.8,55.2,-4.4,4,5,-1,0
15578,15085,254,232,8,5,5,8,7,3,0,0,17,13,2,1,1,2,1,0,0,0,0,0,493,22,3,-3,4,0,4,1,-1,65.4,17.6,47.8,5,5,0,0
16431,15993,264,290,6,6,6,6,9,9,1,0,33,15,6,3,2,1,0,1,1,0,0,0,438,-26,0,0,0,0,18,3,1,31.8,19.6,12.2,4,4,0,1
13965,15064,244,281,4,4,4,4,3,4,0,0,17,115,1,4,0,1,1,0,0,0,0,0,-1099,-37,0,0,-1,0,-98,-3,-1,15.4,35.2,-19.8,4,4,0,0
15529,14679,232,214,7,6,6,7,13,8,0,0,17,18,2,1,0,0,0,1,0,0,0,0,850,18,1,-1,5,0,-1,1,0,21.2,16.8,4.4,4,3,1,1
15286,13768,290,271,5,2,3,5,3,2,0,1,15,16,1,1,0,0,1,0,0,1,0,0,1518,19,3,-2,1,0,-1,0,0,36,21.8,14.2,4,4,0,1
15985,15931,268,236,7,7,7,7,4,7,0,0,15,14,4,3,1,0,1,0,0,0,0,0,54,32,0,0,-3,0,1,1,1,32.2,91.4,-59.2,5,4,1,1
15675,15668,256,283,7,5,5,7,10,5,1,0,25,17,3,4,0,1,1,0,1,0,0,0,7,-27,2,-2,5,0,8,-1,-1,24,52.4,-28.4,5,5,0,1
14866,14008,253,258,5,3,3,5,5,5,0,1,13,23,5,3,1,1,1,0,0,1,0,0,858,-5,2,-2,0,0,-10,2,0,28,82.6,-54.6,3,4,-1,0
18446,16021,270,240,13,7,7,13,13,10,1,0,21,13,1,5,3,0,1,0,1,0,0,0,2425,30,6,-6,3,0,8,-4,3,47.2,12.8,34.4,5,3,2,1
16906,16235,249,222,10,9,9,10,16,10,1,0,18,18,2,5,1,0,1,0,1,0,0,0,671,27,1,-1,6,0,0,-3,1,38,28.2,9.8,5,3,2,1
17313,14733,243,259,11,4,4,11,11,3,0,0,21,16,4,2,0,0,1,0,0,0,0,0,2580,-16,7,-7,8,0,5,2,0,45.8,56.6,-10.8,3,4,-1,1
15182,16169,291,257,4,7,7,4,4,11,1,0,18,33,5,4,0,1,1,0,1,0,0,0,-987,34,-3,3,-7,0,-15,1,-1,28,22.6,5.4,5,4,1,1
14621,17844,273,299,4,8,8,4,4,6,0,1,18,42,4,4,0,2,0,1,0,1,0,0,-3223,-26,-4,4,-2,0,-24,0,-2,52.2,42.2,10,4,4,0,0
16400,15842,237,257,10,6,6,10,8,5,0,0,14,13,3,1,0,2,1,0,0,0,0,0,558,-20,4,-4,3,0,1,2,-2,60.2,21.4,38.8,3,4,-1,1
17421,14762,257,255,11,4,4,11,14,4,0,0,16,29,2,5,1,0,1,0,0,0,0,0,2659,2,7,-7,10,0,-13,-3,1,92.6,26.6,66,3,4,-1,1
16306,18316,284,272,6,11,11,6,9,21,0,1,15,36,5,1,1,1,0,1,0,1,0,0,-2010,12,-5,5,-12,0,-21,4,0,28.8,85.6,-56.8,4,4,0,0
15595,16774,297,296,5,6,6,5,3,8,0,0,16,38,4,4,0,0,0,1,0,0,0,0,-1179,1,-1,1,-5,0,-22,0,0,39.2,65.4,-26.2,4,5,-1,1
15707,15837,291,274,5,6,6,5,6,11,0,1,15,20,2,4,0,1,1,0,0,1,0,0,-130,17,-1,1,-5,0,-5,-2,-1,22.4,55.8,-33.4,4,5,-1,1
16387,18324,255,265,7,13,13,7,5,16,0,1,13,18,3,3,1,0,0,1,0,1,0,0,-1937,-10,-6,6,-11,0,-5,0,1,124.6,50.6,74,5,5,0,0
16243,13472,296,288,5,0,0,5,6,0,1,0,18,14,2,6,1,1,1,0,1,0,0,0,2771,8,5,-5,6,0,4,-4,0,67.8,187.2,-119.4,4,3,1,1
15877,15112,253,265,6,5,5,6,7,9,0,0,16,19,3,5,1,0,1,0,0,0,0,0,765,-12,1,-1,-2,0,-3,-2,1,44.8,105.6,-60.8,4,5,-1,1
14815,16208,259,294,4,5,5,4,4,6,0,1,18,14,3,1,0,2,0,1,0,1,0,0,-1393,-35,-1,1,-2,0,4,2,-2,47.6,36.2,11.4,4,4,0,0
16252,14910,262,254,8,5,5,8,10,11,0,1,23,50,0,3,1,0,1,0,0,1,0,0,1342,8,3,-3,-1,0,-27,-3,1,16.6,66.4,-49.8,5,5,0,1
15722,15764,274,289,6,5,5,6,5,7,1,0,14,19,5,3,2,1,1,0,1,0,0,0,-42,-15,1,-1,-2,0,-5,2,1,72.6,13.8,58.8,5,3,2,1
15844,14354,298,308,4,1,1,4,10,3,0,1,17,92,4,5,0,3,1,0,0,1,0,0,1490,-10,3,-3,7,0,-75,-1,-3,138.4,32.6,105.8,5,4,1,1
15569,15444,232,276,8,7,7,8,9,2,0,0,14,188,3,2,0,0,0,1,0,0,0,0,125,-44,1,-1,7,0,-174,1,0,60.6,74,-13.4,5,5,0,1
16885,15973,256,252,8,6,6,8,11,6,0,0,16,22,7,4,0,2,0,1,0,0,0,0,912,4,2,-2,5,0,-6,3,-2,78.4,46.8,31.6,4,3,1,0
15957,15603,283,266,7,6,7,8,6,7,0,1,19,109,0,3,0,0,1,0,0,1,0,0,354,17,1,-1,-1,0,-90,-3,0,31.6,56.2,-24.6,4,4,0,0
14278,17352,230,265,5,12,12,5,4,10,1,0,12,164,3,3,0,3,0,1,1,0,0,0,-3074,-35,-7,7,-6,0,-152,0,-3,45.2,39.4,5.8,5,5,0,0
14789,16178,240,241,5,8,8,5,10,10,0,0,23,19,2,0,1,0,0,1,0,0,0,0,-1389,-1,-3,3,0,0,4,2,1,58.6,26.4,32.2,4,4,0,0
15314,15147,264,270,6,5,5,6,10,6,1,0,17,18,6,2,0,0,1,0,1,0,0,0,167,-6,1,-1,4,0,-1,4,0,67.6,38.6,29,5,4,1,1
14457,15145,293,294,2,4,4,2,3,8,0,0,14,16,4,5,0,0,1,0,0,0,0,0,-688,-1,-2,2,-5,0,-2,-1,0,60,17,43,5,5,0,0
17342,16757,291,282,8,8,8,8,9,7,0,0,15,101,2,5,2,0,1,0,0,0,0,0,585,9,0,0,2,0,-86,-3,2,17.8,66.2,-48.4,3,4,-1,1
14749,16135,264,254,5,7,7,5,3,10,1,0,18,14,3,2,0,4,0,1,1,0,0,0,-1386,10,-2,2,-7,0,4,1,-4,69.8,27.8,42,5,3,2,0
15620,16428,272,263,5,8,8,6,8,10,0,0,32,43,1,4,0,2,0,1,0,0,0,0,-808,9,-3,2,-2,0,-11,-3,-2,21.4,71.6,-50.2,4,4,0,0
14153,15054,252,253,3,6,7,3,3,15,0,1,15,16,2,3,1,1,0,1,0,1,0,0,-901,-1,-3,4,-12,0,-1,-1,0,31,22.8,8.2,5,5,0,0
15069,15680,251,226,5,7,7,6,4,13,0,0,18,16,4,3,1,0,0,1,0,0,0,0,-611,25,-2,1,-9,0,2,1,1,69.2,29.6,39.6,5,4,1,1
14355,15422,225,255,5,6,6,5,7,6,0,0,18,20,2,1,0,3,0,1,0,0,0,0,-1067,-30,-1,1,1,0,-2,1,-3,116,63,53,5,4,1,0
14588,15474,244,248,4,6,6,4,6,7,1,0,12,18,7,2,0,3,0,1,1,0,0,0,-886,-4,-2,2,-1,0,-6,5,-3,113.2,18.8,94.4,4,4,0,0
16438,13772,267,252,8,2,2,8,8,1,0,0,20,13,3,3,1,0,1,0,0,0,0,0,2666,15,6,-6,7,0,7,0,1,58.2,65.4,-7.2,4,5,-1,1
15083,14246,281,276,3,3,3,3,4,3,0,0,18,23,5,2,2,0,0,1,0,0,0,0,837,5,0,0,1,0,-5,3,2,87.8,127.4,-39.6,5,5,0,0
15384,14478,242,279,6,3,3,6,12,9,0,1,15,20,4,7,0,0,1,0,0,1,0,0,906,-37,3,-3,3,0,-5,-3,0,50.8,88,-37.2,4,4,0,1
16039,14158,261,262,8,3,3,8,13,5,0,1,40,14,3,10,1,2,0,1,0,1,0,0,1881,-1,5,-5,8,0,26,-7,-1,14,15.2,-1.2,4,4,0,1
17010,14808,276,259,9,4,4,9,13,2,0,0,35,18,4,5,0,0,1,0,0,0,0,0,2202,17,5,-5,11,0,17,-1,0,22.4,34.6,-12.2,5,5,0,0
16979,14825,247,281,11,3,3,11,11,3,0,0,18,15,3,4,0,0,1,0,0,0,0,0,2154,-34,8,-8,8,0,3,-1,0,57.4,54.8,2.6,5,5,0,0
14646,15373,263,285,4,5,5,4,6,4,0,1,15,14,2,4,2,0,0,1,0,1,0,0,-727,-22,-1,1,2,0,1,-2,2,143.2,35.2,108,5,4,1,0
15885,13891,280,269,5,2,2,5,7,4,1,0,13,17,3,0,1,0,0,1,1,0,0,0,1994,11,3,-3,3,0,-4,3,1,62.8,12.6,50.2,5,5,0,1
15422,15246,289,293,5,5,5,5,5,5,0,0,21,15,4,3,0,0,0,1,0,0,0,0,176,-4,0,0,0,0,6,1,0,58.6,50.8,7.8,4,5,-1,0
15093,14131,249,259,6,3,3,6,7,3,0,0,34,16,9,0,0,0,1,0,0,0,0,0,962,-10,3,-3,4,0,18,9,0,84,61.6,22.4,4,4,0,0
14493,13635,297,286,2,1,1,2,1,1,1,0,20,18,4,1,1,0,0,1,1,0,0,0,858,11,1,-1,0,0,2,3,1,38.8,79.2,-40.4,5,4,1,0
15718,16160,290,274,6,6,6,6,8,6,0,0,17,19,9,3,1,0,1,0,0,0,0,0,-442,16,0,0,2,0,-2,6,1,57.6,51.8,5.8,5,5,0,1
2525,2549,0,0,0,0,0,0,0,0,0,0,2,4,0,0,0,0,0,0,0,0,0,0,-24,0,0,0,0,0,-2,0,0,23,87.4,-64.4,3,5,-2,0
14802,15425,263,283,4,4,4,4,9,7,0,0,15,16,5,4,1,3,1,0,0,0,0,0,-623,-20,0,0,2,0,-1,1,-2,21.8,16.8,5,3,2,1,0
14504,13974,217,232,6,3,3,6,5,5,0,0,17,16,5,0,0,3,1,0,0,0,0,0,530,-15,3,-3,0,0,1,5,-3,52.6,51.4,1.2,4,4,0,1
14528,13935,284,281,2,2,2,2,1,1,1,0,14,127,3,6,0,0,0,1,1,0,0,0,593,3,0,0,0,0,-113,-3,0,45,32.8,12.2,5,4,1,1
16306,15402,268,248,8,5,5,8,6,7,0,0,30,15,2,3,0,2,1,0,0,0,0,0,904,20,3,-3,-1,0,15,-1,-2,49.4,21.6,27.8,3,5,-2,1
15500,14026,272,261,6,2,2,6,8,3,1,0,15,19,1,2,0,0,0,1,1,0,0,0,1474,11,4,-4,5,0,-4,-1,0,104.2,41.4,62.8,5,4,1,1
14283,15620,263,292,3,4,4,3,3,5,0,0,15,14,3,3,0,0,0,1,0,0,0,0,-1337,-29,-1,1,-2,0,1,0,0,62,34.4,27.6,3,2,1,0
15690,14778,301,272,4,3,3,4,6,5,0,0,13,21,2,2,2,0,1,0,0,0,0,0,912,29,1,-1,1,0,-8,0,2,25.2,95,-69.8,5,3,2,1
16328,14685,299,281,6,3,3,6,6,5,0,0,17,13,3,3,2,1,1,0,0,0,0,0,1643,18,3,-3,1,0,4,0,1,30.4,11.8,18.6,3,3,0,1
15880,14491,289,252,7,4,5,7,8,3,0,0,15,28,4,4,0,0,1,0,0,0,0,0,1389,37,3,-2,5,0,-13,0,0,46,11.8,34.2,4,4,0,1
16511,12925,267,240,8,2,2,8,9,0,1,0,17,10,2,1,2,0,1,0,1,0,0,0,3586,27,6,-6,9,0,7,1,2,113.2,144.4,-31.2,4,4,0,1
14534,15542,282,265,4,6,6,4,0,8,0,1,18,11,1,6,0,0,0,1,0,1,0,0,-1008,17,-2,2,-8,0,7,-5,0,63.4,86.2,-22.8,4,5,-1,0
14395,16398,259,255,2,8,8,2,2,7,0,0,290,17,2,2,0,1,0,1,0,0,0,0,-2003,4,-6,6,-5,0,273,0,-1,96.8,27.6,69.2,5,3,2,0
16393,13961,270,256,9,2,2,9,13,3,0,1,15,17,4,2,2,3,1,0,0,1,0,0,2432,14,7,-7,10,0,-2,2,-1,27.6,40.2,-12.6,2,4,-2,1
16142,14331,253,279,8,2,2,8,16,3,0,0,20,13,4,5,1,1,1,0,0,0,0,0,1811,-26,6,-6,13,0,7,-1,0,49.2,81.6,-32.4,3,4,-1,1
14456,15669,242,250,5,7,7,5,11,9,0,0,25,15,3,1,1,0,0,1,0,0,0,0,-1213,-8,-2,2,2,0,10,2,1,46.2,81.6,-35.4,4,5,-1,0
15078,13927,258,291,5,1,1,5,7,1,0,1,47,113,3,4,0,1,1,0,0,1,0,0,1151,-33,4,-4,6,0,-66,-1,-1,115,98.6,16.4,5,4,1,0
15978,15032,248,259,8,5,5,8,13,3,0,0,17,16,2,3,0,0,0,1,0,0,0,0,946,-11,3,-3,10,0,1,-1,0,23.4,25.2,-1.8,5,3,2,1
15127,13374,251,227,7,3,3,7,10,5,0,1,35,41,9,4,0,1,1,0,0,1,0,0,1753,24,4,-4,5,0,-6,5,-1,16.2,29,-12.8,3,4,-1,1
14710,15949,274,308,3,4,4,5,5,3,1,0,14,14,1,4,1,3,1,0,1,0,0,0,-1239,-34,-1,-1,2,0,0,-3,-2,34.2,34,0.2,3,3,0,0
16978,15447,239,227,11,8,8,11,10,12,1,0,203,14,0,3,2,0,0,1,1,0,0,0,1531,12,3,-3,-2,0,189,-3,2,110.4,12,98.4,4,4,0,1
15392,15794,227,243,8,8,8,8,13,10,1,0,16,33,1,2,0,1,1,0,1,0,0,0,-402,-16,0,0,3,0,-17,-1,-1,12.8,16,-3.2,4,4,0,1
16655,14831,260,263,9,4,4,9,6,4,0,0,51,21,3,3,1,0,1,0,0,0,0,0,1824,-3,5,-5,2,0,30,0,1,92.2,10,82.2,4,3,1,1
14724,12887,265,245,4,1,1,4,6,3,0,0,41,15,3,5,0,0,0,1,0,0,0,0,1837,20,3,-3,3,0,26,-2,0,21.4,23.8,-2.4,4,5,-1,1
14294,14527,248,294,4,2,2,4,6,4,0,1,40,17,4,6,0,0,1,0,0,1,0,0,-233,-46,2,-2,2,0,23,-2,0,139.6,19.2,120.4,5,4,1,0
14586,14547,253,285,4,3,3,4,5,2,0,0,28,13,2,10,0,1,1,0,0,0,0,0,39,-32,1,-1,3,0,15,-8,-1,31.8,99.4,-67.6,4,4,0,0
14735,15449,247,274,5,5,5,5,9,5,0,0,16,40,5,6,0,0,0,1,0,0,0,0,-714,-27,0,0,4,0,-24,-1,0,56.4,57.4,-1,5,5,0,0
12957,15938,220,280,2,6,6,2,4,3,0,0,18,23,3,6,0,2,0,1,0,0,0,0,-2981,-60,-4,4,1,0,-5,-3,-2,74,93,-19,5,4,1,0
14613,16852,238,251,4,10,11,4,7,12,0,1,13,17,0,1,2,1,1,0,0,1,0,0,-2239,-13,-6,7,-5,0,-4,-1,1,52,23,29,5,4,1,0
16208,13634,254,242,9,3,3,9,12,1,0,0,19,14,3,1,0,0,1,0,0,0,0,0,2574,12,6,-6,11,0,5,2,0,54.8,34.4,20.4,5,5,0,0
14674,15113,267,284,3,4,4,3,3,5,0,0,17,22,2,6,2,1,1,0,0,0,0,0,-439,-17,-1,1,-2,0,-5,-4,1,104.8,67.2,37.6,4,5,-1,0
17130,16424,258,235,9,10,10,9,7,9,0,0,17,15,2,0,0,1,0,1,0,0,0,0,706,23,-1,1,-2,0,2,2,-1,82.6,70.8,11.8,2,4,-2,1
15159,16508,257,240,5,9,9,6,4,12,0,1,12,12,3,1,0,1,0,1,0,1,0,0,-1349,17,-4,3,-8,0,0,2,-1,9.2,67.6,-58.4,4,5,-1,0
16262,16278,246,240,9,9,9,9,11,7,1,0,17,13,2,3,1,2,1,0,1,0,0,0,-16,6,0,0,4,0,4,-1,-1,21.8,6.4,15.4,2,2,0,0
14874,14010,289,292,3,0,0,3,4,0,0,0,16,16,3,1,0,0,1,0,0,0,0,0,864,-3,3,-3,4,0,0,2,0,49,29.8,19.2,4,5,-1,1
14149,15918,278,260,2,6,6,2,2,6,0,0,13,17,5,5,0,0,1,0,0,0,0,0,-1769,18,-4,4,-4,0,-4,0,0,18,38.6,-20.6,5,5,0,0
14880,16465,261,277,4,9,10,4,6,12,0,0,12,24,2,3,0,0,0,1,0,0,0,0,-1585,-16,-5,6,-6,0,-12,-1,0,36.8,56.4,-19.6,3,4,-1,0
13616,15608,240,269,2,7,7,2,4,2,0,1,34,17,5,4,0,1,0,1,0,1,0,0,-1992,-29,-5,5,2,0,17,1,-1,53,18.2,34.8,5,4,1,1
14480,17612,269,271,3,10,10,3,5,18,0,0,38,15,1,3,0,0,0,1,0,0,0,0,-3132,-2,-7,7,-13,0,23,-2,0,28.8,80.8,-52,3,3,0,0
16408,13967,279,251,7,3,3,7,8,4,0,0,21,17,2,2,1,0,1,0,0,0,0,0,2441,28,4,-4,4,0,4,0,1,75.8,128,-52.2,4,5,-1,1
14717,14995,276,267,4,5,5,4,1,5,0,1,12,18,3,1,0,0,1,0,0,1,0,0,-278,9,-1,1,-4,0,-6,2,0,40,32.6,7.4,3,3,0,1
13329,15084,249,262,2,6,6,2,1,5,1,0,13,14,3,1,1,0,0,1,1,0,0,0,-1755,-13,-4,4,-4,0,-1,2,1,57.6,67.2,-9.6,4,5,-1,0
15086,16892,236,224,7,10,10,7,7,15,0,0,12,19,1,5,0,0,1,0,0,0,0,0,-1806,12,-3,3,-8,0,-7,-4,0,26.2,19,7.2,3,4,-1,0
15490,16077,207,269,8,7,7,8,10,6,0,1,18,11,2,5,1,0,1,0,0,1,0,0,-587,-62,1,-1,4,0,7,-3,1,14.2,12.2,2,4,3,1,1
14952,15322,252,263,4,6,6,4,3,6,0,1,31,16,3,2,1,1,0,1,0,1,0,0,-370,-11,-2,2,-3,0,15,1,0,81.8,11,70.8,5,2,3,1
16764,13789,269,254,9,3,4,9,10,2,0,0,19,16,5,1,2,0,1,0,0,0,0,0,2975,15,6,-5,8,0,3,4,2,89.4,39,50.4,5,2,3,1
14469,15269,276,294,2,4,4,2,2,2,0,0,68,19,6,2,1,1,0,1,0,0,0,0,-800,-18,-2,2,0,0,49,4,0,46.6,15.8,30.8,4,5,-1,0
15223,17241,258,279,7,9,9,7,3,5,0,0,36,14,1,1,0,1,0,1,0,0,0,0,-2018,-21,-2,2,-2,0,22,0,-1,42.8,45.6,-2.8,4,4,0,0
15996,13023,302,262,6,1,1,6,6,1,0,1,65,14,1,1,0,0,1,0,0,1,0,0,2973,40,5,-5,5,0,51,0,0,23.8,68.2,-44.4,5,4,1,0
14377,15031,253,264,4,5,5,4,5,6,0,0,14,34,5,3,0,0,1,0,0,0,0,0,-654,-11,-1,1,-1,0,-20,2,0,32.4,21.6,10.8,3,5,-2,0
15367,14768,269,272,6,3,3,6,4,7,0,1,14,18,4,4,2,0,1,0,0,1,0,0,599,-3,3,-3,-3,0,-4,0,2,45.6,85.4,-39.8,5,4,1,1
15505,16203,263,255,6,6,6,6,8,8,1,0,12,29,3,2,0,1,1,0,1,0,0,0,-698,8,0,0,0,0,-17,1,-1,8.8,24.6,-15.8,4,5,-1,1
16600,17506,225,248,10,10,10,10,12,10,0,0,110,18,3,3,0,1,1,0,0,0,0,0,-906,-23,0,0,2,0,92,0,-1,76,51.8,24.2,4,2,2,0
15819,16754,255,278,6,7,7,6,6,7,0,0,16,216,1,5,0,3,0,1,0,0,0,0,-935,-23,-1,1,-1,0,-200,-4,-3,62.8,17.6,45.2,5,4,1,1
14513,15957,231,284,4,6,6,4,4,4,0,0,11,23,2,1,1,0,0,1,0,0,0,0,-1444,-53,-2,2,0,0,-12,1,1,60.6,20.6,40,4,4,0,0
16639,14871,266,254,8,5,5,8,11,4,0,0,20,11,1,3,1,1,0,1,0,0,0,0,1768,12,3,-3,7,0,9,-2,0,79,50,29,4,4,0,1
15476,14777,286,262,5,5,5,5,7,6,1,0,19,19,5,4,0,1,0,1,1,0,0,0,699,24,0,0,1,0,0,1,-1,51.6,15.6,36,4,2,2,1
14044,14481,227,246,5,4,4,5,2,7,0,0,12,15,1,3,0,3,1,0,0,0,0,0,-437,-19,1,-1,-5,0,-3,-2,-3,75.6,10.8,64.8,4,3,1,1
16303,17980,241,243,7,13,13,7,7,17,0,0,14,20,5,2,0,1,0,1,0,0,0,0,-1677,-2,-6,6,-10,0,-6,3,-1,112.6,125.8,-13.2,4,5,-1,0
13536,15932,254,270,2,7,7,2,3,3,1,0,17,15,3,2,0,0,0,1,1,0,0,0,-2396,-16,-5,5,0,0,2,1,0,15.6,22,-6.4,2,4,-2,1
17375,14593,264,256,9,4,4,9,12,6,0,0,19,13,4,4,4,0,0,1,0,0,0,0,2782,8,5,-5,6,0,6,0,4,20.2,21,-0.8,4,4,0,1
15770,14183,267,273,6,2,2,6,9,4,0,0,16,69,0,2,1,1,1,0,0,0,0,0,1587,-6,4,-4,5,0,-53,-2,0,89.8,20.2,69.6,5,4,1,1
14372,15467,262,267,3,6,6,3,2,9,0,0,38,17,2,5,0,0,0,1,0,0,0,0,-1095,-5,-3,3,-7,0,21,-3,0,45.4,13,32.4,4,3,1,1
15938,16856,204,251,10,9,9,10,11,12,0,0,18,14,2,5,0,0,1,0,0,0,0,0,-918,-47,1,-1,-1,0,4,-3,0,34.6,41.8,-7.2,3,4,-1,0
15101,14700,236,278,6,3,3,6,11,2,0,0,21,12,1,4,0,0,1,0,0,0,0,0,401,-42,3,-3,9,0,9,-3,0,86.4,45.2,41.2,4,5,-1,1
15196,14472,267,278,5,2,2,5,6,4,0,1,14,22,1,5,0,2,1,0,0,1,0,0,724,-11,3,-3,2,0,-8,-4,-2,63.6,86.2,-22.6,4,4,0,0
16277,14441,258,274,8,2,2,8,15,4,0,1,40,14,3,5,0,2,1,0,0,1,0,0,1836,-16,6,-6,11,0,26,-2,-2,22,32.2,-10.2,5,3,2,0
13258,15815,241,256,2,7,7,2,1,7,0,0,16,48,2,4,1,0,0,1,0,0,0,0,-2557,-15,-5,5,-6,0,-32,-2,1,44.6,14,30.6,5,5,0,0
14671,14859,247,262,5,5,5,5,7,3,0,0,39,19,2,4,0,0,0,1,0,0,0,0,-188,-15,0,0,4,0,20,-2,0,24.4,77,-52.6,4,3,1,1
15794,16238,238,261,7,7,7,7,9,11,0,1,17,55,4,5,1,3,1,0,0,1,0,0,-444,-23,0,0,-2,0,-38,-1,-2,47.4,8,39.4,3,3,0,0
13579,17429,224,296,3,9,9,3,5,5,1,0,40,16,4,2,0,2,0,1,1,0,0,0,-3850,-72,-6,6,0,0,24,2,-2,21.4,13.8,7.6,4,2,2,0
15321,15979,236,257,6,7,7,6,10,10,0,0,21,14,4,5,1,0,0,1,0,0,0,0,-658,-21,-1,1,0,0,7,-1,1,84,18.8,65.2,4,3,1,0
14767,15309,245,257,6,5,5,6,5,10,0,1,22,17,1,5,0,1,1,0,0,1,0,0,-542,-12,1,-1,-5,0,5,-4,-1,53,24.8,28.2,5,5,0,0
14380,18925,240,231,3,17,17,3,2,18,0,1,16,19,3,2,2,2,0,1,0,1,0,0,-4545,9,-14,14,-16,0,-3,1,0,20.8,94,-73.2,5,4,1,0
16299,14728,254,251,9,4,5,9,9,3,0,0,14,16,4,4,0,1,1,0,0,0,0,0,1571,3,5,-4,6,0,-2,0,-1,38,43,-5,5,4,1,1
14319,13368,266,249,3,2,2,3,2,2,0,1,16,14,3,3,0,0,1,0,0,1,0,0,951,17,1,-1,0,0,2,0,0,4.8,59.8,-55,2,4,-2,0
16543,15605,233,264,10,6,6,10,13,7,0,1,17,12,2,2,0,0,0,1,0,1,0,0,938,-31,4,-4,6,0,5,0,0,16.8,29.6,-12.8,4,3,1,0
14744,16691,256,244,5,10,10,5,3,6,0,1,17,19,4,4,0,1,0,1,0,1,0,0,-1947,12,-5,5,-3,0,-2,0,-1,8.2,56.2,-48,4,3,1,0
14597,14752,253,270,4,4,4,4,6,6,0,1,41,20,0,4,1,1,0,1,0,1,0,0,-155,-17,0,0,0,0,21,-4,0,26.2,10.6,15.6,4,4,0,0
2536,2525,1,0,0,0,0,0,0,0,0,0,2,2,0,0,0,0,0,0,0,0,0,0,11,1,0,0,0,0,0,0,0,19.6,10.4,9.2,3,4,-1,1
15454,14077,264,276,4,2,2,4,5,3,0,0,39,18,2,4,0,0,0,1,0,0,0,0,1377,-12,2,-2,2,0,21,-2,0,21,35.4,-14.4,4,5,-1,1
15454,16250,252,250,7,8,8,7,6,7,0,0,19,14,0,3,0,0,0,1,0,0,0,0,-796,2,-1,1,-1,0,5,-3,0,10.6,75.6,-65,4,5,-1,0
17784,13665,263,266,12,2,2,12,8,1,0,0,31,22,2,1,3,0,1,0,0,0,0,0,4119,-3,10,-10,7,0,9,1,3,29,77.4,-48.4,3,4,-1,1
15664,13433,266,276,6,1,1,6,7,1,0,1,15,13,3,2,0,0,0,1,0,1,0,0,2231,-10,5,-5,6,0,2,1,0,75.6,33.4,42.2,5,5,0,1
2572,2551,1,0,0,0,0,0,0,0,0,0,1,2,0,0,0,0,0,0,0,0,0,0,21,1,0,0,0,0,-1,0,0,16,26.8,-10.8,3,3,0,1
16300,18209,215,247,8,11,12,8,11,12,0,0,19,118,2,2,1,4,0,1,0,0,0,0,-1909,-32,-3,4,-1,0,-99,0,-3,8.2,37.4,-29.2,3,4,-1,0
14690,15178,234,265,5,5,5,5,7,4,1,0,34,15,3,4,0,1,0,1,1,0,0,0,-488,-31,0,0,3,0,19,-1,-1,5.4,76.6,-71.2,1,3,-2,0
15413,13998,286,251,5,3,3,5,6,3,0,0,62,18,3,6,0,0,0,1,0,0,0,0,1415,35,2,-2,3,0,44,-3,0,12.8,94.6,-81.8,4,5,-1,0
15231,15210,238,270,6,5,5,6,6,4,0,0,14,32,3,1,0,0,0,1,0,0,0,0,21,-32,1,-1,2,0,-18,2,0,12.6,65.6,-53,2,4,-2,0
16173,14353,271,267,6,3,3,6,7,2,0,0,19,14,6,7,0,0,0,1,0,0,0,0,1820,4,3,-3,5,0,5,-1,0,21.6,22.2,-0.6,3,4,-1,1
14622,16578,252,256,4,7,7,4,4,12,0,0,15,15,2,2,0,2,0,1,0,0,0,0,-1956,-4,-3,3,-8,0,0,0,-2,31.8,9.2,22.6,5,4,1,0
14210,14648,293,287,1,2,2,1,2,4,0,0,62,41,2,3,1,1,0,1,0,0,0,0,-438,6,-1,1,-2,0,21,-1,0,12.6,25.6,-13,2,3,-1,0
14450,15585,283,242,2,7,7,2,2,8,0,1,14,21,6,1,0,1,0,1,0,1,0,0,-1135,41,-5,5,-6,0,-7,5,-1,17,51.6,-34.6,4,5,-1,1
16658,14659,248,251,9,4,4,9,11,3,1,0,74,13,4,2,1,0,1,0,1,0,0,0,1999,-3,5,-5,8,0,61,2,1,10.4,13.4,-3,5,3,2,1
14867,15125,248,275,5,4,4,5,7,3,0,1,17,18,2,4,1,1,0,1,0,1,0,0,-258,-27,1,-1,4,0,-1,-2,0,27.4,22.4,5,4,5,-1,0
15929,16185,269,302,6,4,4,6,7,3,0,0,18,88,4,4,0,3,1,0,0,0,0,0,-256,-33,2,-2,4,0,-70,0,-3,28.8,8.2,20.6,4,2,2,0
15191,14537,255,268,5,3,3,5,7,3,1,0,15,16,0,2,1,2,1,0,1,0,0,0,654,-13,2,-2,4,0,-1,-2,-1,102.6,69.8,32.8,3,3,0,1
17695,16805,258,249,11,9,9,11,8,8,0,0,17,14,1,3,2,1,0,1,0,0,0,0,890,9,2,-2,0,0,3,-2,1,64,152.8,-88.8,3,5,-2,0
14896,14496,285,237,3,5,5,3,2,6,0,1,15,15,0,2,1,0,0,1,0,1,0,0,400,48,-2,2,-4,0,0,-2,1,94.8,97,-2.2,4,3,1,1
15800,18478,228,242,7,15,15,7,9,16,1,0,20,12,3,2,1,0,0,1,1,0,0,0,-2678,-14,-8,8,-7,0,8,1,1,45.8,19.4,26.4,5,4,1,0
16390,14613,259,239,8,4,4,8,12,10,0,0,17,15,0,3,0,0,1,0,0,0,0,0,1777,20,4,-4,2,0,2,-3,0,18.8,90.6,-71.8,4,3,1,1
15515,15317,263,285,6,4,4,6,9,7,0,0,21,16,5,3,0,1,1,0,0,0,0,0,198,-22,2,-2,2,0,5,2,-1,48.8,37.8,11,5,5,0,0
15816,14696,272,258,5,5,5,5,9,6,0,0,140,17,2,3,1,1,1,0,0,0,0,0,1120,14,0,0,3,0,123,-1,0,28.6,16.2,12.4,4,3,1,1
16933,14751,264,235,9,5,5,9,9,5,0,1,16,123,4,2,1,1,1,0,0,1,0,0,2182,29,4,-4,4,0,-107,2,0,16,5.2,10.8,5,1,4,1
14617,16529,269,285,4,8,8,4,1,10,0,0,32,271,2,1,1,1,0,1,0,0,0,0,-1912,-16,-4,4,-9,0,-239,1,0,120.4,60.8,59.6,5,3,2,0
15975,14254,291,262,5,3,3,5,7,3,0,1,17,44,8,2,0,0,1,0,0,1,0,0,1721,29,2,-2,4,0,-27,6,0,26.6,96.4,-69.8,3,4,-1,1
14155,16398,280,267,3,8,8,3,2,10,0,1,16,13,3,3,1,0,1,0,0,1,0,0,-2243,13,-5,5,-8,0,3,0,1,22.8,117.8,-95,5,5,0,0
16549,14174,270,286,7,2,2,7,8,2,0,0,12,13,4,2,0,0,1,0,0,0,0,0,2375,-16,5,-5,6,0,-1,2,0,168.6,19.8,148.8,5,5,0,1
15811,14071,245,276,7,2,2,7,9,3,0,0,18,15,2,1,0,0,1,0,0,0,0,0,1740,-31,5,-5,6,0,3,1,0,19.6,23.2,-3.6,4,4,0,0
15180,13959,284,269,4,2,2,4,6,1,0,1,40,14,1,1,1,1,1,0,0,1,0,0,1221,15,2,-2,5,0,26,0,0,63.6,16,47.6,3,4,-1,0
15004,14440,269,258,3,3,3,3,4,5,1,0,18,24,5,2,2,1,0,1,1,0,0,0,564,11,0,0,-1,0,-6,3,1,76,50.6,25.4,4,4,0,1
14505,15869,278,278,2,7,7,2,4,7,0,0,18,18,1,6,0,0,0,1,0,0,0,0,-1364,0,-5,5,-3,0,0,-5,0,17.6,69,-51.4,4,5,-1,0
14173,13756,246,241,2,3,3,2,4,1,0,0,15,26,3,4,3,0,0,1,0,0,0,0,417,5,-1,1,3,0,-11,-1,3,210.2,42,168.2,5,2,3,1
15422,16372,226,240,8,8,8,8,10,11,0,0,14,28,2,3,3,1,1,0,0,0,0,0,-950,-14,0,0,-1,0,-14,-1,2,93.4,28,65.4,4,3,1,1
15361,14938,270,278,6,4,4,6,7,5,0,0,17,12,6,5,0,0,1,0,0,0,0,0,423,-8,2,-2,2,0,5,1,0,68.8,69.2,-0.4,3,5,-2,0
14681,13859,264,265,4,2,2,4,4,2,0,0,19,18,4,3,0,0,1,0,0,0,0,0,822,-1,2,-2,2,0,1,1,0,132,13.2,118.8,4,3,1,1
2638,2598,3,1,0,0,0,0,0,0,0,0,1,2,0,0,0,0,0,0,0,0,0,0,40,2,0,0,0,0,-1,0,0,67.2,28.4,38.8,4,4,0,1
15096,14825,324,276,2,3,3,2,4,4,0,1,18,16,2,3,0,0,1,0,0,1,0,0,271,48,-1,1,0,0,2,-1,0,43.4,111.8,-68.4,5,4,1,0
15822,16611,235,261,8,8,8,8,10,8,0,0,16,14,1,3,0,1,1,0,0,0,0,0,-789,-26,0,0,2,0,2,-2,-1,28.6,10.8,17.8,5,2,3,1
16438,16300,277,276,8,7,7,8,13,9,0,0,18,18,2,2,0,1,1,0,0,0,0,0,138,1,1,-1,4,0,0,0,-1,19.2,66.8,-47.6,5,4,1,1
13508,15827,233,285,2,5,5,2,3,7,0,0,33,20,2,0,0,1,1,0,0,0,0,0,-2319,-52,-3,3,-4,0,13,2,-1,57.8,15,42.8,4,3,1,0
13357,15689,247,264,2,6,6,2,3,8,0,0,29,18,5,3,0,1,1,0,0,0,0,0,-2332,-17,-4,4,-5,0,11,2,-1,76.6,45.4,31.2,5,5,0,0
14738,14791,254,281,4,3,3,4,4,2,0,0,17,18,2,0,0,2,0,1,0,0,0,0,-53,-27,1,-1,2,0,-1,2,-2,10.4,12,-1.6,3,4,-1,1
16122,16913,246,252,8,9,9,8,9,5,0,0,18,16,3,4,2,3,1,0,0,0,0,0,-791,-6,-1,1,4,0,2,-1,-1,64,13.2,50.8,4,4,0,1
15226,15324,268,286,5,4,4,5,8,5,1,0,22,21,2,5,2,1,1,0,1,0,0,0,-98,-18,1,-1,3,0,1,-3,1,55.6,16.6,39,4,3,1,1
16115,14940,259,251,10,5,6,10,7,5,0,1,18,14,3,4,0,0,0,1,0,1,0,0,1175,8,5,-4,2,0,4,-1,0,14.6,25.2,-10.6,3,5,-2,1
15813,16299,235,246,8,10,10,8,8,6,0,0,19,14,4,3,3,0,1,0,0,0,0,0,-486,-11,-2,2,2,0,5,1,3,70,4.4,65.6,3,0,3,0
15753,16905,276,272,5,8,8,5,8,19,0,0,37,11,1,3,2,0,0,1,0,0,0,0,-1152,4,-3,3,-11,0,26,-2,2,25.6,14.4,11.2,4,3,1,1
16144,15881,266,264,8,7,7,8,6,7,0,0,16,17,3,5,0,0,0,1,0,0,0,0,263,2,1,-1,-1,0,-1,-2,0,13.2,54.4,-41.2,3,5,-2,0
14379,17104,266,294,4,9,9,4,3,10,0,0,16,27,5,3,0,1,0,1,0,0,0,0,-2725,-28,-5,5,-7,0,-11,2,-1,14.2,50.8,-36.6,5,4,1,1
17318,14682,263,231,10,5,5,11,8,5,0,0,17,51,0,3,1,0,0,1,0,0,0,0,2636,32,5,-6,3,0,-34,-3,1,69.4,120,-50.6,5,5,0,1
16190,14873,242,254,8,4,4,8,14,4,0,0,18,17,2,0,0,2,1,0,0,0,0,0,1317,-12,4,-4,10,0,1,2,-2,21.6,29.4,-7.8,5,4,1,0
13370,15292,261,291,1,4,4,1,1,5,0,1,13,16,4,2,0,0,0,1,0,1,0,0,-1922,-30,-3,3,-4,0,-3,2,0,17.2,18.2,-1,3,5,-2,0
13422,14974,278,262,0,4,4,0,0,4,0,1,16,41,3,3,1,1,0,1,0,1,0,0,-1552,16,-4,4,-4,0,-25,0,0,23.4,15.6,7.8,4,4,0,0
14779,13052,279,232,4,2,2,4,2,1,0,1,17,34,2,2,0,0,0,1,0,1,0,0,1727,47,2,-2,1,0,-17,0,0,7.8,118,-110.2,2,5,-3,1
15199,14817,292,295,4,3,3,4,5,3,0,1,16,14,0,2,1,0,1,0,0,1,0,0,382,-3,1,-1,2,0,2,-2,1,74.6,33.8,40.8,4,5,-1,0
14610,13297,220,255,6,2,2,6,7,0,0,0,19,33,6,4,0,1,0,1,0,0,0,0,1313,-35,4,-4,7,0,-14,2,-1,25.4,8.6,16.8,5,3,2,1
15546,15804,275,249,5,6,6,5,8,6,1,0,16,16,4,3,0,0,1,0,1,0,0,0,-258,26,-1,1,2,0,0,1,0,45.8,62,-16.2,4,5,-1,1
15798,13830,267,280,6,2,2,7,5,4,0,1,32,15,2,3,1,0,0,1,0,1,0,0,1968,-13,4,-5,1,0,17,-1,1,124,71.4,52.6,5,5,0,1
16447,15116,280,283,7,4,4,7,10,6,0,1,15,13,2,3,0,1,1,0,0,1,0,0,1331,-3,3,-3,4,0,2,-1,-1,66.6,53.6,13,3,3,0,1
14849,15032,243,271,5,5,5,5,5,4,0,0,32,18,4,1,0,0,0,1,0,0,0,0,-183,-28,0,0,1,0,14,3,0,50.2,61,-10.8,3,3,0,1
15918,13553,274,263,7,2,2,7,6,2,0,1,23,18,4,3,0,1,1,0,0,1,0,0,2365,11,5,-5,4,0,5,1,-1,33,16.6,16.4,4,4,0,1
14428,18210,245,284,4,13,13,4,2,10,1,0,104,17,3,5,0,2,0,1,1,0,0,0,-3782,-39,-9,9,-8,0,87,-2,-2,61.2,28.8,32.4,4,3,1,0
14340,14042,237,247,5,3,3,5,7,3,1,0,14,13,1,1,0,1,1,0,1,0,0,0,298,-10,2,-2,4,0,1,0,-1,18,26,-8,5,4,1,0
16376,16320,194,247,10,8,8,10,13,10,0,0,35,19,5,3,1,2,1,0,0,0,0,0,56,-53,2,-2,3,0,16,2,-1,72.6,28.6,44,5,3,2,1
15405,17064,248,254,6,9,9,6,9,10,0,1,41,15,2,9,1,1,0,1,0,1,0,0,-1659,-6,-3,3,-1,0,26,-7,0,23.2,112.4,-89.2,2,4,-2,0
16728,15398,268,265,9,5,5,9,7,4,0,1,17,15,5,3,1,2,0,1,0,1,0,0,1330,3,4,-4,3,0,2,2,-1,23,31,-8,4,4,0,0
13798,14363,277,296,2,2,2,2,2,4,0,1,15,22,5,4,0,0,1,0,0,1,0,0,-565,-19,0,0,-2,0,-7,1,0,24.6,27.2,-2.6,2,4,-2,1
15458,15144,267,230,6,6,6,6,9,9,1,0,116,18,4,1,1,0,1,0,1,0,0,0,314,37,0,0,0,0,98,3,1,16.2,60.2,-44,4,4,0,0
15553,13881,300,269,4,2,2,4,4,0,0,1,14,15,2,1,2,0,1,0,0,1,0,0,1672,31,2,-2,4,0,-1,1,2,23,13.8,9.2,3,4,-1,1
17305,12833,285,238,9,1,1,9,13,2,0,0,16,17,3,4,2,0,1,0,0,0,0,0,4472,47,8,-8,11,0,-1,-1,2,22.8,23.6,-0.8,4,4,0,1
18188,14609,241,246,14,4,4,14,18,6,1,0,17,17,3,1,2,0,1,0,1,0,0,0,3579,-5,10,-10,12,0,0,2,2,29,14.4,14.6,3,3,0,1
14042,17306,238,283,4,9,9,4,3,9,0,0,18,17,4,2,0,1,0,1,0,0,0,0,-3264,-45,-5,5,-6,0,1,2,-1,46,33.2,12.8,4,4,0,1
16072,14426,242,244,8,4,4,8,14,6,0,0,21,18,1,2,0,0,1,0,0,0,0,0,1646,-2,4,-4,8,0,3,-1,0,25.8,93.4,-67.6,5,5,0,1
17563,14607,256,288,10,1,1,10,15,1,1,0,19,14,3,4,1,1,1,0,1,0,0,0,2956,-32,9,-9,14,0,5,-1,0,30.2,11.4,18.8,4,4,0,1
15266,14647,298,297,4,1,1,4,8,1,0,0,14,36,2,6,1,3,0,1,0,0,0,0,619,1,3,-3,7,0,-22,-4,-2,104.6,30.2,74.4,4,5,-1,1
15492,16161,243,248,6,9,9,6,9,13,0,0,27,18,3,2,1,0,1,0,0,0,0,0,-669,-5,-3,3,-4,0,9,1,1,27.8,41.8,-14,5,4,1,1
13807,14888,260,280,2,4,4,2,3,4,0,0,16,95,4,1,0,1,0,1,0,0,0,0,-1081,-20,-2,2,-1,0,-79,3,-1,77.4,11.8,65.6,5,2,3,0
15917,13814,283,274,7,2,2,7,5,2,0,0,16,14,3,5,0,0,1,0,0,0,0,0,2103,9,5,-5,3,0,2,-2,0,40.8,151.4,-110.6,4,5,-1,1
15574,14056,273,273,5,2,2,5,9,3,0,1,17,16,2,1,1,0,0,1,0,1,0,0,1518,0,3,-3,6,0,1,1,1,15.4,22.8,-7.4,3,4,-1,1
16430,15157,281,278,7,4,4,7,9,5,0,0,21,16,2,4,0,0,1,0,0,0,0,0,1273,3,3,-3,4,0,5,-2,0,28.4,30.8,-2.4,5,5,0,1
17015,13625,277,221,10,3,3,10,7,3,0,0,23,11,5,1,2,2,1,0,0,0,0,0,3390,56,7,-7,4,0,12,4,0,38,98.2,-60.2,1,4,-3,0
15470,14630,296,289,4,2,2,4,7,2,0,0,21,16,3,6,0,0,1,0,0,0,0,0,840,7,2,-2,5,0,5,-3,0,78.8,72.2,6.6,4,4,0,0
14711,13765,298,272,3,1,1,3,2,1,0,1,14,13,2,2,0,0,0,1,0,1,0,0,946,26,2,-2,1,0,1,0,0,25.8,40.6,-14.8,5,3,2,1
15364,14609,277,285,5,3,3,5,5,2,0,1,14,13,3,4,1,0,1,0,0,1,0,0,755,-8,2,-2,3,0,1,-1,1,26,13.4,12.6,2,3,-1,1
15563,16696,270,284,6,6,6,6,11,5,0,0,15,32,8,5,0,1,0,1,0,0,0,0,-1133,-14,0,0,6,0,-17,3,-1,101.6,77.2,24.4,3,4,-1,0
15610,13578,284,279,5,1,1,5,7,3,0,1,15,16,2,1,0,0,0,1,0,1,0,0,2032,5,4,-4,4,0,-1,1,0,46.4,9,37.4,3,2,1,1
2525,2525,0,0,0,0,0,0,0,0,0,0,0,2,0,0,0,0,0,0,0,0,0,0,0,0,0,0,0,0,-2,0,0,56.6,12.4,44.2,3,3,0,0
15978,15302,262,245,7,7,7,7,11,15,0,0,11,12,3,2,0,1,1,0,0,0,0,0,676,17,0,0,-4,0,-1,1,-1,39.6,63.8,-24.2,4,5,-1,1
17385,14414,274,259,10,3,3,10,12,4,0,0,15,14,3,2,2,0,1,0,0,0,0,0,2971,15,7,-7,8,0,1,1,2,54.4,156,-101.6,5,4,1,1
16235,14731,298,277,6,4,4,6,6,1,0,0,15,15,4,4,0,0,0,1,0,0,0,0,1504,21,2,-2,5,0,0,0,0,13,33.6,-20.6,3,4,-1,1
15631,15755,242,300,8,4,4,8,12,3,1,0,19,17,3,1,0,1,0,1,1,0,0,0,-124,-58,4,-4,9,0,2,2,-1,102,21,81,5,4,1,0
16686,14096,300,256,7,3,3,7,11,4,0,0,17,16,4,5,1,0,1,0,0,0,0,0,2590,44,4,-4,7,0,1,-1,1,35.4,51.8,-16.4,4,4,0,1
16034,15292,258,229,7,7,7,7,9,9,0,1,35,15,2,3,0,0,1,0,0,1,0,0,742,29,0,0,0,0,20,-1,0,40.2,48.2,-8,2,5,-3,0
14732,14898,295,258,2,4,4,2,1,9,0,0,18,16,3,1,1,0,0,1,0,0,0,0,-166,37,-2,2,-8,0,2,2,1,12,49,-37,4,4,0,0
16006,13336,254,245,7,2,2,7,12,2,1,0,15,17,2,2,2,0,1,0,1,0,0,0,2670,9,5,-5,10,0,-2,0,2,21.4,19.8,1.6,3,5,-2,1
14073,16270,268,272,2,8,8,2,3,10,0,1,22,203,0,4,0,1,1,0,0,1,0,0,-2197,-4,-6,6,-7,0,-181,-4,-1,27,93,-66,3,5,-2,0
14237,13484,282,263,3,2,2,3,1,1,1,0,16,18,3,1,1,0,1,0,1,0,0,0,753,19,1,-1,0,0,-2,2,1,46,15.4,30.6,4,2,2,1
15586,13895,228,261,9,2,2,9,6,1,0,0,32,16,1,4,1,3,1,0,0,0,0,0,1691,-33,7,-7,5,0,16,-3,-2,122,57.4,64.6,5,5,0,0
15267,14683,247,241,6,5,5,6,10,6,0,0,41,19,3,3,1,0,0,1,0,0,0,0,584,6,1,-1,4,0,22,0,1,81.8,22.2,59.6,5,4,1,1
13755,16650,241,265,3,9,9,3,2,5,0,0,15,16,2,3,0,1,1,0,0,0,0,0,-2895,-24,-6,6,-3,0,-1,-1,-1,56.4,67.8,-11.4,4,4,0,0
14197,14650,277,286,2,3,3,2,2,4,0,1,14,18,2,2,0,0,1,0,0,1,0,0,-453,-9,-1,1,-2,0,-4,0,0,59.8,76.6,-16.8,4,4,0,0
15890,16725,216,249,10,9,9,10,24,16,1,0,23,13,1,7,0,0,1,0,1,0,0,0,-835,-33,1,-1,8,0,10,-6,0,47,45.8,1.2,3,3,0,0
16664,14996,284,231,6,6,6,6,8,7,1,0,12,15,3,6,4,0,1,0,1,0,1,0,1668,53,0,0,1,0,-3,-3,4,15,30,-15,4,5,-1,1
14319,13531,277,270,3,2,2,3,2,1,0,0,12,14,2,2,0,0,1,0,0,0,0,0,788,7,1,-1,1,0,-2,0,0,26.4,107.8,-81.4,4,4,0,1
15666,12491,291,250,4,0,0,4,6,0,0,0,14,12,2,3,2,0,1,0,0,0,0,0,3175,41,4,-4,6,0,2,-1,2,18.8,25,-6.2,4,4,0,1
15469,13765,277,243,6,3,3,6,5,2,1,0,18,22,4,2,0,0,0,1,1,0,0,0,1704,34,3,-3,3,0,-4,2,0,93.2,42.2,51,3,5,-2,1
15984,12582,231,258,11,0,0,11,7,0,0,1,24,13,3,6,2,0,1,0,0,1,0,0,3402,-27,11,-11,7,0,11,-3,2,20.2,4.2,16,5,1,4,1
15804,15456,247,227,6,8,8,6,5,7,0,1,14,17,6,0,2,0,0,1,0,1,0,0,348,20,-2,2,-2,0,-3,6,2,15.6,4.4,11.2,3,1,2,0
14880,16697,258,260,5,9,9,5,5,14,0,1,20,12,1,4,0,1,0,1,0,1,0,0,-1817,-2,-4,4,-9,0,8,-3,-1,128.8,23.8,105,4,3,1,1
16228,17441,216,241,9,11,11,9,8,11,0,0,17,17,3,8,1,1,0,1,0,0,0,0,-1213,-25,-2,2,-3,0,0,-5,0,39.4,13,26.4,3,3,0,0
14063,16208,258,271,3,7,7,3,2,6,0,0,23,29,3,5,0,1,0,1,0,0,0,0,-2145,-13,-4,4,-4,0,-6,-2,-1,16.2,16.8,-0.6,2,4,-2,0
16513,14101,276,254,9,3,3,9,5,1,1,0,17,18,3,2,2,1,1,0,1,0,0,0,2412,22,6,-6,4,0,-1,1,1,19.8,14.6,5.2,5,4,1,0
15880,14007,278,265,6,3,3,6,7,2,0,0,20,16,4,5,1,0,1,0,0,0,0,0,1873,13,3,-3,5,0,4,-1,1,15.6,11.2,4.4,3,5,-2,1
16643,16205,257,259,8,8,8,8,9,9,0,1,36,114,3,5,0,2,1,0,0,1,0,0,438,-2,0,0,0,0,-78,-2,-2,19,25.8,-6.8,4,3,1,1
16378,15799,262,254,7,6,6,7,8,7,0,0,17,17,2,8,1,0,1,0,0,0,0,0,579,8,1,-1,1,0,0,-6,1,24.6,27.6,-3,4,5,-1,1
15268,14677,248,250,6,4,4,6,7,6,0,1,18,39,1,3,0,0,1,0,0,1,0,0,591,-2,2,-2,1,0,-21,-2,0,72.4,29.6,42.8,4,4,0,0
16209,15052,265,265,5,5,5,5,8,6,0,0,13,14,4,4,1,0,0,1,0,0,0,0,1157,0,0,0,2,0,-1,0,1,15.6,12.4,3.2,5,3,2,1
14264,14354,271,257,3,4,4,3,1,1,0,1,16,18,2,5,0,1,0,1,0,1,0,0,-90,14,-1,1,0,0,-2,-3,-1,11.8,13.4,-1.6,3,3,0,0
15661,13260,265,256,7,1,1,7,3,3,0,0,19,11,1,3,0,0,1,0,0,0,0,0,2401,9,6,-6,0,0,8,-2,0,102.2,28.6,73.6,5,5,0,0
14309,15525,244,240,4,7,7,4,4,8,0,0,16,14,2,2,0,0,0,1,0,0,0,0,-1216,4,-3,3,-4,0,2,0,0,32.4,18.8,13.6,3,4,-1,0
14624,14856,276,280,3,4,4,3,5,3,0,1,19,14,2,3,1,1,0,1,0,1,0,0,-232,-4,-1,1,2,0,5,-1,0,23.6,41.6,-18,4,3,1,0
14676,15909,277,284,4,6,6,4,2,7,0,0,18,13,4,3,0,0,1,0,0,0,0,0,-1233,-7,-2,2,-5,0,5,1,0,21.2,77,-55.8,3,4,-1,0
15742,16826,261,256,6,7,7,6,8,12,0,0,14,21,3,3,1,1,1,0,0,0,0,0,-1084,5,-1,1,-4,0,-7,0,0,14.2,50.6,-36.4,4,5,-1,1
15584,14134,300,267,5,2,2,5,5,1,0,0,16,15,2,2,0,0,1,0,0,0,0,0,1450,33,3,-3,4,0,1,0,0,23.6,71.4,-47.8,4,3,1,1
14811,16177,275,282,4,7,7,4,3,6,1,0,21,66,3,5,0,1,1,0,1,0,0,0,-1366,-7,-3,3,-3,0,-45,-2,-1,12.8,48.2,-35.4,4,5,-1,0
13772,18772,240,290,3,12,12,3,3,17,0,1,16,22,3,5,0,2,0,1,0,1,0,0,-5000,-50,-9,9,-14,0,-6,-2,-2,16,85.8,-69.8,2,4,-2,0
15291,14826,245,254,6,4,4,6,9,3,0,0,36,19,5,1,0,0,1,0,0,0,0,0,465,-9,2,-2,6,0,17,4,0,39.8,13.4,26.4,5,3,2,1
14340,14351,256,265,3,3,3,3,5,4,0,1,15,20,4,2,1,0,1,0,0,1,0,0,-11,-9,0,0,1,0,-5,2,1,7.4,5.4,2,4,1,3,1
15400,15878,266,282,6,6,6,6,5,5,0,1,28,18,1,2,0,0,0,1,0,1,0,0,-478,-16,0,0,0,0,10,-1,0,17.6,20.4,-2.8,5,4,1,0
15310,15739,265,244,5,6,6,5,4,6,0,0,16,15,4,1,2,2,1,0,0,0,0,0,-429,21,-1,1,-2,0,1,3,0,8,76.2,-68.2,4,5,-1,0
14438,17275,262,250,3,11,11,3,4,10,0,1,18,15,3,3,0,0,0,1,0,1,0,0,-2837,12,-8,8,-6,0,3,0,0,68.6,55.4,13.2,4,2,2,0
13923,14821,250,259,3,5,5,4,6,6,0,0,26,16,3,4,0,1,0,1,0,0,0,0,-898,-9,-2,1,0,0,10,-1,-1,22,32.8,-10.8,5,5,0,0
14428,15546,292,281,2,6,6,2,4,6,1,0,12,13,2,4,1,1,0,1,1,0,0,0,-1118,11,-4,4,-2,0,-1,-2,0,19.2,106.6,-87.4,4,4,0,0
15382,15279,264,270,5,4,4,5,9,4,0,0,14,18,3,2,2,1,1,0,0,0,0,0,103,-6,1,-1,5,0,-4,1,1,10,62.8,-52.8,2,5,-3,1
15985,14503,275,276,6,3,3,6,4,2,0,0,17,17,3,4,0,0,0,1,0,0,0,0,1482,-1,3,-3,2,0,0,-1,0,23.2,151.6,-128.4,4,5,-1,0
14488,13429,255,258,4,1,1,4,6,1,0,0,19,37,1,2,2,1,1,0,0,0,0,0,1059,-3,3,-3,5,0,-18,-1,1,73.6,50,23.6,5,3,2,0
17684,15260,226,260,13,4,4,13,16,7,0,0,16,15,3,5,3,1,1,0,0,0,0,0,2424,-34,9,-9,9,0,1,-2,2,19.4,51,-31.6,4,4,0,1
15338,14897,262,239,5,6,6,5,6,5,0,0,23,19,6,1,3,0,0,1,0,0,0,0,441,23,-1,1,1,0,4,5,3,63,26.4,36.6,4,5,-1,1
14557,16209,289,290,3,6,6,3,3,9,0,1,21,15,4,5,1,1,1,0,0,1,0,0,-1652,-1,-3,3,-6,0,6,-1,0,52.4,25.2,27.2,4,3,1,0
14384,15462,237,280,5,4,4,6,8,4,0,0,27,15,2,3,0,1,0,1,0,0,0,0,-1078,-43,1,-2,4,0,12,-1,-1,11.4,21.6,-10.2,3,2,1,1
16956,15774,201,222,12,9,9,12,14,8,0,0,13,14,4,2,0,1,1,0,0,0,0,0,1182,-21,3,-3,6,0,-1,2,-1,13.8,107.2,-93.4,2,4,-2,1
15009,15614,249,271,6,5,5,6,6,6,1,0,13,15,1,2,0,2,0,1,1,0,0,0,-605,-22,1,-1,0,0,-2,-1,-2,39.2,23.6,15.6,5,2,3,1
15713,15383,289,262,6,5,5,6,4,7,1,0,15,33,4,6,0,1,1,0,1,0,0,0,330,27,1,-1,-3,0,-18,-2,-1,22.8,20.8,2,5,4,1,1
15489,16003,242,234,7,9,9,7,5,15,0,0,19,36,1,4,2,0,0,1,0,0,0,0,-514,8,-2,2,-10,0,-17,-3,2,39.4,19.8,19.6,5,4,1,0
15497,15236,269,243,5,7,7,5,6,5,1,0,16,18,2,2,0,0,1,0,1,0,0,0,261,26,-2,2,1,0,-2,0,0,21,49.8,-28.8,5,5,0,1
14803,14472,303,303,2,2,2,2,2,3,1,0,22,17,4,4,0,0,0,1,1,0,0,0,331,0,0,0,-1,0,5,0,0,41.6,27.2,14.4,5,4,1,1
16709,16266,252,274,9,7,7,9,11,6,0,1,31,33,9,2,0,1,0,1,0,1,0,0,443,-22,2,-2,5,0,-2,7,-1,94.4,81.8,12.6,5,5,0,1
13886,15825,272,305,2,6,6,2,3,4,0,1,15,17,5,1,0,2,0,1,0,1,0,0,-1939,-33,-4,4,-1,0,-2,4,-2,36,36.8,-0.8,5,5,0,0
16118,17152,239,279,7,9,9,7,9,9,1,0,26,16,2,3,0,2,0,1,1,0,0,0,-1034,-40,-2,2,0,0,10,-1,-2,85.8,88.6,-2.8,4,5,-1,1
14667,14226,279,264,5,3,3,5,7,6,0,1,21,13,2,3,0,0,1,0,0,1,0,0,441,15,2,-2,1,0,8,-1,0,45.4,21.2,24.2,3,4,-1,1
15494,14894,270,256,6,5,7,6,8,5,1,0,11,18,5,2,0,0,0,1,1,0,0,0,600,14,1,1,3,0,-7,3,0,27.2,40.4,-13.2,4,4,0,1
15794,14916,257,262,5,5,5,5,8,4,0,1,13,16,5,2,1,1,0,1,0,1,0,0,878,-5,0,0,4,0,-3,3,0,28.2,29.2,-1,4,5,-1,0
14957,14834,295,288,4,3,3,4,7,5,0,0,19,26,4,10,0,0,1,0,0,0,0,0,123,7,1,-1,2,0,-7,-6,0,52,98.6,-46.6,4,5,-1,0
14569,15531,265,270,3,5,5,3,3,4,0,0,122,17,5,1,1,2,0,1,0,0,0,0,-962,-5,-2,2,-1,0,105,4,-1,17.4,16.4,1,4,5,-1,0
15268,14426,306,302,4,1,1,4,3,2,1,0,13,12,2,1,1,0,1,0,1,0,0,0,842,4,3,-3,1,0,1,1,1,62,27.6,34.4,5,4,1,1
14414,13574,280,303,3,0,0,3,2,0,1,0,15,10,3,3,1,0,1,0,1,0,0,0,840,-23,3,-3,2,0,5,0,1,28.6,99,-70.4,5,4,1,1
17114,13743,289,233,8,2,2,8,5,3,0,0,16,18,1,1,2,3,1,0,0,0,0,0,3371,56,6,-6,2,0,-2,0,-1,146.8,21.2,125.6,4,5,-1,1
18833,15002,285,258,11,5,5,11,23,11,0,1,24,18,5,4,1,0,0,1,0,1,0,0,3831,27,6,-6,12,0,6,1,1,12.6,83.2,-70.6,4,5,-1,1
15333,13366,274,228,5,2,2,5,5,4,1,0,18,14,4,2,0,0,1,0,1,0,0,0,1967,46,3,-3,1,0,4,2,0,20.6,96.6,-76,5,4,1,1
15815,14738,278,226,6,7,7,6,4,5,0,0,39,14,3,1,0,0,1,0,0,0,0,0,1077,52,-1,1,-1,0,25,2,0,68.4,56.2,12.2,4,4,0,1
15141,16151,268,274,5,6,6,5,6,10,0,1,71,19,4,5,0,1,0,1,0,1,0,0,-1010,-6,-1,1,-4,0,52,-1,-1,24,33.4,-9.4,5,5,0,0
15344,15289,265,256,6,5,5,6,3,7,0,0,19,17,2,3,0,1,1,0,0,0,0,0,55,9,1,-1,-4,0,2,-1,-1,23.2,54.6,-31.4,4,4,0,1
17283,15631,281,255,9,6,6,9,10,4,1,0,35,13,3,5,1,0,0,1,1,0,0,0,1652,26,3,-3,6,0,22,-2,1,29.4,52.2,-22.8,4,2,2,1
15306,15664,264,276,5,5,5,5,7,7,0,0,13,13,4,1,1,1,1,0,0,0,0,0,-358,-12,0,0,0,0,0,3,0,34.2,16.4,17.8,4,3,1,1
13872,15845,220,271,4,6,7,4,5,3,1,0,164,35,4,3,0,2,0,1,1,0,0,0,-1973,-51,-2,3,2,0,129,1,-2,31.4,15.8,15.6,4,3,1,1
15553,13669,279,266,6,2,2,6,6,2,0,1,25,16,7,3,0,1,1,0,0,1,0,0,1884,13,4,-4,4,0,9,4,-1,19.4,11.6,7.8,4,3,1,0
15023,15544,262,267,5,5,5,5,5,6,1,0,16,16,4,3,0,0,1,0,1,0,0,0,-521,-5,0,0,-1,0,0,1,0,18.2,24.6,-6.4,3,2,1,1
13900,14197,295,278,1,2,2,1,1,3,0,0,18,14,2,5,0,0,1,0,0,0,0,0,-297,17,-1,1,-2,0,4,-3,0,17.6,53,-35.4,3,4,-1,0
14873,15765,287,278,3,6,6,3,1,8,0,1,14,17,2,4,1,2,0,1,0,1,0,0,-892,9,-3,3,-7,0,-3,-2,-1,4.6,23.2,-18.6,0,4,-4,1
16174,16785,247,219,8,9,9,8,9,12,0,0,18,15,3,3,0,1,1,0,0,0,0,0,-611,28,-1,1,-3,0,3,0,-1,17.4,10.4,7,2,4,-2,0
15797,15416,295,289,5,5,5,5,2,3,0,0,19,14,2,4,2,0,1,0,0,0,0,0,381,6,0,0,-1,0,5,-2,2,11.2,21.8,-10.6,4,4,0,1
14274,15324,237,247,5,7,7,5,1,5,0,0,16,13,4,3,0,1,0,1,0,0,0,0,-1050,-10,-2,2,-4,0,3,1,-1,14.8,39.8,-25,4,5,-1,0
17004,15296,273,268,9,5,5,9,10,7,1,0,17,13,2,2,1,0,0,1,1,0,0,0,1708,5,4,-4,3,0,4,0,1,16.4,15.4,1,5,4,1,0
14208,15758,278,248,1,8,8,1,0,9,0,0,35,18,3,2,1,0,0,1,0,0,0,0,-1550,30,-7,7,-9,0,17,1,1,18.4,80.8,-62.4,4,4,0,0
19137,16333,253,231,16,7,7,16,15,11,0,0,16,42,3,3,1,1,1,0,0,0,0,0,2804,22,9,-9,4,0,-26,0,0,10,14.6,-4.6,2,1,1,0
15640,14282,252,198,7,6,6,7,12,8,0,0,17,19,5,6,1,0,0,1,0,0,0,0,1358,54,1,-1,4,0,-2,-1,1,14,35,-21,4,3,1,1
13936,14953,269,258,2,5,5,2,2,7,0,0,17,24,1,2,1,0,1,0,0,0,0,0,-1017,11,-3,3,-5,0,-7,-1,1,48.2,54.8,-6.6,4,5,-1,0
14623,14843,249,240,4,6,6,4,5,7,0,0,13,18,2,3,1,0,1,0,0,0,0,0,-220,9,-2,2,-2,0,-5,-1,1,13,105.8,-92.8,4,4,0,1
14616,15373,194,257,7,5,5,7,11,8,0,0,17,13,0,5,0,0,1,0,0,0,0,0,-757,-63,2,-2,3,0,4,-5,0,54.2,19.2,35,5,2,3,1
15202,17145,256,258,4,11,12,4,6,11,0,1,14,22,1,4,2,1,0,1,0,1,0,0,-1943,-2,-7,8,-5,0,-8,-3,1,45.2,115,-69.8,5,3,2,0
15647,17990,261,268,7,11,11,7,4,12,0,1,14,14,3,5,0,0,1,0,0,1,0,0,-2343,-7,-4,4,-8,0,0,-2,0,32.2,34.8,-2.6,3,5,-2,0
15210,14007,305,286,3,1,1,3,5,1,1,0,21,12,3,5,0,0,0,1,1,0,0,0,1203,19,2,-2,4,0,9,-2,0,62.4,59,3.4,5,4,1,1
18024,15348,233,214,12,8,8,12,17,8,0,0,37,16,5,1,2,2,1,0,0,0,0,0,2676,19,4,-4,9,0,21,4,0,109.2,35,74.2,5,4,1,1
14131,14086,275,259,3,3,3,3,1,4,0,1,21,30,0,7,0,0,0,1,0,1,0,0,45,16,0,0,-3,0,-9,-7,0,48.2,31.6,16.6,3,5,-2,1
16260,15258,242,275,9,6,6,9,11,3,0,1,34,17,4,2,0,0,0,1,0,1,0,0,1002,-33,3,-3,8,0,17,2,0,130,107.2,22.8,5,4,1,1
16206,16416,240,226,8,9,9,8,10,10,0,1,139,18,3,5,2,0,1,0,0,1,0,0,-210,14,-1,1,0,0,121,-2,2,30.6,13,17.6,4,2,2,1
13711,15692,262,264,2,7,7,2,0,8,0,0,15,16,2,3,0,0,0,1,0,0,0,0,-1981,-2,-5,5,-8,0,-1,-1,0,11.6,41,-29.4,3,4,-1,0
14236,16357,267,298,3,6,6,3,2,7,1,0,13,17,3,0,0,1,0,1,1,0,0,0,-2121,-31,-3,3,-5,0,-4,3,-1,13.4,89.6,-76.2,4,5,-1,0
16202,15189,246,260,9,5,5,9,9,4,0,0,16,14,3,3,0,0,0,1,0,0,0,0,1013,-14,4,-4,5,0,2,0,0,26.2,16,10.2,4,4,0,1
15361,14750,259,259,6,4,4,7,7,6,1,0,13,15,2,2,1,0,0,1,1,0,0,0,611,0,2,-3,1,0,-2,0,1,28.8,38.2,-9.4,5,4,1,1
14319,15593,269,261,4,7,7,4,2,9,0,0,18,19,4,3,0,1,1,0,0,0,0,0,-1274,8,-3,3,-7,0,-1,1,-1,30.8,18.2,12.6,4,5,-1,0
14562,15562,276,258,3,7,7,3,5,6,1,0,12,16,3,6,2,0,1,0,1,0,0,0,-1000,18,-4,4,-1,0,-4,-3,2,28.8,18.4,10.4,3,4,-1,0
15160,14947,279,300,4,3,3,4,5,3,1,0,21,30,5,3,1,0,0,1,1,0,0,0,213,-21,1,-1,2,0,-9,2,1,60.4,18,42.4,4,4,0,0
15135,15398,237,276,5,4,4,5,7,5,0,0,12,17,7,4,1,1,0,1,0,0,0,0,-263,-39,1,-1,2,0,-5,3,0,16.6,20.2,-3.6,4,3,1,1
17374,15188,278,236,9,5,5,9,15,10,0,0,17,13,0,1,0,0,1,0,0,0,0,0,2186,42,4,-4,5,0,4,-1,0,10.4,36.4,-26,3,4,-1,1
16834,17130,234,260,10,10,10,11,11,13,0,1,15,15,2,1,0,1,1,0,0,1,0,0,-296,-26,0,-1,-2,0,0,1,-1,16,66,-50,5,4,1,0
14731,13913,253,266,5,3,3,5,4,6,0,1,17,35,1,5,0,0,0,1,0,1,0,0,818,-13,2,-2,-2,0,-18,-4,0,28,19.4,8.6,4,4,0,0
14221,14998,246,261,4,5,5,4,3,3,0,0,19,14,2,5,2,0,1,0,0,0,0,0,-777,-15,-1,1,0,0,5,-3,2,19.4,10,9.4,2,4,-2,0
14619,15073,269,241,3,6,6,3,3,9,0,1,14,144,4,3,1,0,0,1,0,1,0,0,-454,28,-3,3,-6,0,-130,1,1,69.8,17.4,52.4,4,5,-1,0
14675,16523,235,227,5,9,9,5,6,12,0,0,20,15,3,3,1,2,0,1,0,0,0,0,-1848,8,-4,4,-6,0,5,0,-1,58.2,55.2,3,3,3,0,0
15241,15864,244,249,6,8,8,6,8,11,0,0,17,15,1,2,0,0,0,1,0,0,0,0,-623,-5,-2,2,-3,0,2,-1,0,35.8,20.8,15,5,2,3,1
14565,14025,286,261,3,2,2,3,6,1,1,0,15,16,7,5,0,2,0,1,1,0,0,0,540,25,1,-1,5,0,-1,2,-2,110,31,79,3,3,0,1
17772,14017,279,267,10,2,3,10,8,2,1,0,12,19,6,1,2,0,0,1,1,0,0,0,3755,12,8,-7,6,0,-7,5,2,82.2,100.2,-18,5,5,0,1
15819,14549,266,264,6,4,4,6,9,2,0,0,14,15,4,3,0,1,0,1,0,0,0,0,1270,2,2,-2,7,0,-1,1,-1,99.4,93.8,5.6,5,5,0,1
18061,14775,271,211,13,5,5,13,17,6,0,0,15,18,8,1,0,1,1,0,0,0,0,0,3286,60,8,-8,11,0,-3,7,-1,27.4,35.8,-8.4,4,5,-1,1
14775,15858,295,244,2,7,7,2,4,9,0,0,17,23,9,2,0,0,0,1,0,0,0,0,-1083,51,-5,5,-5,0,-6,7,0,89,70.2,18.8,5,5,0,1
15976,14449,258,233,6,6,6,6,9,4,0,0,18,28,3,4,0,1,0,1,0,0,0,0,1527,25,0,0,5,0,-10,-1,-1,26.4,55.4,-29,5,4,1,0
14761,14476,262,264,4,3,3,4,6,5,0,0,16,17,3,2,0,1,1,0,0,0,0,0,285,-2,1,-1,1,0,-1,1,-1,56.6,60.8,-4.2,5,4,1,1
15373,13561,280,259,6,1,1,6,10,2,0,0,38,15,3,4,0,0,1,0,0,0,0,0,1812,21,5,-5,8,0,23,-1,0,14.6,47,-32.4,3,3,0,0
15023,14407,273,264,5,2,2,6,7,2,1,0,27,18,4,7,0,2,1,0,1,0,0,0,616,9,3,-4,5,0,9,-3,-2,34.6,20,14.6,4,4,0,1
15232,14380,273,264,5,4,4,5,4,3,0,1,19,17,5,3,2,1,0,1,0,1,0,0,852,9,1,-1,1,0,2,2,1,41,11.8,29.2,4,3,1,1
13827,15212,253,278,3,6,6,3,2,3,0,0,15,22,2,3,0,0,0,1,0,0,0,0,-1385,-25,-3,3,-1,0,-7,-1,0,48.4,20.4,28,5,5,0,0
14602,15969,251,274,3,8,8,3,2,5,0,0,15,18,3,3,0,0,0,1,0,0,0,0,-1367,-23,-5,5,-3,0,-3,0,0,12.4,29,-16.6,3,4,-1,0
14094,17098,235,308,4,9,9,4,2,11,0,1,38,38,1,2,0,1,1,0,0,1,0,0,-3004,-73,-5,5,-9,0,0,-1,-1,151,39.2,111.8,4,4,0,0
16867,13768,292,261,9,2,2,9,6,1,0,0,34,15,2,2,1,0,1,0,0,0,0,0,3099,31,7,-7,5,0,19,0,1,24.6,71.4,-46.8,4,4,0,1
13957,15087,285,298,2,5,5,2,1,1,1,0,16,19,6,4,1,0,1,0,1,0,0,0,-1130,-13,-3,3,0,0,-3,2,1,107.6,40.2,67.4,5,5,0,0
16212,15071,258,230,8,7,7,8,6,7,0,1,35,48,7,2,1,0,0,1,0,1,0,0,1141,28,1,-1,-1,0,-13,5,1,56.4,51.6,4.8,5,4,1,1
13924,18434,241,308,3,12,12,3,5,11,0,1,20,21,3,5,0,5,1,0,0,1,0,0,-4510,-67,-9,9,-6,0,-1,-2,-5,131.4,14.6,116.8,3,4,-1,0
13429,16083,228,288,3,3,3,3,1,2,0,0,32,18,2,4,0,4,1,0,0,0,0,1,-2654,-60,0,0,-1,0,14,-2,-4,15.6,16,-0.4,3,4,-1,0
12799,16620,261,271,0,8,8,0,0,7,0,1,19,23,4,2,0,2,0,1,0,1,0,0,-3821,-10,-8,8,-7,0,-4,2,-2,69.2,108.8,-39.6,5,3,2,0
15912,14583,270,260,7,3,3,7,9,6,0,0,18,13,2,6,1,1,0,1,0,0,0,0,1329,10,4,-4,3,0,5,-4,0,54.8,29.8,25,4,4,0,1
18304,14349,277,250,12,4,4,12,14,2,0,0,13,13,1,0,2,0,1,0,0,0,0,0,3955,27,8,-8,12,0,0,1,2,58,19.8,38.2,4,4,0,1
14606,13432,285,243,3,2,2,3,3,2,0,1,18,14,2,2,0,0,0,1,0,1,0,0,1174,42,1,-1,1,0,4,0,0,39.6,37.2,2.4,3,3,0,0
16312,15839,246,227,9,8,8,9,10,10,0,0,34,37,6,2,2,2,1,0,0,0,0,0,473,19,1,-1,0,0,-3,4,0,70.6,38.2,32.4,4,4,0,1
17221,14387,288,267,8,3,3,8,12,1,0,1,19,15,4,5,2,0,1,0,0,1,0,0,2834,21,5,-5,11,0,4,-1,2,114,15.2,98.8,4,4,0,1
16241,15857,245,252,9,8,8,9,11,2,0,0,15,16,3,2,0,1,1,0,0,0,0,0,384,-7,1,-1,9,0,-1,1,-1,52.6,81.4,-28.8,5,4,1,1
14739,15206,234,281,6,3,3,6,4,4,1,0,160,15,4,4,0,3,0,1,1,0,0,0,-467,-47,3,-3,0,0,145,0,-3,33.6,69.6,-36,3,4,-1,1
14858,13250,308,295,2,0,0,2,3,0,0,0,17,11,3,1,0,0,1,0,0,0,0,0,1608,13,2,-2,3,0,6,2,0,40.4,37.2,3.2,4,5,-1,0
15440,14360,246,285,7,3,3,7,5,2,0,1,14,18,4,3,1,1,1,0,0,1,0,0,1080,-39,4,-4,3,0,-4,1,0,46.4,17,29.4,4,4,0,1
14770,14778,272,279,4,4,4,4,5,6,0,1,13,15,3,1,0,2,1,0,0,1,0,0,-8,-7,0,0,-1,0,-2,2,-2,17,9.2,7.8,4,4,0,0
17952,16396,251,252,12,8,8,12,15,10,0,0,17,18,5,1,4,0,1,0,0,0,0,0,1556,-1,4,-4,5,0,-1,4,4,14.4,50.8,-36.4,3,5,-2,1
15949,14632,300,290,4,3,3,4,3,3,0,1,14,20,8,2,3,0,0,1,0,1,0,0,1317,10,1,-1,0,0,-6,6,3,7,26.6,-19.6,4,3,1,0
15202,15920,252,275,5,7,7,6,5,8,0,0,11,13,2,2,0,1,0,1,0,0,0,0,-718,-23,-2,1,-3,0,-2,0,-1,20.6,7.6,13,3,4,-1,0
16283,15868,240,226,10,8,8,10,7,10,1,0,14,17,2,1,0,0,0,1,1,0,0,0,415,14,2,-2,-3,0,-3,1,0,30.8,17.4,13.4,5,4,1,0
15030,14709,254,268,5,4,4,5,9,1,1,0,24,10,1,6,0,3,0,1,1,0,0,0,321,-14,1,-1,8,0,14,-5,-3,27.2,7.8,19.4,4,1,3,0
17922,13622,275,266,9,2,3,9,16,2,0,1,17,13,0,3,4,1,1,0,0,1,0,0,4300,9,7,-6,14,0,4,-3,3,19.8,42.6,-22.8,5,4,1,1
15510,14034,249,255,7,4,4,7,7,1,0,1,120,14,0,0,0,0,1,0,0,1,0,0,1476,-6,3,-3,6,0,106,0,0,42.8,17.4,25.4,5,3,2,1
16762,14920,285,272,7,4,4,7,8,3,1,0,21,16,3,2,0,0,1,0,1,0,0,0,1842,13,3,-3,5,0,5,1,0,86.4,6.4,80,4,2,2,1
17195,14025,292,252,9,3,3,9,6,4,0,0,14,22,6,1,1,0,1,0,0,0,0,0,3170,40,6,-6,2,0,-8,5,1,101.6,18.8,82.8,4,3,1,1
14947,14916,274,293,5,3,3,5,5,4,0,0,19,15,3,2,0,0,1,0,0,0,0,0,31,-19,2,-2,1,0,4,1,0,43.8,34.4,9.4,5,5,0,1
14500,14926,225,232,6,6,6,6,2,5,1,0,22,121,1,3,1,0,1,0,1,0,0,0,-426,-7,0,0,-3,0,-99,-2,1,16.6,12.4,4.2,4,3,1,0
15006,14387,248,258,7,3,3,7,7,5,0,0,110,16,3,6,0,0,1,0,0,0,0,0,619,-10,4,-4,2,0,94,-3,0,43,60.2,-17.2,5,3,2,1
14314,14689,262,278,3,4,4,3,5,4,0,1,16,12,3,4,0,0,0,1,0,1,0,0,-375,-16,-1,1,1,0,4,-1,0,14.6,30.6,-16,4,5,-1,0
16745,14065,284,252,7,3,3,7,9,7,0,0,21,16,1,5,0,1,1,0,0,0,0,0,2680,32,4,-4,2,0,5,-4,-1,30.4,34.8,-4.4,3,2,1,1
16405,14501,251,268,9,3,4,9,14,4,1,0,16,19,2,0,0,0,1,0,1,0,0,0,1904,-17,6,-5,10,0,-3,2,0,32,75.8,-43.8,4,5,-1,0
15814,15761,257,273,7,6,6,7,8,6,0,0,39,15,3,3,1,1,0,1,0,0,0,0,53,-16,1,-1,2,0,24,0,0,67,42.6,24.4,4,3,1,1
15165,15505,272,257,4,6,6,4,5,8,0,0,13,33,4,2,0,1,0,1,0,0,0,0,-340,15,-2,2,-3,0,-20,2,-1,21.2,98.4,-77.2,3,5,-2,1
14148,15782,229,246,4,8,8,4,3,8,0,1,14,16,1,1,0,1,0,1,0,1,0,0,-1634,-17,-4,4,-5,0,-2,0,-1,39.4,16.6,22.8,4,3,1,1
15252,15083,268,258,5,5,5,5,5,5,0,0,18,28,3,2,0,0,0,1,0,0,0,0,169,10,0,0,0,0,-10,1,0,21.6,14.4,7.2,4,3,1,1
15099,14220,282,265,4,3,3,4,5,2,0,1,13,11,2,2,1,1,1,0,0,1,0,0,879,17,1,-1,3,0,2,0,0,34.2,18.2,16,3,2,1,1
15012,15472,271,293,5,5,5,5,5,6,1,0,20,17,7,4,0,0,0,1,1,0,0,0,-460,-22,0,0,-1,0,3,3,0,44.2,9.8,34.4,5,3,2,1
14553,15500,238,278,5,5,5,5,4,7,0,1,19,13,3,4,0,2,0,1,0,1,0,0,-947,-40,0,0,-3,0,6,-1,-2,53.4,60.2,-6.8,2,4,-2,0
13963,14059,250,267,3,3,3,3,4,0,0,0,10,24,6,1,0,3,0,1,0,0,0,0,-96,-17,0,0,4,0,-14,5,-3,17.6,64,-46.4,3,4,-1,0
14100,12583,232,208,6,2,2,6,7,2,1,0,23,12,3,1,3,0,1,0,1,0,0,0,1517,24,4,-4,5,0,11,2,3,29.2,80.8,-51.6,4,5,-1,1
15479,13660,281,266,7,2,2,7,3,3,1,0,12,18,2,0,0,0,1,0,1,0,0,0,1819,15,5,-5,0,0,-6,2,0,56,32.6,23.4,5,2,3,1
14334,14219,296,276,2,2,2,2,1,2,0,1,27,16,1,1,0,0,1,0,0,1,0,0,115,20,0,0,-1,0,11,0,0,60.2,22.2,38,5,4,1,0
16229,14217,305,259,7,3,3,7,4,6,0,0,18,30,3,4,0,1,1,0,0,0,0,0,2012,46,4,-4,-2,0,-12,-1,-1,19.2,142.4,-123.2,2,4,-2,1
14314,14683,252,287,4,3,3,4,4,1,0,0,21,20,6,1,0,1,1,0,0,0,0,0,-369,-35,1,-1,3,0,1,5,-1,24.4,21.2,3.2,3,4,-1,1
18935,15811,222,233,15,7,7,15,19,10,1,0,17,13,4,3,2,0,1,0,1,0,0,0,3124,-11,8,-8,9,0,4,1,2,39.2,46.4,-7.2,3,5,-2,1
16224,15093,258,246,7,5,5,7,10,8,0,0,18,146,3,6,2,1,1,0,0,0,0,0,1131,12,2,-2,2,0,-128,-3,1,48.6,27.6,21,4,5,-1,1
14664,14791,250,281,5,4,4,5,4,8,0,0,28,16,2,3,2,0,1,0,0,0,0,0,-127,-31,1,-1,-4,0,12,-1,2,47.8,13.4,34.4,4,3,1,0
13709,16671,256,258,2,9,9,2,1,14,0,0,22,17,1,1,1,2,0,1,0,0,0,0,-2962,-2,-7,7,-13,0,5,0,-1,53,39,14,4,4,0,0
14832,14467,278,263,3,4,4,3,6,6,0,0,16,15,3,3,1,0,0,1,0,0,0,0,365,15,-1,1,0,0,1,0,1,41.2,22,19.2,4,3,1,0
14380,14515,274,299,2,2,2,2,2,3,0,0,16,42,3,3,0,0,1,0,0,0,0,0,-135,-25,0,0,-1,0,-26,0,0,31,24.2,6.8,4,4,0,0
16605,15724,239,262,10,5,5,10,15,8,0,0,37,15,2,4,2,2,1,0,0,0,0,0,881,-23,5,-5,7,0,22,-2,0,24,31.4,-7.4,4,5,-1,0
15054,15428,239,275,5,5,5,5,11,9,0,0,16,18,5,2,0,0,1,0,0,0,0,0,-374,-36,0,0,2,0,-2,3,0,26.4,30.6,-4.2,4,5,-1,0
16924,13251,280,245,8,2,2,8,9,1,0,0,15,14,5,2,1,0,1,0,0,0,0,0,3673,35,6,-6,8,0,1,3,1,4.8,9.2,-4.4,1,3,-2,1
15872,16982,228,248,8,10,10,8,8,7,0,1,40,20,5,2,0,4,0,1,0,1,0,0,-1110,-20,-2,2,1,0,20,3,-4,6.4,20.8,-14.4,2,5,-3,0
14707,15260,264,271,4,6,6,4,4,6,0,1,17,18,5,3,0,0,1,0,0,1,0,0,-553,-7,-2,2,-2,0,-1,2,0,9.4,33.4,-24,4,4,0,0
15045,14732,276,270,4,4,5,4,4,5,0,1,26,29,3,3,1,1,1,0,0,1,0,0,313,6,0,1,-1,0,-3,0,0,44.2,16.8,27.4,4,4,0,1
12745,16765,234,257,2,9,9,2,1,7,0,0,11,15,1,2,0,1,1,0,0,0,0,0,-4020,-23,-7,7,-6,0,-4,-1,-1,8.6,13,-4.4,3,3,0,0
14044,15063,249,262,3,4,4,3,4,7,0,0,14,23,2,3,0,0,0,1,0,0,0,0,-1019,-13,-1,1,-3,0,-9,-1,0,24.2,107.8,-83.6,3,5,-2,0
14741,13265,303,258,2,1,1,2,2,2,0,0,36,18,4,3,1,0,1,0,0,0,0,0,1476,45,1,-1,0,0,18,1,1,30.6,22.2,8.4,4,4,0,1
15843,15542,267,245,7,6,6,7,5,7,0,1,24,15,1,3,2,0,1,0,0,1,0,0,301,22,1,-1,-2,0,9,-2,2,65.6,154,-88.4,3,4,-1,1
13897,15659,232,254,3,6,6,3,3,7,0,1,16,18,3,5,1,2,0,1,0,1,0,0,-1762,-22,-3,3,-4,0,-2,-2,-1,19.2,19.6,-0.4,3,4,-1,0
15755,13357,263,221,7,3,3,7,7,2,0,0,22,34,2,2,1,0,1,0,0,0,0,0,2398,42,4,-4,5,0,-12,0,1,36.8,24.4,12.4,5,4,1,1
15209,17711,268,280,5,9,9,5,5,13,0,0,87,15,3,5,0,1,0,1,0,0,0,0,-2502,-12,-4,4,-8,0,72,-2,-1,25.4,41.2,-15.8,3,4,-1,0
14557,16749,255,287,5,7,7,5,9,11,0,0,117,37,14,2,0,0,0,1,0,0,0,0,-2192,-32,-2,2,-2,0,80,12,0,35.6,36.6,-1,5,5,0,0
15065,16642,243,271,5,7,7,5,5,7,0,0,11,33,5,2,1,1,1,0,0,0,0,0,-1577,-28,-2,2,-2,0,-22,3,0,33.4,48,-14.6,2,4,-2,0
14577,14234,220,266,5,3,3,5,6,6,0,0,12,207,0,2,2,1,1,0,0,0,0,0,343,-46,2,-2,0,0,-195,-2,1,26.8,17.6,9.2,3,4,-1,1
15503,15358,268,239,6,7,7,6,5,7,0,1,18,14,3,3,0,1,0,1,0,1,0,0,145,29,-1,1,-2,0,4,0,-1,86.6,46.6,40,5,4,1,0
15066,15627,284,259,5,5,5,5,2,5,0,0,155,13,4,3,1,1,1,0,0,0,0,0,-561,25,0,0,-3,0,142,1,0,19.4,18.4,1,3,4,-1,0
14501,16056,272,281,2,7,7,2,2,5,0,0,16,55,4,2,2,1,0,1,0,0,0,0,-1555,-9,-5,5,-3,0,-39,2,1,12.6,29.6,-17,3,3,0,0
15174,15088,287,282,4,4,4,4,6,6,0,1,14,63,3,4,0,0,1,0,0,1,0,0,86,5,0,0,0,0,-49,-1,0,59.6,16.2,43.4,3,3,0,1
15964,15604,253,253,8,6,6,8,5,8,0,0,40,19,6,1,1,1,1,0,0,0,0,0,360,0,2,-2,-3,0,21,5,0,73.8,11.2,62.6,4,4,0,1
16135,15783,229,262,7,6,6,7,9,6,1,0,14,30,2,2,0,1,0,1,1,0,0,0,352,-33,1,-1,3,0,-16,0,-1,48.8,12.8,36,5,3,2,1
14506,14412,272,276,4,3,3,4,2,3,0,0,16,19,3,6,1,1,1,0,0,0,0,0,94,-4,1,-1,-1,0,-3,-3,0,15.2,33.2,-18,4,5,-1,0
15916,14239,284,295,7,1,1,7,8,1,1,0,25,13,1,5,1,0,1,0,1,0,0,0,1677,-11,6,-6,7,0,12,-4,1,20,17,3,5,5,0,1
16336,15231,249,259,8,6,7,8,13,5,0,0,15,31,5,4,0,2,0,1,0,0,0,0,1105,-10,2,-1,8,0,-16,1,-2,76.8,30,46.8,4,5,-1,1
17516,13831,269,250,10,2,2,10,14,1,0,0,24,14,5,4,1,1,1,0,0,0,0,0,3685,19,8,-8,13,0,10,1,0,115.4,62.4,53,4,3,1,0
14712,15829,246,279,4,6,6,4,6,6,0,0,19,17,0,4,0,1,0,1,0,0,0,0,-1117,-33,-2,2,0,0,2,-4,-1,50.6,94.2,-43.6,4,5,-1,0
14858,16499,249,281,5,7,7,5,5,6,0,0,15,41,1,5,1,3,1,0,0,0,0,0,-1641,-32,-2,2,-1,0,-26,-4,-2,53.4,43,10.4,4,4,0,0
17433,14324,230,205,12,6,6,12,22,7,0,1,23,18,2,1,1,0,0,1,0,1,0,0,3109,25,6,-6,15,0,5,1,1,102.6,63.8,38.8,5,5,0,1
16862,15676,251,277,9,5,5,9,14,4,0,0,16,37,2,2,0,2,0,1,0,0,0,0,1186,-26,4,-4,10,0,-21,0,-2,87.2,176,-88.8,4,3,1,1
13730,15119,257,229,2,7,7,2,1,10,0,0,17,21,5,3,0,0,0,1,0,0,0,0,-1389,28,-5,5,-9,0,-4,2,0,47.6,44.6,3,2,4,-2,1
12823,16464,245,270,1,7,7,1,0,10,0,1,38,17,1,7,1,2,0,1,0,1,0,0,-3641,-25,-6,6,-10,0,21,-6,-1,62.6,37.8,24.8,3,5,-2,0
15107,14195,305,273,3,2,2,3,2,3,0,0,21,15,2,2,1,0,0,1,0,0,0,0,912,32,1,-1,-1,0,6,0,1,58.2,76,-17.8,4,4,0,0
13253,17592,251,289,2,9,9,2,4,9,0,1,15,15,4,2,0,3,1,0,0,1,0,0,-4339,-38,-7,7,-5,0,0,2,-3,17,54.4,-37.4,4,4,0,0
14879,13958,269,291,5,1,1,5,7,0,0,1,16,18,6,2,0,2,1,0,0,1,0,0,921,-22,4,-4,7,0,-2,4,-2,18.2,41.2,-23,5,3,2,0
13876,13648,274,301,2,0,0,2,2,0,0,1,25,19,3,5,0,2,1,0,0,1,0,0,228,-27,2,-2,2,0,6,-2,-2,20.4,167.8,-147.4,3,5,-2,1
17314,16123,273,237,10,7,7,10,7,13,1,0,18,13,4,3,1,0,1,0,1,0,0,0,1191,36,3,-3,-6,0,5,1,1,170.2,18.2,152,3,2,1,1
15102,14985,253,241,6,6,6,6,6,6,0,1,21,20,0,3,1,1,0,1,0,1,0,0,117,12,0,0,0,0,1,-3,0,9.4,90.6,-81.2,2,2,0,0
15904,15526,255,295,7,5,5,7,11,5,0,0,14,17,0,5,0,0,1,0,0,0,0,0,378,-40,2,-2,6,0,-3,-5,0,58.8,11.4,47.4,5,3,2,0
14505,13862,294,282,2,1,1,2,2,1,1,0,20,18,5,6,1,1,1,0,1,0,0,0,643,12,1,-1,1,0,2,-1,0,22,65.8,-43.8,5,5,0,0
15814,13913,268,257,7,3,3,7,4,2,0,0,17,17,2,2,3,1,1,0,0,0,0,0,1901,11,4,-4,2,0,0,0,2,54.2,38.2,16,4,4,0,1
15885,14558,257,228,6,5,5,6,7,7,0,0,129,36,3,4,2,0,1,0,0,0,0,0,1327,29,1,-1,0,0,93,-1,2,14,24,-10,4,4,0,1
13107,14218,280,280,0,3,3,0,0,5,0,0,15,14,1,2,0,0,0,1,0,0,0,0,-1111,0,-3,3,-5,0,1,-1,0,7.8,19.8,-12,2,3,-1,0
14499,13991,246,272,4,3,3,4,4,1,0,0,16,163,1,4,0,0,0,1,0,0,0,0,508,-26,1,-1,3,0,-147,-3,0,47.6,16.8,30.8,4,5,-1,1
15603,14546,255,279,7,4,4,7,7,2,0,1,13,13,3,3,0,0,0,1,0,1,0,0,1057,-24,3,-3,5,0,0,0,0,33.6,47,-13.4,5,5,0,1
13659,15259,270,304,1,3,3,1,2,8,0,0,24,17,1,3,0,0,0,1,0,0,0,0,-1600,-34,-2,2,-6,0,7,-2,0,41.2,33.6,7.6,3,2,1,0
15526,13824,246,247,8,2,2,8,8,3,1,0,18,20,2,1,0,0,1,0,1,0,0,0,1702,-1,6,-6,5,0,-2,1,0,26.4,13.4,13,3,4,-1,1
14021,17191,286,254,3,10,10,3,0,10,0,0,16,53,2,4,1,1,0,1,0,0,0,0,-3170,32,-7,7,-10,0,-37,-2,0,76.2,21,55.2,4,4,0,0
14068,14171,286,269,2,2,2,2,1,2,1,0,15,17,4,5,0,0,1,0,1,0,0,0,-103,17,0,0,-1,0,-2,-1,0,38,32,6,4,4,0,0
12915,16824,223,256,2,9,9,2,6,17,0,1,16,16,1,5,0,0,0,1,0,1,0,0,-3909,-33,-7,7,-11,0,0,-4,0,11.4,7,4.4,4,2,2,1
15067,15428,243,267,5,5,5,5,5,6,0,1,16,14,3,2,2,1,1,0,0,1,0,0,-361,-24,0,0,-1,0,2,1,1,46.2,42.2,4,3,3,0,0
16313,14220,285,286,6,3,3,6,9,0,0,0,18,12,2,1,0,0,0,1,0,0,0,0,2093,-1,3,-3,9,0,6,1,0,17.6,31.4,-13.8,5,5,0,1
15299,14784,286,254,4,5,5,4,4,5,0,0,18,17,4,2,1,0,0,1,0,0,0,0,515,32,-1,1,-1,0,1,2,1,181.8,4.8,177,5,1,4,0
15807,14174,242,220,7,4,4,7,10,8,0,0,20,16,4,4,2,0,1,0,0,0,0,0,1633,22,3,-3,2,0,4,0,2,59.6,9.2,50.4,4,2,2,1
14793,14810,288,272,3,4,4,4,2,11,0,0,19,24,2,3,1,1,0,1,0,0,0,0,-17,16,-1,0,-9,0,-5,-1,0,72.4,76,-3.6,3,4,-1,0
14317,15411,226,274,4,5,5,4,9,8,1,0,12,19,5,1,0,3,0,1,1,0,0,0,-1094,-48,-1,1,1,0,-7,4,-3,62,14.4,47.6,4,4,0,1
15704,15892,279,261,6,7,7,6,11,14,0,1,16,15,4,3,0,0,1,0,0,1,0,0,-188,18,-1,1,-3,0,1,1,0,19.6,16,3.6,2,3,-1,1
16424,16517,215,254,8,9,9,8,12,10,0,0,19,106,0,1,2,4,0,1,0,0,0,0,-93,-39,-1,1,2,0,-87,-1,-2,52.8,41,11.8,3,5,-2,0
16776,13808,301,228,6,3,3,6,6,3,0,1,16,15,4,0,1,0,0,1,0,1,0,0,2968,73,3,-3,3,0,1,4,1,18.2,42.2,-24,3,4,-1,1
15162,16012,237,267,6,8,8,6,10,9,1,0,37,16,5,3,0,0,1,0,1,0,0,0,-850,-30,-2,2,1,0,21,2,0,183.4,123.2,60.2,3,3,0,0
14531,18299,239,300,5,9,9,5,7,15,0,0,23,111,1,4,0,1,1,0,0,0,0,0,-3768,-61,-4,4,-8,0,-88,-3,-1,15.8,41.4,-25.6,4,4,0,0
16342,14803,301,298,7,3,3,7,6,4,0,1,21,17,5,3,0,0,1,0,0,1,0,0,1539,3,4,-4,2,0,4,2,0,76.6,47.2,29.4,4,5,-1,1
14073,16387,229,262,3,9,9,3,4,15,0,1,35,19,5,6,0,0,0,1,0,1,0,0,-2314,-33,-6,6,-11,0,16,-1,0,17.6,43,-25.4,4,4,0,0
14503,13533,282,274,2,1,1,2,2,1,0,0,16,16,3,2,2,1,0,1,0,0,0,0,970,8,1,-1,1,0,0,1,1,121.2,68.4,52.8,4,5,-1,1
16006,15799,284,250,7,7,7,7,7,9,0,0,116,18,6,4,1,0,0,1,0,0,0,0,207,34,0,0,-2,0,98,2,1,38.4,47.2,-8.8,4,4,0,0
15501,14657,277,281,6,3,3,6,3,4,0,0,16,20,5,5,0,0,1,0,0,0,0,0,844,-4,3,-3,-1,0,-4,0,0,14.4,10.6,3.8,4,3,1,0
15542,16357,255,243,5,9,9,5,6,6,0,0,32,16,1,2,2,0,0,1,0,0,0,0,-815,12,-4,4,0,0,16,-1,2,77.8,32.6,45.2,5,5,0,1
14799,14035,246,250,5,3,3,5,6,4,0,0,16,15,2,3,0,1,1,0,0,0,0,0,764,-4,2,-2,2,0,1,-1,-1,110.8,24.6,86.2,5,4,1,0
14269,15042,245,266,4,4,4,4,3,7,0,0,15,32,2,2,0,1,0,1,0,0,0,0,-773,-21,0,0,-4,0,-17,0,-1,52.4,17,35.4,2,5,-3,0
14354,16347,213,259,6,8,8,6,11,7,0,0,17,16,4,4,0,1,1,0,0,0,0,0,-1993,-46,-2,2,4,0,1,0,-1,23.2,25.8,-2.6,3,3,0,0
14339,15827,278,288,3,5,5,3,2,5,0,0,15,114,1,2,1,1,1,0,0,0,0,0,-1488,-10,-2,2,-3,0,-99,-1,0,45.6,28,17.6,4,3,1,1
14191,14282,258,275,3,3,3,3,3,4,0,0,20,10,1,5,0,0,0,1,0,0,0,0,-91,-17,0,0,-1,0,10,-4,0,48.6,38.4,10.2,3,3,0,0
15120,15721,271,278,5,6,6,5,5,4,1,0,13,17,7,4,0,1,0,1,1,0,0,0,-601,-7,-1,1,1,0,-4,3,-1,17,25,-8,4,5,-1,0
15611,15379,274,257,5,6,6,5,7,6,1,0,18,37,7,2,1,0,1,0,1,0,0,0,232,17,-1,1,1,0,-19,5,1,112.6,13.4,99.2,4,4,0,0
15103,12900,286,238,4,1,1,4,9,1,1,0,25,34,4,2,0,0,1,0,1,0,0,0,2203,48,3,-3,8,0,-9,2,0,17,12,5,3,3,0,1
14736,16329,279,294,3,6,6,3,5,11,0,0,16,17,5,3,0,0,0,1,0,0,0,0,-1593,-15,-3,3,-6,0,-1,2,0,20.2,10.4,9.8,5,4,1,0
14915,16510,259,276,4,7,7,4,3,11,0,0,205,14,2,2,1,2,0,1,0,0,0,0,-1595,-17,-3,3,-8,0,191,0,-1,45,11,34,3,3,0,0
15529,14764,244,262,7,4,4,7,4,5,1,0,17,17,2,1,1,0,1,0,1,0,0,0,765,-18,3,-3,-1,0,0,1,1,18,36.8,-18.8,3,5,-2,1
14222,15033,258,282,3,4,4,3,4,6,1,0,18,15,0,9,0,1,0,1,1,0,0,0,-811,-24,-1,1,-2,0,3,-9,-1,15.2,13.8,1.4,5,2,3,1
15374,15232,252,232,7,6,6,7,7,7,0,1,16,15,0,4,0,0,0,1,0,1,0,0,142,20,1,-1,0,0,1,-4,0,16.8,25.4,-8.6,5,3,2,0
12811,17634,238,288,1,13,13,1,2,9,0,1,10,12,1,4,0,1,0,1,0,1,0,0,-4823,-50,-12,12,-7,0,-2,-3,-1,19.6,35.2,-15.6,3,4,-1,0
13930,14033,293,270,1,3,3,1,0,3,0,0,21,36,2,4,1,0,0,1,0,0,0,0,-103,23,-2,2,-3,0,-15,-2,1,12.8,47,-34.2,4,5,-1,0
15698,14093,278,238,8,4,5,8,5,3,0,0,20,26,2,6,2,0,1,0,0,0,0,0,1605,40,4,-3,2,0,-6,-4,2,78.6,49,29.6,5,4,1,0
14348,16479,268,273,4,7,7,4,1,6,1,0,35,18,5,2,0,1,0,1,1,0,0,0,-2131,-5,-3,3,-5,0,17,3,-1,30.8,14.2,16.6,4,5,-1,1
14262,14487,246,254,3,4,4,3,3,4,0,0,14,41,2,5,1,0,1,0,0,0,0,0,-225,-8,-1,1,-1,0,-27,-3,1,43.8,31,12.8,5,3,2,1
15238,14401,282,295,4,2,2,4,5,2,0,1,14,53,4,1,0,1,1,0,0,1,0,0,837,-13,2,-2,3,0,-39,3,-1,45.8,8.8,37,4,2,2,1
15736,15899,264,255,6,7,7,6,7,8,0,0,16,40,2,3,2,1,1,0,0,0,0,0,-163,9,-1,1,-1,0,-24,-1,1,11.6,25,-13.4,3,2,1,0
15221,15089,245,260,7,6,6,7,4,7,0,0,18,13,1,5,0,0,0,1,0,0,0,0,132,-15,1,-1,-3,0,5,-4,0,32,42,-10,3,4,-1,0
15942,16131,242,265,8,7,7,8,13,13,0,1,15,14,1,2,0,0,0,1,0,1,0,0,-189,-23,1,-1,0,0,1,-1,0,7.8,34.6,-26.8,2,5,-3,0
14202,14621,231,231,5,5,6,5,4,7,0,0,15,20,5,1,0,2,1,0,0,0,0,0,-419,0,0,1,-3,0,-5,4,-2,40.6,50.6,-10,3,4,-1,0
15793,13879,274,264,7,2,3,7,4,3,0,1,16,17,2,3,0,0,1,0,0,1,0,0,1914,10,5,-4,1,0,-1,-1,0,62.2,35.6,26.6,3,5,-2,1
13856,14409,276,275,1,3,3,1,1,3,1,0,18,20,4,4,1,1,0,1,1,0,0,0,-553,1,-2,2,-2,0,-2,0,0,46.4,33.2,13.2,4,4,0,0
15901,13974,262,222,8,4,4,8,10,3,0,0,19,17,5,1,2,0,0,1,0,0,0,0,1927,40,4,-4,7,0,2,4,2,37.8,50.8,-13,4,3,1,1
14658,15222,237,260,5,6,6,5,8,6,0,0,25,15,3,3,0,0,1,0,0,0,0,0,-564,-23,-1,1,2,0,10,0,0,86,60.6,25.4,3,5,-2,0
14481,14781,231,248,5,6,6,5,4,5,0,0,25,19,5,4,0,0,1,0,0,0,0,0,-300,-17,-1,1,-1,0,6,1,0,23.4,19.6,3.8,4,3,1,1
14416,15400,266,247,3,6,6,3,3,6,0,0,14,16,1,4,0,0,1,0,0,0,0,0,-984,19,-3,3,-3,0,-2,-3,0,11.6,18,-6.4,4,4,0,0
15795,13159,303,274,5,1,1,5,8,1,0,0,11,15,3,0,0,0,1,0,0,0,0,0,2636,29,4,-4,7,0,-4,3,0,20,24.6,-4.6,5,5,0,1
16571,15843,236,250,9,8,8,9,12,9,0,0,18,19,10,3,2,0,0,1,0,0,0,0,728,-14,1,-1,3,0,-1,7,2,21.8,18.4,3.4,3,4,-1,0
15871,15192,281,272,6,5,5,6,7,5,0,0,17,11,3,6,1,0,0,1,0,0,0,0,679,9,1,-1,2,0,6,-3,1,111,67.4,43.6,3,4,-1,1
14933,14806,241,264,5,4,4,5,8,3,1,0,14,19,3,1,0,1,0,1,1,0,0,0,127,-23,1,-1,5,0,-5,2,-1,110,9.4,100.6,5,3,2,1
17200,15337,265,249,10,7,7,10,10,7,0,0,16,17,0,2,0,0,1,0,0,0,0,0,1863,16,3,-3,3,0,-1,-2,0,26.6,12.4,14.2,5,3,2,1
15063,16884,243,277,6,9,9,6,6,4,0,0,13,16,2,3,0,1,1,0,0,0,0,0,-1821,-34,-3,3,2,0,-3,-1,-1,88,27,61,5,4,1,0
17751,14682,256,261,13,5,5,13,17,4,0,1,16,17,1,2,0,0,0,1,0,1,0,0,3069,-5,8,-8,13,0,-1,-1,0,108,9.8,98.2,5,2,3,1
14912,15620,249,294,4,5,5,4,4,5,0,1,16,13,1,3,3,2,0,1,0,1,0,0,-708,-45,-1,1,-1,0,3,-2,1,56.6,31.6,25,5,4,1,1
14474,15053,271,259,3,6,6,3,4,6,0,1,8,18,2,0,2,1,0,1,0,1,0,0,-579,12,-3,3,-2,0,-10,2,1,101.4,64.2,37.2,5,5,0,1
16774,15808,234,256,9,7,7,10,13,9,0,0,15,39,2,3,0,2,0,1,0,0,0,0,966,-22,2,-3,4,0,-24,-1,-2,21.8,12,9.8,4,4,0,1
16089,14794,241,258,8,5,5,8,8,3,0,1,16,16,4,4,2,1,1,0,0,1,0,0,1295,-17,3,-3,5,0,0,0,1,168.6,22.8,145.8,5,2,3,1
16511,16068,236,251,9,7,7,9,8,11,0,0,19,19,3,5,0,1,0,1,0,0,0,0,443,-15,2,-2,-3,0,0,-2,-1,19.2,92.2,-73,5,4,1,0
14500,14249,266,258,4,3,3,5,3,2,0,0,16,25,4,2,0,1,1,0,0,0,0,0,251,8,1,-2,1,0,-9,2,-1,60,62.2,-2.2,5,4,1,1
15094,13919,257,242,6,3,3,6,10,7,0,1,19,20,6,4,0,0,0,1,0,1,0,0,1175,15,3,-3,3,0,-1,2,0,18,19,-1,3,4,-1,1
15071,14297,250,250,5,4,4,5,5,4,0,0,17,72,3,3,1,0,1,0,0,0,0,0,774,0,1,-1,1,0,-55,0,1,31.8,26.6,5.2,4,2,2,1
15478,13803,242,231,7,3,3,8,5,4,1,0,18,36,2,3,2,0,1,0,1,0,0,0,1675,11,4,-5,1,0,-18,-1,2,18.4,49.8,-31.4,2,5,-3,1
14566,15799,265,239,4,8,8,5,3,8,1,0,16,18,4,3,0,0,0,1,1,0,0,0,-1233,26,-4,3,-5,0,-2,1,0,16.4,65.8,-49.4,4,3,1,1
14072,14350,254,277,4,3,3,4,3,2,0,1,18,18,1,4,0,0,0,1,0,1,0,0,-278,-23,1,-1,1,0,0,-3,0,19.8,105.4,-85.6,5,5,0,1
13129,16304,277,258,0,8,8,0,0,10,0,0,13,17,5,2,0,0,0,1,0,0,0,0,-3175,19,-8,8,-10,0,-4,3,0,18.2,14.2,4,4,3,1,0
14315,15499,247,263,4,6,6,4,3,7,0,1,38,18,4,2,1,0,0,1,0,1,0,0,-1184,-16,-2,2,-4,0,20,2,1,45,20.2,24.8,4,4,0,1
14778,14642,270,250,4,5,5,4,4,5,0,1,15,67,2,3,1,0,0,1,0,1,0,0,136,20,-1,1,-1,0,-52,-1,1,12.4,14,-1.6,3,3,0,0
15208,14240,272,220,5,5,5,5,7,5,1,0,15,37,5,0,0,0,0,1,1,0,0,0,968,52,0,0,2,0,-22,5,0,32.4,35.8,-3.4,5,5,0,1
16166,14145,311,260,5,2,2,5,5,3,0,0,22,22,2,2,0,1,1,0,0,0,0,0,2021,51,3,-3,2,0,0,0,-1,33.8,56.6,-22.8,3,4,-1,1
15966,13517,276,271,7,2,2,7,7,2,0,0,10,15,2,3,1,1,1,0,0,0,0,0,2449,5,5,-5,5,0,-5,-1,0,46.2,26,20.2,4,4,0,1
12684,16429,256,309,0,5,5,0,0,6,0,0,18,19,1,5,0,1,0,1,0,0,0,0,-3745,-53,-5,5,-6,0,-1,-4,-1,12,20.6,-8.6,4,4,0,0
16025,15281,224,264,9,4,4,9,12,2,0,0,16,15,3,3,2,2,1,0,0,0,0,0,744,-40,5,-5,10,0,1,0,0,99.8,19.6,80.2,2,4,-2,1
14850,14769,251,284,5,3,4,5,4,2,1,0,110,18,4,1,1,1,1,0,1,0,0,0,81,-33,2,-1,2,0,92,3,0,12.4,12,0.4,3,3,0,1
15195,16360,248,244,5,9,9,5,5,10,0,0,14,16,4,4,0,0,0,1,0,0,0,0,-1165,4,-4,4,-5,0,-2,0,0,17,39,-22,5,3,2,1
2556,2577,0,1,0,0,0,0,0,0,0,0,0,1,0,0,0,0,0,0,0,0,0,0,-21,-1,0,0,0,0,-1,0,0,23.8,9.8,14,4,3,1,0
14914,15725,291,266,3,6,6,3,5,13,0,0,26,36,1,4,2,0,1,0,0,0,0,0,-811,25,-3,3,-8,0,-10,-3,2,53.4,5.4,48,4,1,3,0
16096,14356,272,270,7,2,2,7,10,4,0,0,32,35,0,2,1,0,1,0,0,0,0,0,1740,2,5,-5,6,0,-3,-2,1,37.2,157.4,-120.2,4,3,1,1
15764,15130,265,252,7,5,5,7,7,7,0,1,16,16,0,2,1,1,1,0,0,1,0,0,634,13,2,-2,0,0,0,-2,0,62.2,17.8,44.4,3,3,0,1
15180,17037,256,238,6,11,11,6,5,6,0,0,17,36,4,3,0,1,0,1,0,0,0,0,-1857,18,-5,5,-1,0,-19,1,-1,16.4,62.6,-46.2,4,5,-1,1
16897,14806,286,270,8,3,3,8,9,3,0,1,17,19,5,4,0,0,1,0,0,1,0,0,2091,16,5,-5,6,0,-2,1,0,24.8,28.8,-4,3,4,-1,1
13530,16128,259,274,2,6,6,2,3,8,0,0,13,17,1,2,0,1,0,1,0,0,0,0,-2598,-15,-4,4,-5,0,-4,-1,-1,68.4,18.2,50.2,3,4,-1,0
15537,13627,284,265,5,2,2,5,6,1,1,0,21,11,5,4,0,1,1,0,1,0,0,0,1910,19,3,-3,5,0,10,1,-1,20.6,57.4,-36.8,4,4,0,1
13619,17338,211,271,4,11,11,4,4,12,0,0,12,120,1,3,0,1,0,1,0,0,0,0,-3719,-60,-7,7,-8,0,-108,-2,-1,23,73.6,-50.6,3,4,-1,0
15194,15007,261,244,5,5,6,5,5,5,0,0,15,16,2,2,0,0,0,1,0,0,0,0,187,17,0,1,0,0,-1,0,0,9.6,71,-61.4,5,3,2,0
14393,15422,273,314,3,3,3,3,4,3,0,0,13,16,2,1,0,1,0,1,0,0,0,0,-1029,-41,0,0,1,0,-3,1,-1,8.4,56.8,-48.4,3,5,-2,0
14378,14999,285,278,2,5,5,2,2,2,1,0,18,17,8,4,0,1,0,1,1,0,0,0,-621,7,-3,3,0,0,1,4,-1,11,15.2,-4.2,4,4,0,0
15589,14758,248,264,7,4,4,7,5,1,0,0,14,18,1,2,1,0,0,1,0,0,0,0,831,-16,3,-3,4,0,-4,-1,1,103,35.6,67.4,4,4,0,1
16503,13011,283,263,7,0,0,7,7,0,0,0,23,43,6,2,1,0,1,0,0,0,0,0,3492,20,7,-7,7,0,-20,4,1,72.8,26.2,46.6,5,4,1,1
14903,15154,266,291,4,4,4,4,3,7,0,1,16,19,5,3,0,0,1,0,0,1,0,0,-251,-25,0,0,-4,0,-3,2,0,35.8,80.6,-44.8,5,4,1,1
14398,14709,261,278,3,3,3,3,5,6,1,0,37,19,3,2,2,1,1,0,1,0,0,0,-311,-17,0,0,-1,0,18,1,1,11.8,13,-1.2,4,5,-1,0
14147,16701,280,274,2,9,9,2,2,6,0,0,16,22,3,4,1,1,0,1,0,0,0,0,-2554,6,-7,7,-4,0,-6,-1,0,21,24,-3,3,4,-1,0
16471,12935,323,258,5,1,1,5,4,3,0,0,18,34,7,3,4,0,1,0,0,0,0,0,3536,65,4,-4,1,0,-16,4,4,15.8,31,-15.2,4,5,-1,1
14964,14318,234,253,6,3,3,6,10,3,0,1,15,12,3,2,1,0,1,0,0,1,0,0,646,-19,3,-3,7,0,3,1,1,33.4,17.4,16,4,3,1,0
13851,15078,259,251,2,5,5,2,3,8,0,1,17,37,4,3,0,0,0,1,0,1,0,0,-1227,8,-3,3,-5,0,-20,1,0,16.8,19.4,-2.6,5,4,1,0
17119,15681,263,263,9,7,7,9,9,3,1,0,14,19,5,4,2,0,0,1,1,0,0,0,1438,0,2,-2,6,0,-5,1,2,31.8,9.8,22,4,2,2,0
14189,14162,298,291,2,1,1,2,2,1,1,0,18,38,4,3,0,2,1,0,1,0,0,0,27,7,1,-1,1,0,-20,1,-2,45.8,38.8,7,5,4,1,0
15831,14258,281,231,6,5,5,6,3,3,0,0,14,16,2,3,1,0,0,1,0,0,0,0,1573,50,1,-1,0,0,-2,-1,1,13.8,71.2,-57.4,4,5,-1,1
15195,15216,251,263,6,5,5,6,5,2,1,0,19,37,2,3,1,2,0,1,1,0,0,0,-21,-12,1,-1,3,0,-18,-1,-1,17,20,-3,3,4,-1,0
15948,16792,278,234,7,10,10,7,1,10,0,0,34,13,5,2,1,0,1,0,0,0,0,0,-844,44,-3,3,-9,0,21,3,1,9.6,18,-8.4,2,5,-3,1
15110,14281,303,308,3,1,1,3,3,1,0,0,16,16,5,8,1,0,0,1,0,0,0,0,829,-5,2,-2,2,0,0,-3,1,18.6,13,5.6,4,4,0,1
14971,14746,285,270,4,4,4,4,1,3,0,1,14,18,3,2,1,0,0,1,0,1,0,0,225,15,0,0,-2,0,-4,1,1,94.2,25.4,68.8,5,4,1,0
12638,16775,240,251,1,10,10,1,0,12,0,0,16,38,1,4,0,0,0,1,0,0,0,0,-4137,-11,-9,9,-12,0,-22,-3,0,62.6,62.2,0.4,2,4,-2,0
16409,17229,243,213,8,12,12,8,11,24,0,1,15,18,4,4,1,0,1,0,0,1,0,0,-820,30,-4,4,-13,0,-3,0,1,20.4,38.6,-18.2,5,4,1,0
14598,15055,285,262,3,5,5,3,1,7,0,1,12,14,4,5,1,1,0,1,0,1,0,0,-457,23,-2,2,-6,0,-2,-1,0,65.8,21,44.8,5,2,3,0
16235,15362,263,267,7,6,6,7,6,7,0,0,19,16,2,6,0,0,0,1,0,0,0,0,873,-4,1,-1,-1,0,3,-4,0,15,12.6,2.4,5,4,1,0
15391,14545,252,245,7,5,5,7,6,3,0,0,35,17,5,7,0,1,1,0,0,0,0,0,846,7,2,-2,3,0,18,-2,-1,20.4,21.8,-1.4,3,3,0,1
14705,14922,226,231,6,6,6,6,6,4,1,0,42,20,1,3,0,2,1,0,1,0,0,0,-217,-5,0,0,2,0,22,-2,-2,11.6,11.8,-0.2,4,2,2,1
15321,15356,266,285,7,5,5,7,6,3,0,0,14,16,1,1,0,1,1,0,0,0,0,0,-35,-19,2,-2,3,0,-2,0,-1,15.6,56.4,-40.8,4,4,0,0
14509,16139,254,238,5,9,9,5,2,10,0,0,14,24,1,3,1,1,1,0,0,0,0,0,-1630,16,-4,4,-8,0,-10,-2,0,27.6,65.2,-37.6,5,5,0,0
16254,15428,242,252,7,7,7,8,10,11,0,0,17,23,3,2,1,0,0,1,0,0,0,0,826,-10,0,-1,-1,0,-6,1,1,11.8,31.2,-19.4,3,3,0,1
12882,17987,235,294,1,12,12,1,0,13,0,1,11,16,2,1,0,1,0,1,0,1,0,0,-5105,-59,-11,11,-13,0,-5,1,-1,34.6,40.4,-5.8,4,5,-1,0
14137,14382,272,258,3,4,4,3,4,6,0,1,13,32,2,2,0,0,0,1,0,1,0,0,-245,14,-1,1,-2,0,-19,0,0,11.6,12,-0.4,4,3,1,0
15924,15232,283,265,5,6,6,5,10,15,0,1,21,17,6,9,0,0,0,1,0,1,0,0,692,18,-1,1,-5,0,4,-3,0,72.6,51.8,20.8,4,4,0,1
14244,15007,308,282,1,4,4,1,1,4,0,1,28,17,3,5,0,2,0,1,0,1,0,0,-763,26,-3,3,-3,0,11,-2,-2,11.2,91.6,-80.4,2,5,-3,1
16002,13469,294,284,6,0,1,6,5,0,0,0,17,21,6,2,1,0,1,0,0,0,0,0,2533,10,6,-5,5,0,-4,4,1,60.4,19.2,41.2,3,4,-1,1
15360,14921,279,258,5,5,5,5,9,4,1,0,35,16,3,5,1,0,0,1,1,0,0,0,439,21,0,0,5,0,19,-2,1,14.2,47.6,-33.4,4,4,0,1
15054,13809,253,256,6,2,2,6,4,3,0,1,18,21,3,4,1,1,1,0,0,1,0,0,1245,-3,4,-4,1,0,-3,-1,0,59.2,7.6,51.6,4,3,1,1
14549,13375,268,272,4,1,3,4,3,1,0,1,17,19,3,5,1,0,0,1,0,1,0,0,1174,-4,3,-1,2,0,-2,-2,1,19.2,43,-23.8,4,3,1,0
16250,12972,278,267,7,0,0,7,12,0,0,1,17,13,3,1,0,0,1,0,0,1,0,0,3278,11,7,-7,12,0,4,2,0,38.8,74.6,-35.8,5,4,1,1
14218,15127,263,299,3,4,4,3,2,1,1,0,14,15,3,3,0,3,0,1,1,0,0,0,-909,-36,-1,1,1,0,-1,0,-3,15.4,96,-80.6,4,4,0,0
15672,14771,271,269,7,4,4,7,7,5,0,1,17,11,3,3,0,0,1,0,0,1,0,0,901,2,3,-3,2,0,6,0,0,65.6,20.4,45.2,3,3,0,0
14435,15826,244,284,4,5,5,4,5,5,0,0,23,17,3,0,0,3,1,0,0,0,0,0,-1391,-40,-1,1,0,0,6,3,-3,22.8,33.8,-11,5,2,3,0
13762,14748,266,262,2,4,4,2,5,2,0,0,24,24,1,6,0,1,0,1,0,0,0,0,-986,4,-2,2,3,0,0,-5,-1,38.2,17.6,20.6,5,3,2,1
14391,14478,271,252,4,4,4,4,1,6,0,0,18,23,3,1,0,0,1,0,0,0,0,0,-87,19,0,0,-5,0,-5,2,0,20.8,133.4,-112.6,5,4,1,1
16835,13163,257,225,10,3,3,10,8,4,0,0,14,11,2,2,3,0,0,1,0,0,0,0,3672,32,7,-7,4,0,3,0,3,50.6,16,34.6,4,4,0,1
16197,17157,270,253,7,11,11,7,4,10,0,0,15,34,0,2,0,0,0,1,0,0,0,0,-960,17,-4,4,-6,0,-19,-2,0,28.6,14.8,13.8,4,4,0,1
16481,16933,276,234,8,9,9,8,7,16,0,0,104,50,2,1,1,1,1,0,0,0,0,0,-452,42,-1,1,-9,0,54,1,0,62.2,207.4,-145.2,4,5,-1,1
14883,17252,233,278,6,9,9,6,10,12,0,0,15,25,5,2,0,1,1,0,0,0,0,0,-2369,-45,-3,3,-2,0,-10,3,-1,56.8,17.6,39.2,3,4,-1,1
13700,14806,275,283,1,4,4,1,1,1,0,1,13,14,2,3,2,1,0,1,0,1,0,0,-1106,-8,-3,3,0,0,-1,-1,1,25,45.8,-20.8,4,4,0,0
14281,15428,249,264,4,6,6,4,3,5,0,1,15,13,3,1,1,2,0,1,0,1,0,0,-1147,-15,-2,2,-2,0,2,2,-1,51.4,7.4,44,4,3,1,1
16367,16442,279,245,6,8,8,6,10,8,0,0,20,21,3,6,1,1,1,0,0,0,0,0,-75,34,-2,2,2,0,-1,-3,0,21.4,68.6,-47.2,4,3,1,0
14171,13699,283,300,3,0,0,3,1,0,0,0,12,38,5,5,0,1,1,0,0,0,0,0,472,-17,3,-3,1,0,-26,0,-1,30.8,12,18.8,3,4,-1,1
16160,15986,248,260,8,6,6,9,7,8,0,0,15,16,2,3,1,1,1,0,0,0,0,0,174,-12,2,-3,-1,0,-1,-1,0,74.6,24,50.6,4,2,2,1
13159,14678,267,254,1,5,5,1,0,6,0,1,13,31,2,3,0,2,0,1,0,1,0,0,-1519,13,-4,4,-6,0,-18,-1,-2,106.6,47.6,59,4,5,-1,0
15917,14073,257,238,9,3,3,9,13,3,0,0,17,16,4,3,0,0,1,0,0,0,0,0,1844,19,6,-6,10,0,1,1,0,48.2,63,-14.8,4,2,2,1
16022,14096,270,285,6,3,4,6,7,1,0,1,16,21,2,3,1,0,1,0,0,1,0,0,1926,-15,3,-2,6,0,-5,-1,1,58.8,99,-40.2,2,4,-2,0
16423,16645,256,250,8,7,7,8,10,11,0,0,15,14,4,2,1,2,1,0,0,0,0,0,-222,6,1,-1,-1,0,1,2,-1,25.2,17,8.2,5,1,4,1
15556,15044,260,278,6,5,5,6,8,2,0,0,18,14,2,4,0,2,0,1,0,0,0,0,512,-18,1,-1,6,0,4,-2,-2,46.2,12.2,34,5,4,1,1
13733,17944,267,263,2,12,12,2,1,14,0,0,15,17,2,4,0,0,0,1,0,0,0,0,-4211,4,-10,10,-13,0,-2,-2,0,23.8,70.4,-46.6,4,3,1,0
15645,15807,258,241,7,8,8,7,6,7,0,1,15,14,1,3,0,1,0,1,0,1,0,0,-162,17,-1,1,-1,0,1,-2,-1,30.4,18.4,12,4,4,0,1
14641,15706,257,268,4,6,6,4,7,10,0,1,18,24,1,4,0,0,0,1,0,1,0,0,-1065,-11,-2,2,-3,0,-6,-3,0,10.8,48.4,-37.6,4,5,-1,1
15559,15743,290,273,4,5,5,4,4,5,0,0,32,16,3,2,1,1,0,1,0,0,0,0,-184,17,-1,1,-1,0,16,1,0,33,97.2,-64.2,3,3,0,1
16340,15693,278,262,7,6,6,7,6,6,0,0,18,21,4,3,0,1,0,1,0,0,0,0,647,16,1,-1,0,0,-3,1,-1,106.4,17.2,89.2,4,3,1,1
16511,14983,262,258,8,5,5,8,12,7,0,0,19,35,9,0,1,0,1,0,0,0,0,0,1528,4,3,-3,5,0,-16,9,1,14.8,13,1.8,2,3,-1,1
12839,18494,252,260,0,15,15,0,0,21,0,0,19,31,2,6,0,2,0,1,0,0,0,0,-5655,-8,-15,15,-21,0,-12,-4,-2,52.2,62.4,-10.2,3,4,-1,0
15554,13025,287,255,6,1,1,6,5,0,0,0,18,69,5,4,1,0,1,0,0,0,0,0,2529,32,5,-5,5,0,-51,1,1,36.4,87.4,-51,5,3,2,1
15588,14742,274,269,6,4,4,6,5,3,1,0,18,20,0,4,0,1,1,0,1,0,0,0,846,5,2,-2,2,0,-2,-4,-1,13,104.8,-91.8,4,5,-1,1
15908,16111,279,276,5,6,6,5,6,5,0,1,16,16,3,4,1,3,0,1,0,1,0,0,-203,3,-1,1,1,0,0,-1,-2,16.6,90.8,-74.2,4,4,0,0
18517,14284,284,240,13,4,4,13,10,3,0,0,17,15,3,1,1,0,1,0,0,0,0,0,4233,44,9,-9,7,0,2,2,1,20,43.4,-23.4,4,4,0,1
13923,14328,269,290,2,2,2,2,3,2,0,0,18,36,3,3,0,0,1,0,0,0,0,0,-405,-21,0,0,1,0,-18,0,0,7.8,28.2,-20.4,4,4,0,1
16924,14939,282,258,8,4,4,8,9,7,0,0,23,16,4,2,1,1,1,0,0,0,0,0,1985,24,4,-4,2,0,7,2,0,89.6,21.4,68.2,3,5,-2,1
15035,14287,275,264,5,3,3,5,7,3,0,1,17,13,4,5,0,1,1,0,0,1,0,0,748,11,2,-2,4,0,4,-1,-1,14.6,51.4,-36.8,3,5,-2,0
14108,16271,233,209,4,11,11,4,3,11,0,0,33,27,4,1,1,1,0,1,0,0,0,0,-2163,24,-7,7,-8,0,6,3,0,14.8,90.2,-75.4,4,3,1,0
14085,16619,281,267,3,8,8,3,2,12,0,0,14,107,5,6,0,1,0,1,0,0,0,0,-2534,14,-5,5,-10,0,-93,-1,-1,20.6,42.8,-22.2,5,2,3,0
14931,13895,295,274,3,2,2,3,5,1,1,0,58,16,2,3,1,0,1,0,1,0,0,0,1036,21,1,-1,4,0,42,-1,1,12,21.6,-9.6,3,4,-1,1
16356,14290,257,261,7,4,4,7,7,3,0,1,29,16,2,3,0,0,1,0,0,1,0,0,2066,-4,3,-3,4,0,13,-1,0,49.6,67.2,-17.6,4,2,2,1
15686,15429,263,270,7,5,5,7,9,6,0,0,19,35,4,3,0,1,1,0,0,0,0,0,257,-7,2,-2,3,0,-16,1,-1,13.2,26.6,-13.4,5,5,0,1
15649,15915,267,281,6,6,6,6,5,4,1,0,17,21,6,5,0,0,1,0,1,0,0,0,-266,-14,0,0,1,0,-4,1,0,72,12.4,59.6,5,4,1,1
18060,14352,293,238,10,4,4,10,7,4,0,0,18,18,3,2,3,1,1,0,0,0,0,0,3708,55,6,-6,3,0,0,1,2,50,18.4,31.6,3,5,-2,1
13671,14695,275,307,1,2,2,1,1,2,0,1,17,18,4,4,0,0,1,0,0,1,0,0,-1024,-32,-1,1,-1,0,-1,0,0,16.8,11.6,5.2,4,3,1,0
14310,15705,277,284,3,5,5,3,3,5,0,0,13,37,5,3,0,0,1,0,0,0,0,0,-1395,-7,-2,2,-2,0,-24,2,0,9.4,12.6,-3.2,3,5,-2,0
15303,16759,207,250,7,9,9,7,11,9,0,0,12,14,2,3,0,0,0,1,0,0,0,0,-1456,-43,-2,2,2,0,-2,-1,0,83,88.2,-5.2,5,5,0,0
14328,16762,270,301,3,7,7,3,2,6,1,0,39,14,0,6,0,2,1,0,1,0,0,0,-2434,-31,-4,4,-4,0,25,-6,-2,61,34.8,26.2,4,4,0,0
16483,14707,283,255,8,5,5,9,10,4,0,0,17,17,4,2,0,0,0,1,0,0,0,0,1776,28,3,-4,6,0,0,2,0,30.6,38,-7.4,5,5,0,1
17288,13353,309,255,6,1,1,6,7,2,0,1,18,17,1,7,1,0,1,0,0,1,0,0,3935,54,5,-5,5,0,1,-6,1,20.4,45.4,-25,4,5,-1,1
15093,13727,280,289,5,1,1,6,4,1,1,0,11,27,6,5,1,0,1,0,1,0,0,0,1366,-9,4,-5,3,0,-16,1,1,48.8,5.2,43.6,4,0,4,1
18874,15415,266,241,12,7,7,12,14,10,0,1,22,15,4,2,4,0,1,0,0,1,1,0,3459,25,5,-5,4,0,7,2,4,100.4,15.2,85.2,5,4,1,1
14658,14230,293,298,2,2,2,2,1,2,0,1,11,13,2,3,0,0,0,1,0,1,0,0,428,-5,0,0,-1,0,-2,-1,0,63.8,43.4,20.4,3,5,-2,0
16411,12494,292,245,7,0,1,7,9,0,0,1,18,16,2,1,0,0,1,0,0,1,0,0,3917,47,7,-6,9,0,2,1,0,17,11.4,5.6,3,4,-1,1
15988,16077,301,250,5,8,8,5,6,9,0,1,35,13,2,4,1,0,0,1,0,1,0,0,-89,51,-3,3,-3,0,22,-2,1,54.8,18,36.8,5,5,0,1
16305,16450,220,222,8,11,11,8,11,15,0,0,19,39,4,8,3,0,0,1,0,0,0,0,-145,-2,-3,3,-4,0,-20,-4,3,56.4,60.6,-4.2,3,3,0,0
15835,13603,243,253,7,2,3,7,9,2,0,0,14,17,5,6,1,0,1,0,0,0,0,0,2232,-10,5,-4,7,0,-3,-1,1,116.2,21,95.2,5,5,0,1
13396,13859,263,243,1,4,4,1,0,5,0,0,12,17,4,4,0,0,1,0,0,0,0,0,-463,20,-3,3,-5,0,-5,0,0,13.2,64.6,-51.4,4,4,0,0
15164,15939,234,269,7,7,7,7,6,7,0,0,17,17,2,4,0,0,1,0,0,0,0,0,-775,-35,0,0,-1,0,0,-2,0,23,21,2,4,5,-1,0
16942,15115,274,261,10,5,5,10,11,3,1,0,17,16,3,3,1,1,1,0,1,0,0,0,1827,13,5,-5,8,0,1,0,0,34.6,67.8,-33.2,3,4,-1,1
15371,15558,251,245,6,7,8,6,7,10,1,0,15,20,2,4,0,1,0,1,1,0,0,0,-187,6,-1,2,-3,0,-5,-2,-1,8.4,16,-7.6,2,4,-2,0
14301,16087,253,252,4,8,8,6,2,7,0,0,13,17,3,1,0,0,0,1,0,0,0,0,-1786,1,-4,2,-5,0,-4,2,0,24.6,26.4,-1.8,3,5,-2,0
15305,15859,301,301,4,5,5,4,8,6,1,0,28,31,3,4,0,1,1,0,1,0,0,0,-554,0,-1,1,2,0,-3,-1,-1,121.8,12.8,109,5,4,1,1
14597,14051,290,279,2,1,1,2,2,2,0,0,45,17,5,4,1,2,1,0,0,0,0,0,546,11,1,-1,0,0,28,1,-1,61,69.8,-8.8,3,3,0,1
16817,15508,253,247,10,6,6,10,11,7,1,0,21,14,1,1,0,0,1,0,1,0,0,0,1309,6,4,-4,4,0,7,0,0,53.2,27.6,25.6,4,3,1,1
16334,12996,297,265,4,1,1,4,11,0,0,1,34,14,2,0,0,0,0,1,0,1,0,0,3338,32,3,-3,11,0,20,2,0,76.6,44.4,32.2,5,5,0,1
15166,14525,260,255,6,4,4,6,6,6,1,0,16,17,2,1,0,0,1,0,1,0,0,0,641,5,2,-2,0,0,-1,1,0,87.8,80.8,7,3,4,-1,0
14851,14353,274,262,4,3,4,4,7,4,0,1,19,20,4,3,1,1,0,1,0,1,0,0,498,12,1,0,3,0,-1,1,0,85.6,47.4,38.2,5,5,0,0
15510,13952,241,233,7,3,3,7,6,5,0,0,46,14,4,4,0,2,0,1,0,0,0,0,1558,8,4,-4,1,0,32,0,-2,37.4,104.4,-67,5,3,2,1
16987,14967,236,245,10,5,5,10,17,7,0,0,17,13,1,4,0,1,1,0,0,0,0,0,2020,-9,5,-5,10,0,4,-3,-1,62.8,21,41.8,3,3,0,1
14664,15428,290,277,3,4,4,3,5,6,0,0,11,15,3,4,1,0,1,0,0,0,0,0,-764,13,-1,1,-1,0,-4,-1,1,78.6,47,31.6,4,4,0,0
16097,14296,257,230,8,5,7,8,5,11,0,0,20,14,1,4,0,1,0,1,0,0,0,0,1801,27,3,-1,-6,0,6,-3,-1,26.4,13.8,12.6,5,3,2,1
15299,14362,267,272,6,2,2,6,9,1,0,0,18,16,3,3,0,1,0,1,0,0,0,0,937,-5,4,-4,8,0,2,0,-1,60.6,38.6,22,3,5,-2,0
14259,16693,217,246,5,9,9,5,10,12,0,0,46,16,4,2,1,2,1,0,0,0,0,0,-2434,-29,-4,4,-2,0,30,2,-1,23.6,19.2,4.4,5,5,0,0
13660,14619,266,268,1,4,4,1,2,7,0,0,16,15,3,5,0,0,0,1,0,0,0,0,-959,-2,-3,3,-5,0,1,-2,0,17.8,25.6,-7.8,3,3,0,0
15750,17179,266,270,6,9,9,6,7,11,0,0,100,17,4,4,1,0,0,1,0,0,0,0,-1429,-4,-3,3,-4,0,83,0,1,13.4,59.8,-46.4,5,3,2,0
14850,14635,260,229,5,5,5,5,5,9,0,0,16,125,2,2,1,2,0,1,0,0,0,0,215,31,0,0,-4,0,-109,0,-1,15,12.2,2.8,3,5,-2,0
16233,13543,266,268,8,2,2,8,10,1,0,1,18,18,4,2,0,0,1,0,0,1,0,0,2690,-2,6,-6,9,0,0,2,0,9.4,16.4,-7,3,4,-1,0
16207,16997,211,225,10,12,12,10,13,13,0,0,13,21,2,1,1,2,0,1,0,0,0,0,-790,-14,-2,2,0,0,-8,1,-1,22.2,92.2,-70,3,5,-2,0
17559,16320,284,238,9,9,9,9,11,8,0,0,16,19,8,2,0,1,1,0,0,0,0,0,1239,46,0,0,3,0,-3,6,-1,31.8,53.4,-21.6,3,4,-1,1
15276,13735,285,264,4,2,3,4,5,2,0,0,16,19,3,3,1,0,0,1,0,0,0,0,1541,21,2,-1,3,0,-3,0,1,63.2,32.6,30.6,5,3,2,1
15116,14993,269,264,5,4,4,5,3,5,0,0,13,15,3,3,2,1,0,1,0,0,0,0,123,5,1,-1,-2,0,-2,0,1,33.4,28.8,4.6,3,3,0,0
14033,14436,269,224,2,6,6,2,3,7,0,0,13,16,2,3,0,0,0,1,0,0,0,0,-403,45,-4,4,-4,0,-3,-1,0,14.2,39.6,-25.4,3,3,0,0
14301,15626,272,322,3,5,5,3,4,0,0,0,15,13,1,2,0,1,0,1,0,0,0,0,-1325,-50,-2,2,4,0,2,-1,-1,17.2,30,-12.8,3,5,-2,0
16417,13937,284,250,7,3,3,7,7,2,0,0,12,17,6,4,0,0,1,0,0,0,0,0,2480,34,4,-4,5,0,-5,2,0,21.2,59.2,-38,3,4,-1,1
15642,14514,292,277,4,3,3,4,5,4,0,0,19,121,0,2,1,1,1,0,0,0,0,0,1128,15,1,-1,1,0,-102,-2,0,20,58.4,-38.4,4,5,-1,1
14847,14135,243,281,5,2,2,5,6,1,0,1,12,13,1,3,0,2,0,1,0,1,0,0,712,-38,3,-3,5,0,-1,-2,-2,138.8,18,120.8,5,5,0,0
15205,14676,278,271,5,3,3,5,5,3,0,0,20,18,4,5,0,0,1,0,0,0,0,0,529,7,2,-2,2,0,2,-1,0,42.4,14,28.4,5,5,0,0
17486,16191,258,258,10,7,7,10,8,12,1,0,21,17,6,3,1,1,1,0,1,0,0,0,1295,0,3,-3,-4,0,4,3,0,30.2,19.4,10.8,5,5,0,1
15050,14899,237,237,5,7,7,5,6,1,1,0,18,34,3,4,1,1,0,1,1,0,0,0,151,0,-2,2,5,0,-16,-1,0,16.4,7.8,8.6,4,2,2,0
15977,16280,220,253,11,7,7,11,6,8,1,0,15,29,3,4,1,1,1,0,1,0,0,0,-303,-33,4,-4,-2,0,-14,-1,0,59.4,12.2,47.2,3,4,-1,0
14805,13588,262,226,4,4,4,4,3,4,0,1,20,19,3,4,0,0,1,0,0,1,0,0,1217,36,0,0,-1,0,1,-1,0,31.4,12.4,19,4,4,0,1
15524,13485,258,250,6,2,2,6,5,3,0,0,19,15,0,4,1,0,0,1,0,0,0,0,2039,8,4,-4,2,0,4,-4,1,58.8,21,37.8,2,3,-1,1
13826,13443,287,285,1,1,1,1,2,0,0,1,25,22,5,2,0,0,0,1,0,1,0,0,383,2,0,0,2,0,3,3,0,12.8,30.2,-17.4,5,3,2,1
13607,17479,239,271,2,10,10,2,3,10,0,1,11,70,1,3,0,3,0,1,0,1,0,0,-3872,-32,-8,8,-7,0,-59,-2,-3,43.2,22.2,21,5,2,3,0
15211,16213,272,288,5,6,6,5,3,6,0,0,20,23,4,6,0,0,0,1,0,0,0,0,-1002,-16,-1,1,-3,0,-3,-2,0,10,27.6,-17.6,2,3,-1,1
16828,16691,280,270,9,7,7,9,8,8,0,1,19,19,4,3,0,1,0,1,0,1,0,0,137,10,2,-2,0,0,0,1,-1,15.8,18.6,-2.8,3,3,0,1
13260,15620,284,294,0,5,5,0,0,3,0,1,13,17,5,4,0,0,0,1,0,1,0,0,-2360,-10,-5,5,-3,0,-4,1,0,14.8,17.4,-2.6,4,5,-1,0
14015,15020,250,253,4,5,5,4,1,4,0,0,17,18,2,4,0,1,1,0,0,0,0,0,-1005,-3,-1,1,-3,0,-1,-2,-1,41,15.6,25.4,3,5,-2,1
15842,17332,245,244,6,11,11,6,3,10,0,0,13,16,2,2,0,1,0,1,0,0,0,0,-1490,1,-5,5,-7,0,-3,0,-1,26,42.8,-16.8,3,4,-1,0
15164,16864,256,277,5,7,7,5,4,12,1,0,13,38,3,4,1,3,0,1,1,0,0,0,-1700,-21,-2,2,-8,0,-25,-1,-2,19.6,25.8,-6.2,2,3,-1,0
14301,14898,277,251,3,5,5,3,3,6,1,0,22,17,2,3,0,0,1,0,1,0,0,0,-597,26,-2,2,-3,0,5,-1,0,85.8,14.4,71.4,5,5,0,0
15027,12855,288,271,4,0,0,4,1,0,0,1,17,20,7,4,1,0,1,0,0,1,0,0,2172,17,4,-4,1,0,-3,3,1,22.2,6.8,15.4,4,2,2,1
16610,16683,264,217,7,11,11,8,11,17,0,0,15,16,3,3,1,0,0,1,0,0,0,0,-73,47,-4,3,-6,0,-1,0,1,48.8,43,5.8,5,5,0,1
15330,15766,244,260,6,7,7,6,8,7,0,0,22,108,5,1,0,0,1,0,0,0,0,0,-436,-16,-1,1,1,0,-86,4,0,91,16.8,74.2,5,5,0,0
14936,15744,262,285,4,6,6,4,6,7,0,0,16,18,6,1,0,0,0,1,0,0,0,0,-808,-23,-2,2,-1,0,-2,5,0,24.8,7,17.8,5,2,3,0
14349,17711,206,257,6,12,12,6,5,15,0,0,10,28,1,1,1,2,0,1,0,0,0,0,-3362,-51,-6,6,-10,0,-18,0,-1,45.6,33.2,12.4,4,4,0,1
14705,16352,244,291,5,7,7,6,5,5,0,1,11,33,18,5,0,1,0,1,0,1,0,0,-1647,-47,-2,1,0,0,-22,13,-1,13.8,31.8,-18,3,5,-2,1
16801,16255,242,269,10,7,7,10,19,7,0,0,15,12,1,4,1,1,1,0,0,0,0,0,546,-27,3,-3,12,0,3,-3,0,55.2,9.2,46,5,3,2,1
15758,16173,264,284,6,5,5,6,4,5,0,1,29,18,4,3,0,3,0,1,0,1,0,0,-415,-20,1,-1,-1,0,11,1,-3,35.2,31,4.2,5,3,2,0
16598,13341,274,231,9,3,3,9,7,3,0,0,18,17,3,2,1,0,0,1,0,0,0,0,3257,43,6,-6,4,0,1,1,1,92.4,45.2,47.2,4,3,1,1
14610,16085,243,260,4,7,7,4,7,13,0,1,16,19,2,2,0,1,1,0,0,1,0,0,-1475,-17,-3,3,-6,0,-3,0,-1,23.2,46.4,-23.2,3,3,0,0
15557,14690,245,238,7,5,5,7,11,7,0,0,16,15,1,1,0,0,1,0,0,0,0,0,867,7,2,-2,4,0,1,0,0,48.6,22,26.6,3,2,1,0
16615,13241,259,258,9,1,1,9,13,1,1,0,18,13,2,2,0,0,1,0,1,0,0,0,3374,1,8,-8,12,0,5,0,0,14.8,64.8,-50,4,4,0,0
14497,14335,271,281,3,3,3,3,3,1,0,0,17,13,3,2,1,1,1,0,0,0,0,0,162,-10,0,0,2,0,4,1,0,23.2,37.8,-14.6,3,5,-2,0
13823,15424,263,302,2,4,4,2,4,3,0,1,17,22,3,2,0,1,0,1,0,1,0,0,-1601,-39,-2,2,1,0,-5,1,-1,51,76.8,-25.8,4,4,0,0
15512,16579,274,285,5,7,7,5,8,7,0,0,12,16,2,2,0,2,1,0,0,0,0,0,-1067,-11,-2,2,1,0,-4,0,-2,25.6,68,-42.4,4,5,-1,0
14966,14221,285,276,4,2,2,4,2,1,1,0,138,15,1,3,2,1,1,0,1,0,0,0,745,9,2,-2,1,0,123,-2,1,15,24,-9,3,3,0,1
15236,14884,241,274,6,6,6,7,6,1,0,0,15,13,4,2,0,1,1,0,0,0,0,0,352,-33,0,-1,5,0,2,2,-1,12.6,23.2,-10.6,2,4,-2,1
16818,13791,272,236,11,3,3,11,6,4,0,0,106,17,2,3,0,0,1,0,0,0,0,0,3027,36,8,-8,2,0,89,-1,0,21.2,7.2,14,4,1,3,1
15029,14984,279,291,4,3,3,4,4,5,1,0,16,107,4,5,2,0,1,0,1,0,0,0,45,-12,1,-1,-1,0,-91,-1,2,10,13.2,-3.2,3,3,0,1
13849,13393,264,261,3,2,2,3,0,1,0,0,136,14,0,4,1,1,1,0,0,0,0,0,456,3,1,-1,-1,0,122,-4,0,33.2,22,11.2,4,4,0,1
16438,14452,253,275,9,3,3,9,8,2,0,0,20,15,5,5,0,1,1,0,0,0,0,0,1986,-22,6,-6,6,0,5,0,-1,51.2,12.4,38.8,5,2,3,1
17149,16352,246,257,11,8,8,11,9,11,0,0,15,18,3,2,0,0,1,0,0,0,0,0,797,-11,3,-3,-2,0,-3,1,0,24.2,11.4,12.8,5,3,2,1
15060,15056,255,238,5,6,6,5,8,11,0,0,35,15,2,2,0,0,0,1,0,0,0,0,4,17,-1,1,-3,0,20,0,0,22,7.8,14.2,4,2,2,1
14053,15542,278,263,2,7,7,2,1,5,0,1,15,20,4,2,0,0,0,1,0,1,0,0,-1489,15,-5,5,-4,0,-5,2,0,12,26.6,-14.6,4,4,0,1
15914,15973,254,242,7,8,8,7,5,10,0,0,16,26,2,3,0,0,0,1,0,0,0,0,-59,12,-1,1,-5,0,-10,-1,0,43.8,76.6,-32.8,4,3,1,0
15492,17363,280,259,6,12,12,6,2,9,0,0,30,21,4,4,0,0,1,0,0,0,0,0,-1871,21,-6,6,-7,0,9,0,0,157.8,64.4,93.4,4,4,0,0
14556,14654,251,248,5,5,5,5,5,4,0,1,38,13,4,1,0,0,1,0,0,1,0,0,-98,3,0,0,1,0,25,3,0,18,51.6,-33.6,3,5,-2,0
14764,16635,231,236,5,9,9,5,6,11,0,1,15,16,4,1,1,2,1,0,0,1,0,0,-1871,-5,-4,4,-5,0,-1,3,-1,48,30.6,17.4,3,4,-1,0
13786,13542,261,223,3,3,3,3,1,2,1,0,14,14,0,2,0,0,0,1,1,0,0,0,244,38,0,0,-1,0,0,-2,0,9,14,-5,3,3,0,1
16640,14554,256,251,9,4,4,9,14,6,0,1,15,13,2,4,2,0,1,0,0,1,0,0,2086,5,5,-5,8,0,2,-2,2,73.4,27.6,45.8,3,3,0,1
14558,15239,246,274,5,4,4,5,5,3,0,1,26,18,4,5,0,1,1,0,0,1,0,0,-681,-28,1,-1,2,0,8,-1,-1,14.6,34.8,-20.2,3,3,0,0
14727,14841,275,262,4,4,4,4,4,4,1,0,42,25,3,1,1,1,1,0,1,0,0,0,-114,13,0,0,0,0,17,2,0,48.2,95.8,-47.6,3,4,-1,0
15690,13448,285,238,5,4,4,5,8,1,1,0,13,15,6,1,0,0,0,1,1,0,0,0,2242,47,1,-1,7,0,-2,5,0,27.4,9.4,18,5,2,3,1
14053,13503,263,271,3,2,2,3,3,1,0,0,11,14,2,0,0,0,1,0,0,0,0,0,550,-8,1,-1,2,0,-3,2,0,6.8,8,-1.2,1,3,-2,1
16508,15725,259,273,7,6,6,7,7,5,0,1,13,140,4,3,1,0,1,0,0,1,0,0,783,-14,1,-1,2,0,-127,1,1,14.6,37.4,-22.8,2,4,-2,0
17404,16221,279,255,9,8,8,9,7,5,1,0,15,38,2,1,1,0,1,0,1,0,0,0,1183,24,1,-1,2,0,-23,1,1,34.2,96.8,-62.6,4,5,-1,0
16230,14835,245,270,8,5,6,8,12,3,1,0,36,19,4,6,1,0,0,1,1,0,0,0,1395,-25,3,-2,9,0,17,-2,1,52.4,45.2,7.2,5,4,1,1
16091,13898,251,233,9,3,3,9,8,3,1,0,16,16,1,1,2,0,1,0,1,0,0,0,2193,18,6,-6,5,0,0,0,2,5.8,6.4,-0.6,1,3,-2,1
15455,13908,255,268,6,3,3,6,8,1,0,0,12,44,1,4,0,0,0,1,0,0,0,0,1547,-13,3,-3,7,0,-32,-3,0,38.4,42,-3.6,4,4,0,1
14716,16323,270,311,2,7,7,2,6,9,0,0,17,15,2,5,0,0,0,1,0,0,0,0,-1607,-41,-5,5,-3,0,2,-3,0,107.6,25.6,82,5,4,1,1
16327,17333,227,248,10,11,11,11,10,12,1,0,18,35,2,4,0,0,0,1,1,0,0,0,-1006,-21,-1,0,-2,0,-17,-2,0,54.4,89.2,-34.8,5,3,2,0
15408,15567,246,238,5,7,7,5,6,7,0,0,13,14,1,0,3,1,1,0,0,0,0,0,-159,8,-2,2,-1,0,-1,1,2,9,10.6,-1.6,2,3,-1,0
14415,14948,260,281,4,2,2,4,3,2,0,1,16,18,3,4,1,2,1,0,0,1,0,0,-533,-21,2,-2,1,0,-2,-1,-1,19.6,15.6,4,3,2,1,0
15574,14777,261,257,7,4,4,7,6,3,0,0,14,12,0,2,1,2,1,0,0,0,0,0,797,4,3,-3,3,0,2,-2,-1,6.2,18.6,-12.4,2,5,-3,1
2541,2557,0,1,0,0,0,0,0,0,0,0,0,2,0,0,0,0,0,0,0,0,0,0,-16,-1,0,0,0,0,-2,0,0,36.4,40.4,-4,4,3,1,1
13567,14166,286,281,1,2,2,1,0,1,0,1,15,15,2,2,0,1,1,0,0,1,0,0,-599,5,-1,1,-1,0,0,0,-1,13.4,35.6,-22.2,5,4,1,0
15622,14333,266,284,8,3,3,8,6,1,0,1,15,17,2,2,0,0,1,0,0,1,0,0,1289,-18,5,-5,5,0,-2,0,0,106.6,99.8,6.8,4,4,0,0
18550,15722,260,196,13,7,7,13,14,16,0,1,21,50,2,9,1,0,0,1,0,1,0,0,2828,64,6,-6,-2,0,-29,-7,1,10.2,131.2,-121,4,5,-1,1
13256,15967,260,256,1,8,8,1,2,9,0,1,15,16,1,2,2,1,0,1,0,1,0,0,-2711,4,-7,7,-7,0,-1,-1,1,9.6,51.6,-42,4,5,-1,0
16552,13449,263,290,8,1,1,8,7,0,0,1,26,13,3,3,1,0,0,1,0,1,0,0,3103,-27,7,-7,7,0,13,0,1,22.8,39.6,-16.8,5,2,3,1
14232,13919,281,290,2,1,1,2,2,2,0,0,19,14,2,6,1,0,1,0,0,0,0,0,313,-9,1,-1,0,0,5,-4,1,33.6,44.8,-11.2,4,4,0,1
15145,15446,265,271,6,5,5,6,7,9,1,0,15,17,4,6,1,0,1,0,1,0,0,0,-301,-6,1,-1,-2,0,-2,-2,1,19.8,23.2,-3.4,4,5,-1,1
13524,16447,238,231,2,10,10,2,4,10,0,1,20,29,2,3,1,2,0,1,0,1,0,0,-2923,7,-8,8,-6,0,-9,-1,-1,11.6,46.6,-35,5,4,1,0
14837,17284,283,289,3,8,8,3,5,11,0,0,22,85,1,5,0,4,1,0,0,0,0,0,-2447,-6,-5,5,-6,0,-63,-4,-4,96.4,83,13.4,5,5,0,0
15658,15426,262,282,6,4,5,6,8,5,0,0,12,20,1,1,0,2,0,1,0,0,0,0,232,-20,2,-1,3,0,-8,0,-2,57.2,22.8,34.4,4,4,0,1
15651,15780,286,259,5,6,7,5,5,8,0,0,15,19,2,4,1,0,1,0,0,0,0,0,-129,27,-1,2,-3,0,-4,-2,1,15.2,49,-33.8,3,3,0,1
15927,15903,256,264,7,6,6,7,10,9,0,1,14,16,2,2,0,1,0,1,0,1,0,0,24,-8,1,-1,1,0,-2,0,-1,13.6,45,-31.4,4,5,-1,0
15143,14944,255,257,5,5,5,5,6,3,0,1,19,17,4,8,1,1,0,1,0,1,0,0,199,-2,0,0,3,0,2,-4,0,18.4,14.4,4,4,4,0,0
14378,15447,238,246,4,6,6,4,8,5,0,1,24,14,2,2,0,2,1,0,0,1,0,0,-1069,-8,-2,2,3,0,10,0,-2,35.6,82,-46.4,4,5,-1,0
16653,15259,282,283,7,3,3,7,12,3,1,0,27,18,7,2,0,3,1,0,1,0,0,0,1394,-1,4,-4,9,0,9,5,-3,27.8,10.6,17.2,5,3,2,0
15311,15384,259,269,6,6,6,6,6,5,0,0,24,23,3,4,1,0,1,0,0,0,0,0,-73,-10,0,0,1,0,1,-1,1,40.2,21.4,18.8,3,4,-1,0
16970,16932,241,198,10,14,14,11,14,19,0,1,17,18,2,3,3,0,0,1,0,1,0,0,38,43,-4,3,-5,0,-1,-1,3,17.8,32.6,-14.8,4,3,1,0
14710,13964,238,249,5,4,4,6,11,5,1,0,21,14,3,3,1,0,1,0,1,0,0,0,746,-11,1,-2,6,0,7,0,1,92.4,76.2,16.2,3,5,-2,1
17484,15650,239,216,13,8,8,13,16,12,0,0,40,16,3,8,1,0,1,0,0,0,0,0,1834,23,5,-5,4,0,24,-5,1,15,36.6,-21.6,3,4,-1,0
14082,16314,257,280,3,8,8,3,4,9,0,1,11,18,2,1,0,0,0,1,0,1,0,0,-2232,-23,-5,5,-5,0,-7,1,0,82.6,4.4,78.2,4,1,3,1
14655,15712,265,254,4,7,7,4,2,3,0,0,19,12,2,4,0,1,1,0,0,0,0,0,-1057,11,-3,3,-1,0,7,-2,-1,56,23.6,32.4,4,3,1,1
13661,14208,285,263,1,3,3,1,0,2,0,0,17,12,1,4,1,0,0,1,0,0,0,0,-547,22,-2,2,-2,0,5,-3,1,18.2,35,-16.8,4,4,0,0
16021,15774,251,270,8,6,6,8,7,4,0,0,18,19,5,2,1,1,1,0,0,0,0,0,247,-19,2,-2,3,0,-1,3,0,108.2,18,90.2,4,3,1,0
14682,15946,236,264,5,7,7,5,6,7,0,0,137,14,7,3,0,0,1,0,0,0,0,0,-1264,-28,-2,2,-1,0,123,4,0,12.4,49,-36.6,3,4,-1,0
16454,12741,314,236,6,1,1,6,9,1,0,0,24,54,7,7,1,0,1,0,0,0,0,0,3713,78,5,-5,8,0,-30,0,1,11,26.4,-15.4,3,3,0,0
15332,15806,270,294,5,5,5,5,7,9,0,0,12,12,1,2,0,1,0,1,0,0,0,0,-474,-24,0,0,-2,0,0,-1,-1,32.4,49.6,-17.2,2,3,-1,0
15940,14304,292,319,5,1,1,5,6,0,0,1,13,16,5,1,0,1,0,1,0,1,0,0,1636,-27,4,-4,6,0,-3,4,-1,18.8,8.8,10,4,3,1,1
15400,15559,252,255,5,7,7,5,4,10,0,1,18,21,5,3,0,1,1,0,0,1,0,0,-159,-3,-2,2,-6,0,-3,2,-1,53.8,15.6,38.2,3,5,-2,0
16514,14195,289,259,8,3,3,8,7,3,0,0,15,15,3,3,0,0,1,0,0,0,0,0,2319,30,5,-5,4,0,0,0,0,36.8,34.4,2.4,3,5,-2,1
16888,16719,264,284,10,8,8,10,10,4,0,0,107,25,2,2,0,0,1,0,0,0,0,0,169,-20,2,-2,6,0,82,0,0,8.8,36.8,-28,3,4,-1,0
17433,16842,227,243,11,9,9,11,26,17,0,0,19,15,1,4,0,0,0,1,0,0,0,0,591,-16,2,-2,9,0,4,-3,0,53.6,9,44.6,4,2,2,1
15699,15048,264,257,7,6,6,7,6,9,0,1,14,15,2,3,0,1,0,1,0,1,0,0,651,7,1,-1,-3,0,-1,-1,-1,24.2,77,-52.8,5,5,0,1
16967,14458,257,258,10,5,5,10,13,6,0,1,15,16,3,1,1,0,0,1,0,1,0,0,2509,-1,5,-5,7,0,-1,2,1,33.4,12.4,21,4,4,0,1
17476,15252,262,247,11,6,6,11,15,4,1,0,14,17,2,1,1,0,1,0,1,0,0,0,2224,15,5,-5,11,0,-3,1,1,105.6,26.8,78.8,5,5,0,1
15610,13691,278,222,5,4,4,5,6,6,0,1,375,16,4,4,1,0,1,0,0,1,0,0,1919,56,1,-1,0,0,359,0,1,66,29.4,36.6,4,5,-1,0
16099,15173,282,273,6,4,4,6,9,7,0,1,17,16,6,1,0,0,1,0,0,1,0,0,926,9,2,-2,2,0,1,5,0,33.6,27.4,6.2,5,2,3,1
15187,14450,288,288,3,2,2,3,4,5,1,0,21,16,5,6,2,1,0,1,1,0,0,0,737,0,1,-1,-1,0,5,-1,1,74.4,14,60.4,5,5,0,1
16032,15087,264,248,9,5,5,9,3,5,0,0,16,19,3,3,2,0,1,0,0,0,0,0,945,16,4,-4,-2,0,-3,0,2,18,58.8,-40.8,4,3,1,0
13793,16162,248,272,3,7,7,3,4,10,1,0,26,21,4,7,0,0,1,0,1,0,0,0,-2369,-24,-4,4,-6,0,5,-3,0,45.6,19.6,26,5,3,2,0
18319,16181,274,251,12,7,7,12,21,9,0,0,19,17,5,4,1,0,0,1,0,0,0,0,2138,23,5,-5,12,0,2,1,1,27.2,122.4,-95.2,5,4,1,0
13615,16340,246,300,3,7,7,3,2,7,0,0,18,17,2,3,0,1,0,1,0,0,0,0,-2725,-54,-4,4,-5,0,1,-1,-1,7.2,27.2,-20,3,4,-1,0
15054,16311,221,231,6,9,9,6,11,12,0,0,295,36,0,3,0,1,1,0,0,0,0,0,-1257,-10,-3,3,-1,0,259,-3,-1,46.8,58.4,-11.6,4,5,-1,0
15450,15480,265,243,7,6,6,7,7,10,0,0,20,20,3,3,0,0,1,0,0,0,0,0,-30,22,1,-1,-3,0,0,0,0,28.6,36.6,-8,5,4,1,1
14004,15318,274,278,2,5,5,2,2,5,0,0,17,21,5,4,0,0,0,1,0,0,0,0,-1314,-4,-3,3,-3,0,-4,1,0,19.2,38.8,-19.6,3,5,-2,0
2599,2701,0,6,0,0,0,0,0,0,0,0,2,3,0,1,0,0,0,0,0,0,0,0,-102,-6,0,0,0,0,-1,-1,0,18.6,59.2,-40.6,4,3,1,0
14198,14959,246,280,4,3,3,4,6,4,1,0,18,16,2,3,0,2,1,0,1,0,0,0,-761,-34,1,-1,2,0,2,-1,-2,26.8,19.4,7.4,5,4,1,0
18094,17242,253,244,12,9,9,12,23,19,1,0,17,16,5,2,0,2,0,1,1,0,0,0,852,9,3,-3,4,0,1,3,-2,16.8,59.2,-42.4,3,5,-2,1
19399,13898,288,213,13,5,5,13,26,6,0,0,19,16,4,5,1,0,1,0,0,0,0,0,5501,75,8,-8,20,0,3,-1,1,54,24.4,29.6,4,5,-1,1
16095,14724,260,251,7,5,5,7,8,4,0,0,17,102,5,2,0,1,0,1,0,0,0,0,1371,9,2,-2,4,0,-85,3,-1,27.4,71.6,-44.2,4,3,1,1
15713,15664,285,298,5,5,5,5,4,3,0,0,18,19,5,2,1,1,0,1,0,0,0,0,49,-13,0,0,1,0,-1,3,0,61.4,24,37.4,4,5,-1,0
15136,16606,248,270,6,7,7,6,3,9,1,0,13,22,3,2,0,5,1,0,1,0,0,0,-1470,-22,-1,1,-6,0,-9,1,-5,77.4,43.6,33.8,5,2,3,0
17079,15378,284,274,9,4,4,10,15,4,0,1,17,18,1,2,1,0,1,0,0,1,0,0,1701,10,5,-6,11,0,-1,-1,1,56,60.4,-4.4,5,3,2,1
15198,15349,271,284,4,5,5,4,5,8,0,1,17,36,2,5,0,1,1,0,0,1,0,0,-151,-13,-1,1,-3,0,-19,-3,-1,42.2,15.8,26.4,2,3,-1,0
15201,15546,266,232,5,7,7,5,5,5,0,0,14,20,2,2,1,0,0,1,0,0,0,0,-345,34,-2,2,0,0,-6,0,1,16.8,80.4,-63.6,3,5,-2,0
14589,14749,266,246,3,5,5,3,6,6,1,0,25,19,4,0,2,1,1,0,1,0,0,0,-160,20,-2,2,0,0,6,4,1,8.2,100.6,-92.4,2,4,-2,0
14561,14778,249,254,4,5,5,4,7,4,0,1,18,17,4,4,0,0,0,1,0,1,0,0,-217,-5,-1,1,3,0,1,0,0,123,60.8,62.2,4,3,1,0
16955,16033,234,241,11,9,9,11,19,16,0,1,15,14,0,4,0,1,0,1,0,1,0,0,922,-7,2,-2,3,0,1,-4,-1,8,15.8,-7.8,2,3,-1,0
14886,16340,257,250,4,8,8,4,6,11,0,0,16,18,3,4,4,0,0,1,0,0,0,0,-1454,7,-4,4,-5,0,-2,-1,4,15.4,91.8,-76.4,4,5,-1,0
15500,15238,295,269,4,5,5,4,7,10,1,0,13,16,5,3,0,0,1,0,1,0,0,0,262,26,-1,1,-3,0,-3,2,0,102,29.8,72.2,3,3,0,1
13160,18093,239,295,1,12,12,2,2,10,0,0,14,17,4,5,0,3,0,1,0,0,0,0,-4933,-56,-11,10,-8,0,-3,-1,-3,22,21.4,0.6,3,5,-2,0
16063,15438,268,258,7,6,6,7,8,11,1,0,16,18,3,3,1,0,0,1,1,0,0,0,625,10,1,-1,-3,0,-2,0,1,24.4,27.8,-3.4,4,4,0,1
15669,15333,291,267,6,4,4,6,7,4,0,0,18,42,5,4,0,2,1,0,0,0,0,0,336,24,2,-2,3,0,-24,1,-2,21.6,16,5.6,4,5,-1,1
13710,13273,280,287,2,0,0,2,2,0,0,0,14,15,4,5,0,0,1,0,0,0,0,0,437,-7,2,-2,2,0,-1,-1,0,11.4,77.8,-66.4,4,5,-1,1
14176,15240,252,253,3,6,6,3,5,10,0,0,11,16,2,3,1,1,0,1,0,0,0,0,-1064,-1,-3,3,-5,0,-5,-1,0,70.4,26.8,43.6,3,5,-2,0
14578,16160,241,285,5,6,6,5,5,6,0,0,27,16,4,6,0,3,1,0,0,0,0,0,-1582,-44,-1,1,-1,0,11,-2,-3,20.2,13.6,6.6,3,4,-1,0
14684,16115,238,271,5,8,8,5,3,3,0,1,11,19,5,2,1,1,0,1,0,1,0,0,-1431,-33,-3,3,0,0,-8,3,0,47.8,13.2,34.6,4,2,2,1
17910,14418,309,274,10,3,3,10,19,4,0,0,17,114,5,5,0,0,1,0,0,0,0,0,3492,35,7,-7,15,0,-97,0,0,16.6,50.6,-34,4,4,0,1
16974,15485,253,246,8,6,6,8,13,15,0,1,32,23,4,2,0,0,0,1,0,1,0,0,1489,7,2,-2,-2,0,9,2,0,89.4,26.8,62.6,3,4,-1,1
15337,16149,264,280,7,7,7,7,5,7,0,0,19,21,4,5,0,0,0,1,0,0,0,0,-812,-16,0,0,-2,0,-2,-1,0,22.4,62.4,-40,4,5,-1,0
13910,13584,229,261,4,2,2,4,4,1,0,0,13,19,4,3,1,1,0,1,0,0,0,0,326,-32,2,-2,3,0,-6,1,0,8.8,51.6,-42.8,3,4,-1,0
17668,14974,226,223,14,6,7,14,14,6,0,0,12,17,4,4,2,0,1,0,0,0,0,0,2694,3,8,-7,8,0,-5,0,2,17.6,21.2,-3.6,5,4,1,0
12548,16414,242,286,1,8,8,1,0,7,0,0,17,11,1,2,0,1,1,0,0,0,0,0,-3866,-44,-7,7,-7,0,6,-1,-1,11.8,27.4,-15.6,4,3,1,0
14476,14575,262,269,3,4,4,3,3,5,0,0,14,19,4,3,0,0,1,0,0,0,0,0,-99,-7,-1,1,-2,0,-5,1,0,20.8,8.2,12.6,5,2,3,1
15765,14131,274,274,7,2,2,7,10,2,0,0,13,17,7,3,0,0,1,0,0,0,0,0,1634,0,5,-5,8,0,-4,4,0,38.6,22.4,16.2,2,3,-1,0
13411,16806,266,270,1,8,8,1,2,15,0,0,46,139,4,4,0,1,0,1,0,0,0,0,-3395,-4,-7,7,-13,0,-93,0,-1,9.8,34,-24.2,4,4,0,1
14156,15789,256,293,4,4,4,4,3,3,1,0,15,115,3,3,1,3,1,0,1,0,0,0,-1633,-37,0,0,0,0,-100,0,-2,11,20.6,-9.6,3,4,-1,1
14469,15035,282,276,2,4,4,2,3,2,0,0,20,39,3,3,0,2,0,1,0,0,0,0,-566,6,-2,2,1,0,-19,0,-2,25,22.4,2.6,5,3,2,1
15945,15448,268,224,6,7,7,6,12,10,1,0,15,33,3,3,1,1,0,1,1,0,0,0,497,44,-1,1,2,0,-18,0,0,11.6,15,-3.4,2,4,-2,1
14276,15827,268,238,3,7,7,3,2,13,0,0,16,35,4,2,0,0,0,1,0,0,0,0,-1551,30,-4,4,-11,0,-19,2,0,20.6,39.8,-19.2,4,4,0,0
14394,16175,267,260,3,7,7,3,4,10,0,0,16,19,4,1,1,1,1,0,0,0,0,0,-1781,7,-4,4,-6,0,-3,3,0,26,11,15,3,4,-1,0
16219,16540,236,276,8,8,8,8,9,10,0,0,13,23,1,2,0,1,0,1,0,0,0,0,-321,-40,0,0,-1,0,-10,-1,-1,28,62.6,-34.6,3,4,-1,0
14048,15350,245,229,4,7,7,4,3,12,0,0,38,15,2,1,0,0,0,1,0,0,0,0,-1302,16,-3,3,-9,0,23,1,0,65,15.8,49.2,5,3,2,1
15314,15846,250,281,6,6,6,6,6,9,0,0,19,17,1,3,0,0,1,0,0,0,0,0,-532,-31,0,0,-3,0,2,-2,0,19.8,20.2,-0.4,5,4,1,0
16153,13121,260,274,7,0,0,7,9,0,0,1,16,53,0,4,2,0,1,0,0,1,0,0,3032,-14,7,-7,9,0,-37,-4,2,38.6,102.8,-64.2,5,5,0,1
14306,14577,261,276,4,3,3,4,3,5,0,0,18,17,1,2,0,0,1,0,0,0,0,0,-271,-15,1,-1,-2,0,1,-1,0,27.4,18.4,9,2,4,-2,1
13235,14779,242,289,2,2,2,2,1,2,0,0,41,14,1,5,0,5,0,1,0,0,0,0,-1544,-47,0,0,-1,0,27,-4,-5,47.8,45.8,2,3,3,0,0
16676,14306,256,255,9,3,3,9,16,3,0,0,28,14,5,3,0,0,0,1,0,0,0,0,2370,1,6,-6,13,0,14,2,0,95.6,20.4,75.2,4,4,0,1
14968,15723,264,278,4,6,6,4,7,6,0,0,13,18,5,4,1,0,1,0,0,0,0,0,-755,-14,-2,2,1,0,-5,1,1,14.8,39,-24.2,3,5,-2,0
13885,18139,243,279,3,13,13,3,4,14,0,1,11,17,3,1,1,2,0,1,0,1,0,0,-4254,-36,-10,10,-10,0,-6,2,-1,30.4,35.2,-4.8,3,4,-1,0
14194,17385,261,263,3,11,11,3,2,13,0,0,14,31,2,1,1,2,0,1,0,0,0,0,-3191,-2,-8,8,-11,0,-17,1,-1,57.6,66.8,-9.2,3,4,-1,1
18016,15264,242,223,12,7,7,12,21,12,1,0,21,15,2,3,1,0,1,0,1,0,0,0,2752,19,5,-5,9,0,6,-1,1,34,11.2,22.8,1,3,-2,1
16095,13609,292,260,5,2,3,5,10,2,0,0,17,19,4,3,0,0,0,1,0,0,0,0,2486,32,3,-2,8,0,-2,1,0,74.4,9,65.4,5,3,2,1
14204,15280,250,271,3,5,5,3,5,3,0,1,16,172,1,5,0,3,0,1,0,1,0,0,-1076,-21,-2,2,2,0,-156,-4,-3,32.4,27,5.4,4,3,1,0
13977,15949,313,307,1,5,5,1,0,5,0,0,15,17,3,5,1,1,0,1,0,0,0,0,-1972,6,-4,4,-5,0,-2,-2,0,10.2,35.8,-25.6,4,3,1,0
14210,15147,269,269,3,6,6,3,2,4,0,0,15,16,2,2,0,1,1,0,0,0,0,0,-937,0,-3,3,-2,0,-1,0,-1,28.6,18,10.6,4,4,0,0
16664,17344,247,258,8,9,9,8,11,19,0,0,13,31,4,2,1,0,1,0,0,0,0,0,-680,-11,-1,1,-8,0,-18,2,1,110.4,9.6,100.8,4,2,2,1
14972,14355,285,299,4,2,2,4,5,2,0,0,13,15,2,0,0,0,1,0,0,0,0,0,617,-14,2,-2,3,0,-2,2,0,23,79.6,-56.6,5,4,1,1
10772,9237,166,93,6,5,5,6,2,7,0,0,6,5,1,0,0,0,1,0,0,0,0,0,1535,73,1,-1,-5,0,1,1,0,29.4,16.8,12.6,4,3,1,1
15181,14224,259,235,6,4,4,6,5,5,0,1,114,14,0,3,0,1,1,0,0,1,0,0,957,24,2,-2,0,0,100,-3,-1,23.2,70.8,-47.6,4,3,1,1
15744,14896,273,262,6,5,5,6,6,5,0,0,61,13,0,17,0,1,1,0,0,0,0,0,848,11,1,-1,1,0,48,-17,-1,133,9.2,123.8,3,4,-1,1
15719,15826,262,233,7,8,8,7,6,10,0,1,14,12,0,0,0,0,1,0,0,1,0,0,-107,29,-1,1,-4,0,2,0,0,61.4,172.2,-110.8,2,5,-3,1
14528,16125,272,277,3,7,7,3,3,11,0,1,18,34,1,4,0,0,1,0,0,1,0,0,-1597,-5,-4,4,-8,0,-16,-3,0,38.2,45,-6.8,3,4,-1,0
15111,17907,203,257,5,10,10,5,8,10,0,0,13,26,3,3,2,2,0,1,0,0,0,0,-2796,-54,-5,5,-2,0,-13,0,0,21.2,40.2,-19,4,2,2,0
15209,16401,259,284,5,6,6,5,6,9,1,0,17,13,1,4,0,1,0,1,1,0,0,0,-1192,-25,-1,1,-3,0,4,-3,-1,16.2,26.2,-10,3,2,1,1
13488,14776,238,229,3,6,7,3,1,10,0,0,16,13,3,1,0,0,0,1,0,0,0,0,-1288,9,-3,4,-9,0,3,2,0,27,15.2,11.8,3,3,0,1
14293,17971,232,282,4,12,12,4,3,8,0,1,16,13,3,2,0,0,0,1,0,1,0,0,-3678,-50,-8,8,-5,0,3,1,0,21.6,52,-30.4,2,4,-2,0
17994,13185,281,229,9,2,2,9,12,6,0,0,20,26,1,1,5,0,1,0,0,0,1,0,4809,52,7,-7,6,0,-6,0,5,37.8,32.8,5,2,3,-1,1
19369,14315,263,236,16,4,4,16,21,3,0,0,31,12,0,2,2,0,1,0,0,0,0,0,5054,27,12,-12,18,0,19,-2,2,65,41.6,23.4,4,4,0,1
15452,14364,252,253,6,4,4,6,7,7,0,1,17,32,1,3,0,0,0,1,0,1,0,0,1088,-1,2,-2,0,0,-15,-2,0,39.4,47.6,-8.2,5,2,3,1
14262,15140,255,266,3,5,5,3,3,6,0,1,18,14,2,2,1,0,0,1,0,1,0,0,-878,-11,-2,2,-3,0,4,0,1,28.8,86.2,-57.4,4,5,-1,0
16036,14069,277,244,7,3,3,7,11,5,0,0,23,35,8,6,0,0,1,0,0,0,0,0,1967,33,4,-4,6,0,-12,2,0,12.6,30.2,-17.6,2,4,-2,0
16719,15202,273,279,8,4,4,8,12,5,0,1,52,17,5,3,1,1,1,0,0,1,0,0,1517,-6,4,-4,7,0,35,2,0,61,9,52,5,2,3,0
15008,14653,268,243,4,6,6,4,3,5,0,0,13,16,4,2,2,1,1,0,0,0,0,0,355,25,-2,2,-2,0,-3,2,1,40.8,133.8,-93,3,4,-1,1
13941,15353,252,300,3,3,3,3,3,3,0,1,14,15,1,3,0,1,0,1,0,1,0,0,-1412,-48,0,0,0,0,-1,-2,-1,86.4,21.6,64.8,3,4,-1,0
15767,16976,220,270,8,10,10,8,7,9,1,0,20,61,3,6,1,1,0,1,1,0,0,0,-1209,-50,-2,2,-2,0,-41,-3,0,9.6,71.2,-61.6,4,3,1,1
13334,17092,248,291,2,10,10,2,3,10,0,1,106,20,3,3,0,0,1,0,0,1,0,0,-3758,-43,-8,8,-7,0,86,0,0,75.8,25.6,50.2,2,4,-2,0
16423,15283,282,238,8,6,6,8,6,4,1,0,15,19,4,3,2,2,0,1,1,0,0,0,1140,44,2,-2,2,0,-4,1,0,11.8,133.8,-122,4,5,-1,1
16059,14461,281,294,6,2,2,6,6,2,0,0,15,36,4,2,1,0,0,1,0,0,0,0,1598,-13,4,-4,4,0,-21,2,1,36.4,84,-47.6,3,4,-1,1
12955,16541,229,270,2,9,9,3,2,6,0,0,17,15,4,1,0,1,0,1,0,0,0,0,-3586,-41,-7,6,-4,0,2,3,-1,20.4,19.2,1.2,3,4,-1,1
15863,15007,234,257,8,5,5,8,10,3,0,0,19,16,4,5,0,1,1,0,0,0,0,0,856,-23,3,-3,7,0,3,-1,-1,46.4,85,-38.6,5,4,1,0
13922,16672,267,270,3,8,8,3,1,6,0,0,12,21,1,3,0,1,0,1,0,0,0,0,-2750,-3,-5,5,-5,0,-9,-2,-1,30.2,74.8,-44.6,4,4,0,0
13180,16901,251,269,1,9,9,1,0,14,0,0,34,15,6,3,0,0,0,1,0,0,0,0,-3721,-18,-8,8,-14,0,19,3,0,13.4,88,-74.6,4,4,0,0
14910,17322,265,263,4,10,10,4,3,18,0,0,50,15,2,4,1,1,0,1,0,0,0,0,-2412,2,-6,6,-15,0,35,-2,0,86.4,69.6,16.8,3,4,-1,0
15700,14380,299,279,5,2,2,5,6,1,0,1,12,16,5,3,0,0,1,0,0,1,0,0,1320,20,3,-3,5,0,-4,2,0,100.6,105.6,-5,5,4,1,0
13397,17542,235,255,3,10,10,3,2,21,0,1,18,21,4,4,0,1,0,1,0,1,0,0,-4145,-20,-7,7,-19,0,-3,0,-1,14.6,12.8,1.8,2,3,-1,0
16598,13843,273,261,8,2,2,8,10,1,0,0,18,102,2,3,1,1,1,0,0,0,0,0,2755,12,6,-6,9,0,-84,-1,0,19,40.4,-21.4,4,4,0,1
15694,15609,222,229,9,8,8,9,10,4,1,0,16,14,5,1,1,1,1,0,1,0,0,0,85,-7,1,-1,6,0,2,4,0,7.8,9.4,-1.6,2,2,0,1
16711,15853,284,267,8,6,6,8,9,5,0,1,19,20,4,3,0,0,1,0,0,1,0,0,858,17,2,-2,4,0,-1,1,0,134,14.6,119.4,5,5,0,0
14390,13587,282,255,2,2,2,2,2,3,0,0,16,18,4,5,1,0,1,0,0,0,0,0,803,27,0,0,-1,0,-2,-1,1,81,79.8,1.2,4,3,1,0
14299,14753,270,280,3,4,4,3,1,2,0,1,20,13,1,3,0,2,1,0,0,1,0,0,-454,-10,-1,1,-1,0,7,-2,-2,15.2,22,-6.8,2,4,-2,1
15837,13561,257,239,8,2,2,8,9,3,0,0,19,16,3,5,1,0,1,0,0,0,0,0,2276,18,6,-6,6,0,3,-2,1,17.2,74,-56.8,3,4,-1,1
17633,16074,253,265,13,6,6,13,10,6,0,0,123,14,2,1,2,1,1,0,0,0,0,0,1559,-12,7,-7,4,0,109,1,1,6.4,17.4,-11,1,5,-4,1
15323,15726,264,243,6,7,7,6,9,9,0,0,28,18,2,0,1,0,1,0,0,0,0,0,-403,21,-1,1,0,0,10,2,1,16.6,39,-22.4,3,4,-1,1
17215,16339,267,245,10,8,8,10,8,8,0,0,15,21,0,3,2,0,1,0,0,0,0,0,876,22,2,-2,0,0,-6,-3,2,69.4,15.8,53.6,3,4,-1,1
16134,14436,243,260,7,3,3,7,8,3,0,0,17,43,17,3,1,1,1,0,0,0,0,0,1698,-17,4,-4,5,0,-26,14,0,29.8,11.4,18.4,3,4,-1,1
14431,16613,254,259,4,10,10,5,5,5,0,0,49,18,4,1,1,1,0,1,0,0,0,0,-2182,-5,-6,5,0,0,31,3,0,45.2,28.6,16.6,2,5,-3,0
15606,16430,265,260,5,7,7,5,4,10,0,1,13,18,5,2,0,3,0,1,0,1,0,0,-824,5,-2,2,-6,0,-5,3,-3,31.2,61.8,-30.6,4,4,0,0
15531,14938,269,269,6,4,4,6,9,5,0,0,20,19,2,4,0,0,1,0,0,0,0,0,593,0,2,-2,4,0,1,-2,0,75.4,15.6,59.8,4,3,1,1
16624,14968,250,233,9,6,6,9,9,9,0,0,18,99,4,2,1,0,0,1,0,0,0,0,1656,17,3,-3,0,0,-81,2,1,78.8,13.6,65.2,4,4,0,1
16530,18443,263,264,7,11,11,7,11,23,1,0,17,14,3,3,2,2,0,1,1,0,0,0,-1913,-1,-4,4,-12,0,3,0,0,30.4,90.4,-60,5,4,1,0
13024,15080,219,249,2,6,6,2,3,11,0,1,72,17,0,10,0,0,0,1,0,1,0,0,-2056,-30,-4,4,-8,0,55,-10,0,61.2,46.2,15,4,3,1,0
14765,15104,265,313,3,3,3,3,4,2,0,0,21,17,2,8,0,0,0,1,0,0,0,0,-339,-48,0,0,2,0,4,-6,0,75.8,91.4,-15.6,4,4,0,0
13861,14927,279,278,1,4,4,1,2,4,0,1,89,20,5,3,1,0,0,1,0,1,0,0,-1066,1,-3,3,-2,0,69,2,1,107.6,63.4,44.2,5,5,0,0
14650,14716,279,299,3,2,2,3,7,2,0,0,59,17,4,3,1,1,1,0,0,0,0,0,-66,-20,1,-1,5,0,42,1,0,84,207.4,-123.4,5,5,0,1
13757,15709,271,267,1,7,7,1,1,5,0,0,27,19,6,1,1,0,0,1,0,0,0,0,-1952,4,-6,6,-4,0,8,5,1,74.8,43.6,31.2,5,5,0,0
15615,15767,254,274,6,7,7,7,10,8,0,1,44,17,1,3,0,1,0,1,0,1,0,0,-152,-20,-1,0,2,0,27,-2,-1,132,64.2,67.8,4,3,1,1
16595,15768,273,255,8,7,7,8,15,12,0,0,19,27,5,1,0,0,1,0,0,0,0,0,827,18,1,-1,3,0,-8,4,0,33,61.6,-28.6,5,4,1,1
15366,15461,240,262,5,6,7,5,6,4,0,1,14,16,4,3,1,0,1,0,0,1,0,0,-95,-22,-1,2,2,0,-2,1,1,64.8,30.8,34,2,4,-2,1
15631,14427,300,282,4,2,2,4,5,3,1,0,17,26,0,4,0,0,1,0,1,0,0,0,1204,18,2,-2,2,0,-9,-4,0,12.8,95.2,-82.4,4,4,0,1
15394,14934,263,255,6,5,5,6,2,5,0,0,36,18,2,4,1,1,0,1,0,0,0,0,460,8,1,-1,-3,0,18,-2,0,76.2,12.6,63.6,4,3,1,0
15582,15394,279,301,4,4,4,5,6,7,0,1,109,18,2,7,0,0,1,0,0,1,0,0,188,-22,0,-1,-1,0,91,-5,0,60.8,116.2,-55.4,4,4,0,0
16091,14624,248,238,8,6,6,8,8,3,0,1,15,14,1,4,0,0,1,0,0,1,0,0,1467,10,2,-2,5,0,1,-3,0,24.2,9.6,14.6,4,2,2,1
16285,16103,283,275,6,7,7,6,7,9,0,0,15,20,1,1,0,0,1,0,0,0,0,0,182,8,-1,1,-2,0,-5,0,0,61.4,105.6,-44.2,5,5,0,1
12998,15474,253,280,1,5,5,1,3,8,0,1,16,17,2,3,0,0,0,1,0,1,0,0,-2476,-27,-4,4,-5,0,-1,-1,0,65.6,99.8,-34.2,4,5,-1,1
13928,15234,242,259,3,6,6,3,2,10,0,1,19,19,3,8,1,0,0,1,0,1,0,0,-1306,-17,-3,3,-8,0,0,-5,1,25.4,16.8,8.6,4,3,1,0
16440,15169,257,230,7,6,6,8,8,6,0,0,13,12,1,3,2,0,1,0,0,0,0,0,1271,27,1,-2,2,0,1,-2,2,23,8.4,14.6,5,2,3,1
13919,15917,225,283,3,5,5,3,7,8,0,1,17,47,0,4,1,3,0,1,0,1,0,0,-1998,-58,-2,2,-1,0,-30,-4,-2,17.8,26.6,-8.8,5,5,0,0
14380,14167,243,250,5,3,3,5,6,2,1,0,21,37,4,4,0,0,0,1,1,0,0,0,213,-7,2,-2,4,0,-16,0,0,34.8,29,5.8,3,5,-2,0
15489,15223,260,241,8,6,6,8,5,9,0,0,15,13,3,3,1,0,1,0,0,0,0,0,266,19,2,-2,-4,0,2,0,1,113.8,8.6,105.2,5,2,3,1
17827,15242,259,215,12,6,6,12,17,7,1,0,37,12,3,2,1,0,1,0,1,0,0,0,2585,44,6,-6,10,0,25,1,1,79.6,20,59.6,3,5,-2,1
17001,14242,272,279,9,2,2,9,18,1,0,0,24,39,6,2,0,1,1,0,0,0,0,0,2759,-7,7,-7,17,0,-15,4,-1,49,73,-24,5,5,0,1
15638,16107,281,281,6,6,6,6,7,8,1,0,34,16,5,2,0,2,1,0,1,0,0,0,-469,0,0,0,-1,0,18,3,-2,66,13.4,52.6,5,3,2,1
13503,15449,238,233,3,7,7,3,1,13,0,0,18,15,4,2,0,3,0,1,0,0,0,0,-1946,5,-4,4,-12,0,3,2,-3,15.4,119.8,-104.4,3,3,0,0
14028,14523,253,259,3,4,5,3,3,7,0,0,13,32,4,2,0,0,0,1,0,0,0,0,-495,-6,-1,2,-4,0,-19,2,0,12.6,36,-23.4,4,5,-1,0
15311,15093,220,286,8,4,4,8,10,4,0,0,14,32,1,2,0,1,0,1,0,0,0,0,218,-66,4,-4,6,0,-18,-1,-1,56.6,40.6,16,3,4,-1,1
15774,14722,248,244,7,6,6,7,8,8,0,1,25,15,2,1,1,1,1,0,0,1,0,0,1052,4,1,-1,0,0,10,1,0,30,23.8,6.2,4,4,0,1
15401,14045,291,269,5,2,2,5,5,3,0,0,24,112,7,5,0,0,1,0,0,0,0,0,1356,22,3,-3,2,0,-88,2,0,21.6,42,-20.4,4,5,-1,0
14956,13671,245,242,6,2,2,6,8,2,0,0,17,20,3,2,0,2,0,1,0,0,0,0,1285,3,4,-4,6,0,-3,1,-2,15,19.4,-4.4,3,4,-1,0
18404,14162,253,234,16,3,3,16,14,3,0,1,17,17,3,3,0,0,1,0,0,1,0,0,4242,19,13,-13,11,0,0,0,0,47.6,30.6,17,5,4,1,1
13031,15368,223,284,2,6,7,2,6,3,0,0,20,15,0,4,0,1,1,0,0,0,0,0,-2337,-61,-4,5,3,0,5,-4,-1,49.6,12.2,37.4,4,3,1,1
15008,14263,269,258,5,3,3,6,4,7,0,1,18,9,1,7,0,0,0,1,0,1,0,0,745,11,2,-3,-3,0,9,-6,0,24.4,44.4,-20,4,5,-1,0
14738,13668,297,266,3,1,1,3,4,1,0,0,32,14,2,1,0,1,1,0,0,0,0,0,1070,31,2,-2,3,0,18,1,-1,29.6,88.4,-58.8,5,5,0,1
15085,16264,248,271,5,8,8,5,5,5,1,0,16,32,4,1,0,2,1,0,1,0,0,0,-1179,-23,-3,3,0,0,-16,3,-2,8,44,-36,1,4,-3,0
13533,16876,242,223,1,12,12,1,0,14,0,0,44,13,5,19,2,0,0,1,0,0,0,0,-3343,19,-11,11,-14,0,31,-14,2,134.4,19.6,114.8,3,3,0,0
14865,16588,249,231,5,10,10,5,3,15,0,0,38,20,3,14,4,0,0,1,0,0,0,0,-1723,18,-5,5,-12,0,18,-11,4,120.8,11,109.8,3,4,-1,1
14727,13747,269,259,5,2,2,5,2,3,0,0,16,30,4,4,1,1,1,0,0,0,0,0,980,10,3,-3,-1,0,-14,0,0,110.4,49.6,60.8,4,5,-1,1
14769,15094,277,285,3,4,4,3,4,5,0,0,16,15,2,5,1,0,0,1,0,0,0,0,-325,-8,-1,1,-1,0,1,-3,1,43,35,8,5,2,3,1
15936,13433,256,204,8,4,4,8,5,2,0,0,14,25,5,4,0,0,1,0,0,0,0,0,2503,52,4,-4,3,0,-11,1,0,16,28,-12,3,4,-1,1
18173,15560,257,242,11,6,6,11,11,7,0,0,15,12,4,3,4,3,0,1,0,0,0,0,2613,15,5,-5,4,0,3,1,1,111,42.4,68.6,5,2,3,1
13699,14514,245,275,3,3,3,3,3,3,0,0,19,35,2,5,1,1,0,1,0,0,0,0,-815,-30,0,0,0,0,-16,-3,0,113.8,24.2,89.6,3,3,0,0
14181,14077,243,262,3,3,3,3,3,4,0,0,18,13,0,8,0,1,0,1,0,0,0,0,104,-19,0,0,-1,0,5,-8,-1,88,38.8,49.2,5,3,2,0
16293,14670,300,276,6,3,3,6,11,7,0,0,40,18,1,5,1,0,1,0,0,0,0,0,1623,24,3,-3,4,0,22,-4,1,58.4,106.8,-48.4,4,4,0,1
15415,13583,285,295,6,1,1,6,4,0,1,0,14,23,5,1,0,0,1,0,1,0,0,0,1832,-10,5,-5,4,0,-9,4,0,86.2,17.8,68.4,4,4,0,1
15190,13238,225,259,6,1,1,6,11,0,1,0,21,16,2,3,0,1,0,1,1,0,0,0,1952,-34,5,-5,11,0,5,-1,-1,41.6,68.4,-26.8,4,4,0,1
14242,15442,270,288,3,3,3,3,7,7,0,1,103,21,4,0,0,0,0,1,0,1,0,0,-1200,-18,0,0,0,0,82,4,0,21.2,57.8,-36.6,5,5,0,0
16650,16910,220,248,10,10,10,10,16,11,0,0,111,35,1,0,0,0,0,1,0,0,0,0,-260,-28,0,0,5,0,76,1,0,60,55.8,4.2,4,4,0,0
16656,15551,253,241,7,7,7,7,9,7,0,1,115,18,3,2,0,0,0,1,0,1,0,0,1105,12,0,0,2,0,97,1,0,60.8,17,43.8,3,4,-1,1
15367,17172,232,248,7,11,11,7,7,13,0,1,17,11,0,3,0,0,0,1,0,1,0,0,-1805,-16,-4,4,-6,0,6,-3,0,54,148.8,-94.8,3,5,-2,0
14121,18648,251,303,3,11,11,3,4,10,0,0,37,20,4,2,0,5,1,0,0,0,0,0,-4527,-52,-8,8,-6,0,17,2,-5,46.8,17.4,29.4,5,5,0,0
16991,13449,286,261,10,2,2,10,11,0,1,0,15,14,2,2,0,1,1,0,1,0,0,0,3542,25,8,-8,11,0,1,0,-1,101.8,70,31.8,5,4,1,1
14754,15563,242,252,5,8,8,5,3,4,0,1,14,61,1,3,0,1,1,0,0,1,0,0,-809,-10,-3,3,-1,0,-47,-2,-1,175.8,39,136.8,4,5,-1,0
15306,15907,269,299,4,5,5,5,3,7,0,1,13,15,3,3,0,3,0,1,0,1,0,0,-601,-30,-1,0,-4,0,-2,0,-3,21,31.4,-10.4,4,5,-1,0
16173,16658,211,254,9,10,10,9,8,8,0,1,18,17,2,4,0,2,0,1,0,1,0,0,-485,-43,-1,1,0,0,1,-2,-2,81,36.6,44.4,4,3,1,0
14710,14551,264,250,3,5,5,3,5,3,0,0,14,14,4,3,1,0,0,1,0,0,0,0,159,14,-2,2,2,0,0,1,1,10.8,26,-15.2,5,5,0,1
13586,16642,231,269,3,8,8,3,4,11,0,1,11,15,2,2,0,0,1,0,0,1,0,0,-3056,-38,-5,5,-7,0,-4,0,0,118.8,81.2,37.6,5,3,2,0
17681,14526,276,246,11,5,6,11,15,5,0,0,37,15,5,5,2,0,1,0,0,0,0,0,3155,30,6,-5,10,0,22,0,2,86,18.6,67.4,3,4,-1,1
16937,14463,294,277,9,3,3,9,6,3,1,0,17,13,4,3,0,0,1,0,1,0,0,0,2474,17,6,-6,3,0,4,1,0,64.6,108.6,-44,5,4,1,1
14083,14650,258,292,3,2,2,3,3,2,0,0,33,16,5,4,0,1,0,1,0,0,0,0,-567,-34,1,-1,1,0,17,1,-1,11,17,-6,3,4,-1,0
14160,15197,247,274,3,5,5,3,5,6,0,0,13,16,2,1,0,1,0,1,0,0,0,0,-1037,-27,-2,2,-1,0,-3,1,-1,14.2,57,-42.8,2,5,-3,0
13850,15000,263,266,2,6,6,2,3,8,0,1,20,15,1,2,0,0,0,1,0,1,0,0,-1150,-3,-4,4,-5,0,5,-1,0,17.2,56.2,-39,5,5,0,1
15622,15057,263,281,7,3,3,7,12,5,0,0,13,12,3,1,0,1,1,0,0,0,0,0,565,-18,4,-4,7,0,1,2,-1,43.2,74.4,-31.2,5,4,1,1
15653,15057,271,268,8,5,5,8,3,2,0,1,17,15,2,5,0,0,1,0,0,1,0,0,596,3,3,-3,1,0,2,-3,0,11.2,40,-28.8,3,4,-1,1
15533,15411,282,258,5,7,7,5,3,9,0,0,15,13,3,1,1,1,1,0,0,0,0,0,122,24,-2,2,-6,0,2,2,0,19.4,16.2,3.2,3,3,0,1
17471,14478,261,271,11,3,3,11,15,2,0,0,11,17,4,2,0,1,1,0,0,0,0,0,2993,-10,8,-8,13,0,-6,2,-1,136,71.8,64.2,4,5,-1,1
14369,15333,274,279,2,6,6,2,3,8,1,0,29,14,2,6,1,0,0,1,1,0,0,0,-964,-5,-4,4,-5,0,15,-4,1,28,17.6,10.4,4,4,0,0
16586,16013,281,260,9,6,6,9,5,10,0,0,51,14,4,5,1,2,1,0,0,0,0,0,573,21,3,-3,-5,0,37,-1,-1,59.8,34,25.8,4,5,-1,0
14654,16759,275,260,3,10,10,3,2,9,0,0,15,17,2,4,1,2,1,0,0,0,0,0,-2105,15,-7,7,-7,0,-2,-2,-1,20.4,26.8,-6.4,4,3,1,1
15625,14852,287,239,6,4,4,6,0,2,0,0,19,11,0,3,1,3,1,0,0,0,0,0,773,48,2,-2,-2,0,8,-3,-2,20.2,56,-35.8,3,3,0,1
14170,17327,238,244,4,11,11,4,2,15,0,0,24,14,5,3,0,3,0,1,0,0,0,0,-3157,-6,-7,7,-13,0,10,2,-3,68,75.8,-7.8,4,5,-1,0
14264,14656,242,229,5,6,6,5,4,6,0,0,14,16,3,2,0,0,0,1,0,0,0,0,-392,13,-1,1,-2,0,-2,1,0,43.4,30.6,12.8,4,5,-1,0
14020,14484,253,263,3,3,3,3,2,1,1,0,19,28,4,3,0,2,0,1,1,0,0,0,-464,-10,0,0,1,0,-9,1,-2,96.6,59.2,37.4,4,3,1,0
14341,17055,262,287,3,8,8,3,2,7,0,0,30,31,5,4,0,1,1,0,0,0,0,0,-2714,-25,-5,5,-5,0,-1,1,-1,54.6,8.6,46,3,3,0,0
15353,14720,231,237,7,5,5,7,7,7,0,0,14,31,4,2,1,0,1,0,0,0,0,0,633,-6,2,-2,0,0,-17,2,1,97,20.8,76.2,5,5,0,1
2530,2550,1,2,0,0,0,0,0,0,0,0,1,1,1,0,0,0,0,0,0,0,0,0,-20,-1,0,0,0,0,0,1,0,30.4,55.4,-25,5,3,2,0
16146,15799,253,256,10,6,6,10,9,6,1,0,14,17,4,5,0,0,1,0,1,0,0,0,347,-3,4,-4,3,0,-3,-1,0,35.6,32.6,3,4,4,0,0
17720,14598,252,251,10,5,5,10,14,6,0,0,15,13,4,2,1,0,1,0,0,0,0,0,3122,1,5,-5,8,0,2,2,1,72,22.4,49.6,5,4,1,1
14426,14692,282,286,3,4,4,3,2,2,0,1,21,35,2,6,1,1,1,0,0,1,0,0,-266,-4,-1,1,0,0,-14,-4,0,87,49.2,37.8,4,3,1,0
12656,13901,244,245,1,4,4,1,1,4,1,0,9,20,4,1,0,2,0,1,1,0,0,0,-1245,-1,-3,3,-3,0,-11,3,-2,98.8,59,39.8,4,5,-1,0
16526,13800,268,234,9,3,3,9,9,1,0,0,16,18,2,1,1,1,1,0,0,0,0,0,2726,34,6,-6,8,0,-2,1,0,16.6,24,-7.4,4,5,-1,1
16396,17573,250,252,8,12,12,8,8,16,0,1,27,37,3,4,0,1,0,1,0,1,0,0,-1177,-2,-4,4,-8,0,-10,-1,-1,24.8,75.8,-51,4,5,-1,0
15274,14446,283,276,5,3,3,5,4,4,0,0,11,106,3,0,1,0,1,0,0,0,0,0,828,7,2,-2,0,0,-95,3,1,25.6,37.4,-11.8,2,5,-3,0
14132,17065,276,273,2,9,9,2,2,10,0,1,16,15,1,5,0,0,0,1,0,1,0,0,-2933,3,-7,7,-8,0,1,-4,0,41.8,19.2,22.6,4,5,-1,0
14319,15588,257,258,4,7,7,4,2,9,0,1,13,19,3,0,0,0,0,1,0,1,0,0,-1269,-1,-3,3,-7,0,-6,3,0,20.4,10.4,10,4,3,1,1
17238,15264,282,242,9,5,5,9,13,8,0,0,14,15,4,3,1,0,0,1,0,0,0,0,1974,40,4,-4,5,0,-1,1,1,17.8,41.2,-23.4,3,4,-1,1
14985,15956,235,246,6,8,8,6,7,8,0,0,19,43,2,3,0,1,0,1,0,0,0,0,-971,-11,-2,2,-1,0,-24,-1,-1,87.4,9.2,78.2,4,4,0,1
13940,16368,250,284,2,8,8,2,0,9,0,0,28,17,1,3,1,0,0,1,0,0,0,0,-2428,-34,-6,6,-9,0,11,-2,1,6.8,8.8,-2,2,3,-1,0
15306,15076,263,267,6,3,3,6,8,3,0,0,34,19,5,4,1,1,1,0,0,0,0,0,230,-4,3,-3,5,0,15,1,0,48.8,9.4,39.4,2,3,-1,1
15359,14151,278,272,5,3,3,5,4,2,0,0,23,21,2,4,2,0,0,1,0,0,0,0,1208,6,2,-2,2,0,2,-2,2,84.4,104,-19.6,4,3,1,1
15195,15788,241,228,6,8,8,6,8,3,0,0,15,7,1,2,1,1,0,1,0,0,0,0,-593,13,-2,2,5,0,8,-1,0,11.6,195.4,-183.8,2,4,-2,1
17032,14986,267,264,8,5,5,9,15,4,0,1,119,19,6,4,1,1,0,1,0,1,0,0,2046,3,3,-4,11,0,100,2,0,68.4,52,16.4,4,4,0,1
15567,13437,294,292,4,0,0,4,4,0,1,0,37,11,4,2,0,0,1,0,1,0,0,0,2130,2,4,-4,4,0,26,2,0,18.6,10.8,7.8,3,3,0,1
15784,15180,276,273,6,5,6,6,6,4,0,1,15,17,5,3,0,0,0,1,0,1,0,0,604,3,1,0,2,0,-2,2,0,35.8,21,14.8,5,4,1,1
15837,15127,268,273,6,4,4,6,11,6,0,0,39,14,1,5,0,0,1,0,0,0,0,0,710,-5,2,-2,5,0,25,-4,0,14.8,44.8,-30,4,5,-1,0
17311,14741,251,265,10,4,4,10,12,4,0,0,18,14,1,1,0,0,1,0,0,0,0,0,2570,-14,6,-6,8,0,4,0,0,20,16.4,3.6,3,5,-2,1
16697,16784,296,275,6,8,8,6,4,9,0,1,12,102,1,1,0,0,1,0,0,1,0,0,-87,21,-2,2,-5,0,-90,0,0,151.4,32.4,119,5,4,1,0
14157,14913,255,273,3,4,4,3,4,5,0,0,74,38,3,4,0,0,0,1,0,0,0,0,-756,-18,-1,1,-1,0,36,-1,0,71.8,15,56.8,3,5,-2,0
14184,15430,284,292,2,4,4,2,2,8,0,1,36,16,3,3,0,1,1,0,0,1,0,0,-1246,-8,-2,2,-6,0,20,0,-1,57.6,11.6,46,4,2,2,1
14691,16571,259,262,4,8,8,4,2,13,0,0,16,57,0,2,3,2,1,0,0,0,0,0,-1880,-3,-4,4,-11,0,-41,-2,1,92.2,57,35.2,5,3,2,0
15253,15272,250,261,6,6,6,6,4,8,0,1,21,14,3,4,1,1,0,1,0,1,0,0,-19,-11,0,0,-4,0,7,-1,0,12.6,41.6,-29,4,4,0,1
14731,15505,282,281,3,5,5,3,4,10,0,1,35,16,2,4,1,1,0,1,0,1,0,0,-774,1,-2,2,-6,0,19,-2,0,21.4,7.8,13.6,5,2,3,0
15183,13351,281,211,5,4,4,5,1,3,0,0,28,12,3,2,2,0,0,1,0,0,0,0,1832,70,1,-1,-2,0,16,1,2,84,110.2,-26.2,4,4,0,1
15703,15308,245,278,8,6,6,8,4,0,1,0,20,15,4,2,1,1,1,0,1,0,0,0,395,-33,2,-2,4,0,5,2,0,11.2,94.6,-83.4,3,5,-2,0
14826,13877,264,293,5,2,2,5,3,2,0,1,16,18,5,6,1,0,0,1,0,1,0,0,949,-29,3,-3,1,0,-2,-1,1,127,27,100,3,4,-1,0
15252,17517,241,264,6,10,10,6,5,12,0,0,21,55,5,6,0,0,1,0,0,0,0,0,-2265,-23,-4,4,-7,0,-34,-1,0,44.6,13.8,30.8,4,3,1,0
17892,13494,297,259,12,2,2,12,15,2,0,0,15,15,2,1,1,0,1,0,0,0,0,0,4398,38,10,-10,13,0,0,1,1,81.8,10.2,71.6,4,3,1,1
15620,14230,261,252,6,3,3,6,9,5,0,0,13,16,4,3,0,0,1,0,0,0,0,0,1390,9,3,-3,4,0,-3,1,0,75,9.2,65.8,4,4,0,0
14441,17860,276,250,2,12,12,2,2,17,0,0,37,19,5,3,1,0,0,1,0,0,0,0,-3419,26,-10,10,-15,0,18,2,1,26.8,59.8,-33,5,5,0,0
18170,14772,272,211,11,6,6,11,16,8,0,0,25,17,5,2,1,0,1,0,0,0,0,0,3398,61,5,-5,8,0,8,3,1,26.6,11.8,14.8,5,3,2,1
13717,15164,270,289,2,4,4,2,4,5,0,0,14,21,2,2,0,2,0,1,0,0,0,0,-1447,-19,-2,2,-1,0,-7,0,-2,14.8,41.8,-27,4,4,0,0
14438,14471,271,250,2,4,4,2,5,4,0,0,16,27,6,2,1,0,0,1,0,0,0,0,-33,21,-2,2,1,0,-11,4,1,18.8,110.8,-92,4,4,0,1
17403,16600,250,229,11,9,9,11,11,18,0,1,20,141,3,2,0,0,1,0,0,1,0,0,803,21,2,-2,-7,0,-121,1,0,91,8.2,82.8,5,3,2,0
13878,15042,269,266,2,4,4,2,0,6,0,0,16,14,1,7,0,1,0,1,0,0,0,0,-1164,3,-2,2,-6,0,2,-6,-1,13.2,13.4,-0.2,3,4,-1,1
17169,16041,231,213,12,8,8,12,24,11,0,1,41,21,3,2,0,0,1,0,0,1,0,0,1128,18,4,-4,13,0,20,1,0,28,36.2,-8.2,4,4,0,1
16813,13898,273,209,8,4,4,8,9,4,0,0,17,10,1,2,2,1,0,1,0,0,0,0,2915,64,4,-4,5,0,7,-1,1,9.4,22,-12.6,3,3,0,1
14253,13930,243,262,4,2,2,4,2,2,0,0,16,17,1,3,0,0,1,0,0,0,0,0,323,-19,2,-2,0,0,-1,-2,0,34.6,11.2,23.4,4,5,-1,0
15311,13808,247,261,7,2,2,7,6,3,1,0,15,14,0,5,1,0,1,0,1,0,0,0,1503,-14,5,-5,3,0,1,-5,1,95,44.4,50.6,4,4,0,1
15604,14412,255,241,7,4,4,8,3,6,1,0,11,40,8,2,1,2,0,1,1,0,0,0,1192,14,3,-4,-3,0,-29,6,-1,33.8,76.4,-42.6,5,5,0,1
14188,15752,242,286,4,6,6,4,4,2,1,0,14,19,5,3,1,3,0,1,1,0,0,0,-1564,-44,-2,2,2,0,-5,2,-2,63.4,13.6,49.8,4,3,1,1
16433,15641,290,267,7,5,5,7,7,6,0,0,22,17,3,2,1,0,1,0,0,0,0,0,792,23,2,-2,1,0,5,1,1,36,15.4,20.6,5,3,2,1
16459,15530,262,259,8,6,6,8,10,9,0,0,21,15,3,3,1,0,0,1,0,0,0,0,929,3,2,-2,1,0,6,0,1,76.4,38.4,38,3,5,-2,0
15272,15878,251,247,6,8,8,6,5,8,0,0,36,35,4,5,0,1,0,1,0,0,0,0,-606,4,-2,2,-3,0,1,-1,-1,21.2,33.2,-12,3,5,-2,0
15176,16110,234,260,8,8,8,8,4,4,0,0,18,29,3,4,0,3,0,1,0,0,0,0,-934,-26,0,0,0,0,-11,-1,-3,37,26.2,10.8,3,5,-2,0
16410,14163,256,270,8,2,2,8,13,5,0,0,23,17,2,3,0,0,1,0,0,0,0,0,2247,-14,6,-6,8,0,6,-1,0,86.2,25.8,60.4,4,2,2,0
14876,14143,301,282,3,2,2,3,5,2,1,0,19,19,1,3,0,1,1,0,1,0,0,0,733,19,1,-1,3,0,0,-2,-1,111.4,51,60.4,4,2,2,1
16438,13795,265,257,7,2,2,7,10,5,0,0,16,28,6,3,1,0,1,0,0,0,0,0,2643,8,5,-5,5,0,-12,3,1,14.2,60.2,-46,3,5,-2,1
15622,13753,263,252,7,2,2,7,8,1,0,0,12,20,6,2,0,1,1,0,0,0,0,0,1869,11,5,-5,7,0,-8,4,-1,13,38.2,-25.2,4,4,0,1
14946,14784,231,272,6,4,4,6,11,6,0,0,13,15,3,4,1,1,1,0,0,0,0,0,162,-41,2,-2,5,0,-2,-1,0,31,22.6,8.4,3,4,-1,1
15333,15519,244,266,7,7,7,7,5,6,0,1,15,24,2,2,1,1,1,0,0,1,0,0,-186,-22,0,0,-1,0,-9,0,0,31,34,-3,4,5,-1,1
14780,14973,265,281,4,4,4,4,5,3,0,0,17,16,1,1,0,1,1,0,0,0,0,0,-193,-16,0,0,2,0,1,0,-1,48.4,11.2,37.2,3,4,-1,0
15940,16490,260,255,7,7,7,7,9,11,0,0,38,16,3,7,0,0,0,1,0,0,0,0,-550,5,0,0,-2,0,22,-4,0,22.6,34.4,-11.8,3,3,0,1
13320,15322,260,264,1,6,6,1,2,4,0,1,13,13,1,3,0,2,0,1,0,1,0,0,-2002,-4,-5,5,-2,0,0,-2,-2,18.8,29,-10.2,2,5,-3,0
13723,14583,254,276,3,3,3,3,6,3,0,1,18,16,3,3,0,1,1,0,0,1,0,0,-860,-22,0,0,3,0,2,0,-1,22.6,15.4,7.2,5,3,2,0
17882,16152,255,244,12,9,9,12,15,8,0,0,17,30,0,1,1,0,1,0,0,0,0,0,1730,11,3,-3,7,0,-13,-1,1,43.8,43.6,0.2,5,2,3,1
14989,13905,284,260,3,3,3,3,4,4,0,0,16,14,4,3,0,0,0,1,0,0,0,0,1084,24,0,0,0,0,2,1,0,49,10.4,38.6,5,2,3,1
15269,16829,235,249,5,10,10,5,6,10,0,0,17,17,4,1,0,2,0,1,0,0,0,0,-1560,-14,-5,5,-4,0,0,3,-2,32.4,33.4,-1,3,2,1,0
13791,15662,271,296,1,5,5,1,2,5,0,0,19,14,2,5,0,0,0,1,0,0,0,0,-1871,-25,-4,4,-3,0,5,-3,0,56.2,33.8,22.4,5,3,2,0
16155,15292,252,244,7,5,5,7,12,8,0,0,16,15,5,1,1,1,0,1,0,0,0,0,863,8,2,-2,4,0,1,4,0,38.8,123,-84.2,5,4,1,1
17949,14194,261,265,10,3,3,10,15,4,1,0,18,19,4,5,1,1,0,1,1,0,0,0,3755,-4,7,-7,11,0,-1,-1,0,157,53.2,103.8,5,4,1,1
16605,15092,244,248,10,5,5,10,13,2,1,0,14,20,2,3,1,0,1,0,1,0,0,0,1513,-4,5,-5,11,0,-6,-1,1,28.8,77.2,-48.4,3,2,1,1
13770,15365,284,320,1,3,3,1,1,3,0,1,42,14,2,5,0,0,1,0,0,1,0,0,-1595,-36,-2,2,-2,0,28,-3,0,20.2,69.6,-49.4,3,4,-1,0
15089,14770,296,263,3,6,6,3,5,4,0,1,16,13,2,7,0,0,0,1,0,1,0,0,319,33,-3,3,1,0,3,-5,0,12.2,44.2,-32,5,5,0,1
14255,13661,234,274,5,2,3,5,8,0,0,1,15,14,2,2,0,2,1,0,0,1,0,0,594,-40,3,-2,8,0,1,0,-2,27,13.8,13.2,2,2,0,1
15714,13652,299,263,5,1,1,5,4,2,1,0,14,104,2,2,1,0,1,0,1,0,0,0,2062,36,4,-4,2,0,-90,0,1,99,12.4,86.6,5,4,1,1
15136,16085,250,251,5,9,9,5,5,5,0,1,37,16,6,3,1,1,0,1,0,1,0,0,-949,-1,-4,4,0,0,21,3,0,12.2,12.6,-0.4,3,3,0,1
14794,15814,290,297,3,6,6,3,2,6,0,0,15,17,2,3,0,1,0,1,0,0,0,0,-1020,-7,-3,3,-4,0,-2,-1,-1,73.4,29.2,44.2,3,4,-1,1
14446,15002,289,260,2,5,5,2,3,5,0,1,17,17,4,4,0,0,1,0,0,1,0,0,-556,29,-3,3,-2,0,0,0,0,30.6,56.8,-26.2,5,4,1,0
15710,15648,294,293,5,5,5,5,3,4,0,0,114,13,3,5,1,1,1,0,0,0,0,0,62,1,0,0,-1,0,101,-2,0,9.8,34.8,-25,3,3,0,1
14107,14830,278,252,2,6,6,2,2,8,0,1,14,17,2,3,1,0,0,1,0,1,0,0,-723,26,-4,4,-6,0,-3,-1,1,46.4,47,-0.6,4,4,0,0
15295,14513,283,251,5,4,4,5,5,5,0,1,15,19,2,1,1,0,1,0,0,1,0,0,782,32,1,-1,0,0,-4,1,1,41.6,17.8,23.8,4,3,1,0
13752,15154,231,266,3,5,5,3,2,7,0,1,12,15,2,1,1,2,1,0,0,1,0,0,-1402,-35,-2,2,-5,0,-3,1,-1,27.2,42.8,-15.6,4,4,0,0
15133,14513,303,249,3,4,4,3,5,8,0,1,17,35,5,4,0,0,1,0,0,1,0,0,620,54,-1,1,-3,0,-18,1,0,10,23.2,-13.2,4,4,0,0
14908,14765,282,279,4,4,4,4,5,3,0,0,38,18,4,4,0,0,0,1,0,0,0,0,143,3,0,0,2,0,20,0,0,72.8,100.8,-28,5,3,2,0
15931,16384,233,252,8,8,8,8,13,11,0,0,16,116,1,1,0,2,0,1,0,0,0,0,-453,-19,0,0,2,0,-100,0,-2,58.6,53.6,5,4,5,-1,0
16172,13473,304,245,5,2,2,5,3,2,0,1,36,13,1,4,1,1,1,0,0,1,0,0,2699,59,3,-3,1,0,23,-3,0,83,23.6,59.4,5,3,2,1
16977,16865,276,215,8,11,11,8,8,16,0,0,18,33,1,5,2,0,0,1,0,0,0,0,112,61,-3,3,-8,0,-15,-4,2,66,83.2,-17.2,5,4,1,0
15722,15818,255,267,7,6,6,7,8,11,0,1,19,18,3,7,1,0,1,0,0,1,0,0,-96,-12,1,-1,-3,0,1,-4,1,15.4,47,-31.6,4,4,0,0
16929,14925,249,230,9,5,5,9,12,8,0,0,18,158,4,3,1,0,1,0,0,0,0,0,2004,19,4,-4,4,0,-140,1,1,13.2,25.4,-12.2,3,5,-2,1
15724,13312,287,276,4,0,0,4,8,0,0,0,15,19,3,2,0,0,1,0,0,0,0,0,2412,11,4,-4,8,0,-4,1,0,54.6,28,26.6,5,5,0,1
15554,14956,217,227,7,7,7,7,13,16,0,0,163,51,3,2,0,0,1,0,0,0,0,0,598,-10,0,0,-3,0,112,1,0,88.4,15,73.4,5,3,2,1
18458,15382,276,231,12,8,8,12,14,8,0,0,15,36,4,1,1,0,1,0,0,0,0,0,3076,45,4,-4,6,0,-21,3,1,140.2,69.4,70.8,5,5,0,1
14882,14407,276,307,4,2,2,4,2,0,0,0,24,19,3,3,1,1,1,0,0,0,0,0,475,-31,2,-2,2,0,5,0,0,61.2,10.2,51,5,3,2,1
17201,13355,272,232,9,3,3,9,10,2,0,0,16,27,2,3,2,0,0,1,0,0,0,0,3846,40,6,-6,8,0,-11,-1,2,38.4,18.8,19.6,4,4,0,1
17253,14025,252,255,13,3,3,13,11,1,0,0,19,16,2,4,1,0,0,1,0,0,0,0,3228,-3,10,-10,10,0,3,-2,1,55,21,34,4,4,0,1
16585,13491,261,233,9,2,3,9,7,2,0,0,15,19,8,2,1,0,1,0,0,0,0,0,3094,28,7,-6,5,0,-4,6,1,16,119.2,-103.2,4,4,0,1
14300,15676,251,295,4,5,5,4,3,8,1,0,12,16,1,1,0,0,1,0,1,0,0,0,-1376,-44,-1,1,-5,0,-4,0,0,6.2,30.4,-24.2,2,4,-2,0
14527,14813,291,278,2,4,4,2,0,3,0,0,52,22,8,1,1,1,0,1,0,0,0,0,-286,13,-2,2,-3,0,30,7,0,48.8,98.8,-50,4,5,-1,0
15339,14571,277,263,5,4,4,5,7,6,1,0,14,17,3,0,1,0,1,0,1,0,0,0,768,14,1,-1,1,0,-3,3,1,22.2,63.8,-41.6,3,4,-1,0
14185,15760,290,299,2,3,3,2,2,3,0,0,108,68,3,3,1,2,1,0,0,0,0,0,-1575,-9,-1,1,-1,0,40,0,-1,39.2,18,21.2,5,5,0,0
17275,16049,277,251,11,5,5,11,7,7,0,0,35,10,4,1,1,2,1,0,0,0,0,0,1226,26,6,-6,0,0,25,3,-1,12.6,14.4,-1.8,3,3,0,1
16243,14806,253,267,9,4,4,9,13,2,0,0,16,13,1,3,1,2,1,0,0,0,0,0,1437,-14,5,-5,11,0,3,-2,-1,67.6,48.6,19,4,2,2,0
14423,16064,265,272,3,8,8,3,5,8,0,1,23,14,0,4,0,0,0,1,0,1,0,0,-1641,-7,-5,5,-3,0,9,-4,0,20,25.4,-5.4,4,3,1,0
12967,14216,242,253,1,4,4,1,1,1,0,1,36,14,5,3,0,0,0,1,0,1,0,0,-1249,-11,-3,3,0,0,22,2,0,63,25.6,37.4,4,4,0,0
16363,15833,266,261,7,5,5,7,7,9,0,0,18,16,3,0,2,2,1,0,0,0,0,0,530,5,2,-2,-2,0,2,3,0,27.6,36.2,-8.6,4,4,0,1
15925,16009,288,252,5,8,8,5,4,10,0,0,34,15,6,8,1,1,1,0,0,0,0,0,-84,36,-3,3,-6,0,19,-2,0,60,17.2,42.8,5,2,3,1
17451,15074,265,265,12,5,5,12,16,3,1,0,18,105,3,5,1,0,0,1,1,0,0,0,2377,0,7,-7,13,0,-87,-2,1,99.4,53.8,45.6,5,5,0,1
17797,18259,245,250,12,9,9,12,18,17,0,0,24,41,3,6,0,1,1,0,0,0,0,0,-462,-5,3,-3,1,0,-17,-3,-1,93.8,125.8,-32,4,5,-1,0
14184,15684,261,268,2,6,6,2,3,10,0,1,12,18,0,3,1,0,0,1,0,1,0,0,-1500,-7,-4,4,-7,0,-6,-3,1,12.8,69.6,-56.8,4,5,-1,0
16700,14888,265,247,8,6,6,8,8,3,0,0,17,21,2,6,2,0,1,0,0,0,0,0,1812,18,2,-2,5,0,-4,-4,2,20.6,51.6,-31,4,3,1,1
15310,12150,288,230,4,0,0,4,5,0,0,0,14,24,5,5,2,0,1,0,0,0,0,0,3160,58,4,-4,5,0,-10,0,2,43,66,-23,2,4,-2,0
14288,14192,294,300,1,1,1,1,1,1,1,0,18,14,3,3,1,1,1,0,1,0,0,0,96,-6,0,0,0,0,4,0,0,23.8,8.8,15,3,4,-1,0
13792,17740,252,273,3,12,12,3,2,13,0,0,17,28,2,5,0,0,0,1,0,0,0,0,-3948,-21,-9,9,-11,0,-11,-3,0,73.8,111.6,-37.8,4,5,-1,0
15760,16205,275,301,6,5,6,6,15,6,0,0,36,16,3,3,0,1,1,0,0,0,0,0,-445,-26,1,0,9,0,20,0,-1,73.2,24.8,48.4,4,4,0,0
15739,14595,255,205,6,7,7,6,7,12,0,0,15,16,5,1,2,0,0,1,0,0,0,0,1144,50,-1,1,-5,0,-1,4,2,19.2,7.6,11.6,2,3,-1,0
14836,15259,279,274,4,6,6,4,3,4,0,0,13,17,6,0,1,0,0,1,0,0,0,0,-423,5,-2,2,-1,0,-4,6,1,98,30,68,4,4,0,1
15188,13790,253,252,7,2,3,7,5,1,0,0,53,14,2,2,1,2,1,0,0,0,0,0,1398,1,5,-4,4,0,39,0,-1,33.2,9,24.2,5,3,2,1
14627,14282,292,291,3,2,2,3,2,2,0,0,11,17,3,4,0,0,0,1,0,0,0,0,345,1,1,-1,0,0,-6,-1,0,18.6,16.2,2.4,3,4,-1,0
14077,15421,211,245,5,7,7,5,3,10,0,0,22,18,0,2,2,2,1,0,0,0,0,0,-1344,-34,-2,2,-7,0,4,-2,0,6.6,40.2,-33.6,1,4,-3,0
14143,14682,260,247,3,5,5,3,4,5,0,0,16,19,3,2,0,1,0,1,0,0,0,0,-539,13,-2,2,-1,0,-3,1,-1,13.6,69.6,-56,3,4,-1,0
16052,15046,245,243,8,6,6,9,9,5,1,0,16,14,3,3,4,2,0,1,1,0,0,0,1006,2,2,-3,4,0,2,0,2,73.6,28.2,45.4,3,5,-2,1
14156,14449,265,268,2,3,3,2,2,5,0,0,41,17,1,6,2,1,1,0,0,0,0,0,-293,-3,-1,1,-3,0,24,-5,1,121.6,71,50.6,2,4,-2,0
14940,17023,272,267,4,10,10,4,6,7,0,0,14,111,6,4,1,2,0,1,0,0,0,0,-2083,5,-6,6,-1,0,-97,2,-1,8,67,-59,1,5,-4,0
13224,16037,237,264,2,7,7,2,4,6,0,0,15,17,0,1,0,1,1,0,0,0,0,0,-2813,-27,-5,5,-2,0,-2,-1,-1,45.2,14,31.2,5,3,2,0
16903,14483,261,239,11,4,4,11,12,4,0,0,31,14,1,4,0,0,1,0,0,0,0,0,2420,22,7,-7,8,0,17,-3,0,29.2,29.4,-0.2,4,4,0,0
13699,14882,315,313,0,2,2,0,0,3,0,1,15,32,2,1,1,1,0,1,0,1,0,0,-1183,2,-2,2,-3,0,-17,1,0,16.4,51.6,-35.2,4,4,0,0
16098,16006,277,249,6,7,7,6,6,11,1,0,17,34,3,4,2,0,0,1,1,0,0,0,92,28,-1,1,-5,0,-17,-1,2,22,63.8,-41.8,4,5,-1,0
14399,14339,264,269,3,2,2,3,4,3,0,0,20,39,5,3,1,2,1,0,0,0,0,0,60,-5,1,-1,1,0,-19,2,-1,37.8,43.8,-6,4,4,0,1
2515,2536,0,1,0,0,0,0,0,0,0,0,2,1,0,0,0,0,0,0,0,0,0,0,-21,-1,0,0,0,0,1,0,0,13.6,14,-0.4,3,4,-1,1
14432,14872,291,280,3,4,4,3,2,5,0,0,18,18,2,7,0,0,0,1,0,0,0,0,-440,11,-1,1,-3,0,0,-5,0,7.2,15.6,-8.4,1,4,-3,1
16402,14662,286,260,8,4,4,8,9,4,1,0,19,36,6,5,0,0,1,0,1,0,0,0,1740,26,4,-4,5,0,-17,1,0,64.6,13.8,50.8,4,5,-1,1
18318,15112,264,236,13,4,4,13,13,4,0,0,21,24,7,4,1,0,1,0,0,0,0,0,3206,28,9,-9,9,0,-3,3,1,17.2,33.4,-16.2,3,4,-1,1
15358,15728,269,288,5,5,5,5,8,9,0,1,19,16,1,0,0,1,0,1,0,1,0,0,-370,-19,0,0,-1,0,3,1,-1,59.4,76.2,-16.8,3,5,-2,1
15844,13776,284,256,6,3,3,6,4,4,0,0,15,16,5,3,1,0,1,0,0,0,0,0,2068,28,3,-3,0,0,-1,2,1,13,7.8,5.2,4,3,1,1
13941,16679,237,306,2,8,8,2,3,4,0,1,17,15,1,2,1,0,0,1,0,1,0,0,-2738,-69,-6,6,-1,0,2,-1,1,9,29.6,-20.6,2,3,-1,0
15071,14002,302,280,4,2,2,4,2,0,0,0,13,13,2,5,1,1,1,0,0,0,0,0,1069,22,2,-2,2,0,0,-3,0,51,24,27,5,4,1,0
14743,16156,257,288,4,6,6,4,5,13,0,1,125,171,7,5,0,0,1,0,0,1,0,0,-1413,-31,-2,2,-8,0,-46,2,0,20.4,28.4,-8,5,3,2,0
14893,15600,268,257,5,7,8,5,2,7,0,1,22,18,2,4,0,0,1,0,0,1,0,0,-707,11,-2,3,-5,0,4,-2,0,14.6,39.8,-25.2,4,4,0,0
13968,16837,246,280,2,7,7,2,3,8,0,0,35,102,4,4,0,3,0,1,0,0,0,0,-2869,-34,-5,5,-5,0,-67,0,-3,63,11.6,51.4,3,3,0,0
14068,13410,255,280,3,0,0,3,3,0,0,0,35,17,3,7,0,0,1,0,0,0,0,0,658,-25,3,-3,3,0,18,-4,0,38.4,11.6,26.8,4,3,1,0
14258,14826,258,268,3,5,5,3,2,4,0,0,28,14,3,1,0,0,0,1,0,0,0,0,-568,-10,-2,2,-2,0,14,2,0,32.4,12.8,19.6,3,3,0,0
16138,14094,307,280,5,2,3,5,3,2,0,0,123,15,3,3,2,0,0,1,0,0,0,0,2044,27,3,-2,1,0,108,0,2,43.4,6.6,36.8,5,2,3,1
16599,14332,281,266,7,3,3,7,9,4,1,0,11,15,3,1,0,2,1,0,1,0,0,0,2267,15,4,-4,5,0,-4,2,-2,65.2,6.8,58.4,5,3,2,1
14821,13496,280,256,4,2,2,4,1,4,0,1,20,15,2,7,0,0,1,0,0,1,0,0,1325,24,2,-2,-3,0,5,-5,0,80.8,11.4,69.4,3,2,1,1
15646,15258,289,268,5,6,6,5,7,7,0,0,15,23,3,2,0,0,0,1,0,0,0,0,388,21,-1,1,0,0,-8,1,0,17.2,53.8,-36.6,4,3,1,1
14088,16630,235,267,3,9,9,3,5,6,0,0,19,21,3,1,0,3,0,1,0,0,0,0,-2542,-32,-6,6,-1,0,-2,2,-3,25.4,9.8,15.6,4,2,2,0
14171,16959,234,280,5,9,9,5,5,10,0,1,17,12,0,2,0,0,0,1,0,1,0,0,-2788,-46,-4,4,-5,0,5,-2,0,35.2,7.4,27.8,4,1,3,0
15900,16759,239,248,9,10,10,9,7,10,0,0,14,19,3,5,1,0,0,1,0,0,0,0,-859,-9,-1,1,-3,0,-5,-2,1,21.4,21.6,-0.2,4,5,-1,1
15525,16117,260,257,6,7,7,6,6,5,0,0,20,30,2,4,0,1,0,1,0,0,0,0,-592,3,-1,1,1,0,-10,-2,-1,15,79.6,-64.6,3,4,-1,0
13925,15797,220,258,5,7,7,6,5,6,0,0,130,16,2,5,0,2,1,0,0,0,0,0,-1872,-38,-2,1,-1,0,114,-3,-2,73.4,12,61.4,3,1,2,0
14325,13358,274,250,3,2,2,3,4,2,0,0,19,13,3,4,2,0,1,0,0,0,0,0,967,24,1,-1,2,0,6,-1,2,9.4,18.8,-9.4,3,3,0,0
14140,13858,264,277,3,2,2,3,3,1,0,1,15,18,4,2,0,1,1,0,0,1,0,0,282,-13,1,-1,2,0,-3,2,-1,107.4,30,77.4,4,5,-1,0
16155,15244,264,245,8,6,6,8,5,4,0,0,112,25,3,1,0,1,1,0,0,0,0,0,911,19,2,-2,1,0,87,2,-1,38,25,13,3,5,-2,0
15605,15184,284,287,5,4,4,5,10,4,0,0,16,19,4,2,0,1,1,0,0,0,0,0,421,-3,1,-1,6,0,-3,2,-1,108,6.4,101.6,3,1,2,0
16024,15219,270,278,7,4,4,7,10,4,0,0,38,15,1,4,0,0,1,0,0,0,0,0,805,-8,3,-3,6,0,23,-3,0,47.2,21.6,25.6,3,5,-2,1
16370,14379,261,270,9,3,3,9,6,3,1,0,13,10,3,2,1,3,1,0,1,0,0,0,1991,-9,6,-6,3,0,3,1,-2,199.2,20.4,178.8,5,4,1,1
17471,12982,269,227,10,2,2,10,9,1,0,1,15,11,2,1,1,1,1,0,0,1,0,0,4489,42,8,-8,8,0,4,1,0,16.8,9.4,7.4,4,2,2,1
15802,15266,284,255,6,6,6,6,4,6,0,0,19,44,5,3,1,2,0,1,0,0,0,0,536,29,0,0,-2,0,-25,2,-1,33.4,34.2,-0.8,4,4,0,1
14596,13979,260,288,4,1,1,4,5,1,0,1,14,13,2,2,0,0,1,0,0,1,0,0,617,-28,3,-3,4,0,1,0,0,24.8,28,-3.2,5,4,1,1
15960,14121,262,271,8,2,2,9,8,2,0,0,17,19,3,4,0,0,1,0,0,0,0,0,1839,-9,6,-7,6,0,-2,-1,0,61.2,102.6,-41.4,5,4,1,1
14670,16593,254,258,4,7,7,4,4,11,0,0,15,15,1,4,0,2,0,1,0,0,0,0,-1923,-4,-3,3,-7,0,0,-3,-2,15.2,19.8,-4.6,3,5,-2,0
16613,15230,264,280,8,4,4,8,8,6,0,0,23,108,1,2,1,0,1,0,0,0,0,0,1383,-16,4,-4,2,0,-85,-1,1,7.4,56,-48.6,2,5,-3,0
12970,16206,208,228,3,9,9,4,2,8,0,0,18,18,3,3,0,0,0,1,0,0,0,0,-3236,-20,-6,5,-6,0,0,0,0,24.8,11.8,13,4,3,1,0
16172,15009,237,269,11,3,3,11,12,5,0,0,25,116,2,3,1,1,1,0,0,0,0,0,1163,-32,8,-8,7,0,-91,-1,0,85.6,94,-8.4,5,5,0,1
17205,15911,277,251,8,6,6,8,8,11,0,0,30,16,4,6,1,1,1,0,0,0,0,0,1294,26,2,-2,-3,0,14,-2,0,23.8,11.6,12.2,4,2,2,1
14920,14438,269,259,5,4,4,5,6,2,0,1,15,16,4,2,1,0,0,1,0,1,0,0,482,10,1,-1,4,0,-1,2,1,18.4,8,10.4,4,3,1,1
15353,14422,244,257,7,4,4,7,8,4,1,0,21,16,1,4,0,0,0,1,1,0,0,0,931,-13,3,-3,4,0,5,-3,0,27.2,13.6,13.6,5,2,3,0
14454,16766,236,269,4,9,9,4,6,10,0,1,17,20,1,4,0,0,0,1,0,1,0,0,-2312,-33,-5,5,-4,0,-3,-3,0,18.6,22.2,-3.6,3,5,-2,0
14518,15417,255,240,4,7,8,4,4,5,0,1,15,16,1,0,0,2,0,1,0,1,0,0,-899,15,-3,4,-1,0,-1,1,-2,8,24.6,-16.6,3,5,-2,0
15695,15690,270,255,5,7,7,5,7,12,0,0,158,40,4,3,2,1,0,1,0,0,0,0,5,15,-2,2,-5,0,118,1,1,37.4,20.4,17,3,4,-1,1
14308,14318,212,230,6,5,5,6,5,4,0,0,17,13,0,0,0,0,1,0,0,0,0,0,-10,-18,1,-1,1,0,4,0,0,18.6,25.2,-6.6,5,4,1,0
15665,14787,280,301,4,3,3,4,5,4,0,1,15,19,5,1,2,1,1,0,0,1,0,0,878,-21,1,-1,1,0,-4,4,1,33.8,15.8,18,4,4,0,0
14335,14168,258,235,3,5,5,3,2,2,0,0,18,17,5,3,2,0,1,0,0,0,0,0,167,23,-2,2,0,0,1,2,2,20.8,30.4,-9.6,5,4,1,1
13995,15255,251,275,3,4,4,3,5,6,0,0,15,19,3,5,0,3,1,0,0,0,0,0,-1260,-24,-1,1,-1,0,-4,-2,-3,19,45.2,-26.2,4,4,0,1
14384,14485,255,256,5,5,5,5,3,2,1,0,15,11,0,6,0,1,1,0,1,0,0,0,-101,-1,0,0,1,0,4,-6,-1,38.2,2.2,36,3,0,3,1
14491,17211,262,289,4,9,10,4,4,7,0,1,16,13,1,3,0,2,1,0,0,1,0,0,-2720,-27,-5,6,-3,0,3,-2,-2,82.8,18.4,64.4,4,4,0,0
15976,14401,264,240,7,4,4,7,7,5,0,0,14,15,4,2,0,2,1,0,0,0,0,0,1575,24,3,-3,2,0,-1,2,-2,70.4,79,-8.6,3,3,0,1
16603,14299,273,248,10,4,4,10,7,6,0,1,17,14,2,4,0,0,1,0,0,1,0,0,2304,25,6,-6,1,0,3,-2,0,15.2,11.4,3.8,2,2,0,0
15464,15523,277,280,5,4,4,5,6,7,0,0,14,111,4,2,0,3,1,0,0,0,0,0,-59,-3,1,-1,-1,0,-97,2,-3,7.4,22.2,-14.8,4,2,2,1
14014,17393,223,242,4,12,12,4,4,13,0,1,14,15,1,3,1,1,0,1,0,1,0,0,-3379,-19,-8,8,-9,0,-1,-2,0,33,143,-110,5,4,1,1
15628,15858,288,281,4,6,6,4,4,8,1,0,13,20,3,3,0,1,1,0,1,0,0,0,-230,7,-2,2,-4,0,-7,0,-1,8.4,29.6,-21.2,3,4,-1,0
16135,14186,286,246,6,3,3,6,10,5,0,0,109,20,2,0,1,0,0,1,0,0,0,0,1949,40,3,-3,5,0,89,2,1,16.2,14.6,1.6,3,5,-2,0
15465,17340,256,246,6,10,10,6,10,13,0,0,11,36,4,2,0,1,0,1,0,0,0,0,-1875,10,-4,4,-3,0,-25,2,-1,67,89.6,-22.6,4,5,-1,0
16523,13889,271,269,9,1,1,9,7,1,1,0,23,15,6,3,1,0,1,0,1,0,0,0,2634,2,8,-8,6,0,8,3,1,8,24.2,-16.2,2,3,-1,1
13184,18553,246,265,1,14,14,1,3,18,0,1,15,16,2,4,0,1,0,1,0,1,0,0,-5369,-19,-13,13,-15,0,-1,-2,-1,33.6,79.2,-45.6,3,4,-1,0
15044,14063,276,270,5,2,2,5,5,2,1,0,17,28,7,2,0,2,1,0,1,0,0,0,981,6,3,-3,3,0,-11,5,-2,58.6,16.2,42.4,5,4,1,1
14714,16469,283,289,4,8,8,4,4,7,0,1,24,16,2,4,0,0,0,1,0,1,0,0,-1755,-6,-4,4,-3,0,8,-2,0,36.6,65.8,-29.2,5,3,2,0
13728,14396,254,273,2,3,3,2,1,3,0,0,27,14,4,2,1,0,1,0,0,0,0,0,-668,-19,-1,1,-2,0,13,2,1,28,37.2,-9.2,5,5,0,1
15861,14326,243,256,7,4,4,7,4,3,0,0,24,16,2,2,4,1,0,1,0,0,0,0,1535,-13,3,-3,1,0,8,0,3,37,19.6,17.4,3,4,-1,1
14003,13033,276,257,2,0,0,2,1,0,0,0,13,26,2,3,1,1,1,0,0,0,0,0,970,19,2,-2,1,0,-13,-1,0,7,14.4,-7.4,2,4,-2,1
15255,14543,246,242,6,5,5,6,7,6,0,1,20,18,3,6,0,0,0,1,0,1,0,0,712,4,1,-1,1,0,2,-3,0,33.6,51.2,-17.6,4,3,1,1
14565,15736,249,268,3,6,6,3,4,5,0,0,34,21,4,0,1,1,0,1,0,0,0,0,-1171,-19,-3,3,-1,0,13,4,0,19.2,44.6,-25.4,4,4,0,1
15188,15169,280,273,4,4,4,4,5,5,0,0,19,11,3,3,1,0,1,0,0,0,0,0,19,7,0,0,0,0,8,0,1,17.6,20.4,-2.8,3,3,0,0
13117,16009,221,265,3,7,7,3,2,8,0,0,17,34,2,3,0,0,0,1,0,0,0,0,-2892,-44,-4,4,-6,0,-17,-1,0,95,16.4,78.6,5,5,0,1
15969,13977,237,269,9,2,2,9,14,2,0,0,9,18,4,2,0,1,1,0,0,0,0,0,1992,-32,7,-7,12,0,-9,2,-1,10,17.8,-7.8,2,3,-1,1
15502,16380,294,253,5,9,9,5,3,15,0,1,17,18,2,3,2,0,0,1,0,1,0,0,-878,41,-4,4,-12,0,-1,-1,2,11.4,68.2,-56.8,4,5,-1,0
2561,2530,2,0,0,0,0,0,0,0,0,0,11,2,0,0,0,0,0,0,0,0,0,0,31,2,0,0,0,0,9,0,0,11.2,88.2,-77,3,3,0,1
15547,15848,212,268,8,6,6,8,14,5,0,0,15,41,2,5,0,1,1,0,0,0,0,0,-301,-56,2,-2,9,0,-26,-3,-1,36,188.2,-152.2,5,5,0,0
14547,14853,264,260,4,5,5,4,4,7,0,0,16,36,3,2,1,1,0,1,0,0,0,0,-306,4,-1,1,-3,0,-20,1,0,20,19.6,0.4,5,4,1,0
14178,15816,258,258,3,7,7,3,4,7,0,0,18,22,3,2,0,2,0,1,0,0,0,0,-1638,0,-4,4,-3,0,-4,1,-2,24.6,83.8,-59.2,5,4,1,0
14762,16179,297,289,3,6,6,4,3,5,0,0,13,16,2,1,1,0,0,1,0,0,0,0,-1417,8,-3,2,-2,0,-3,1,1,6.2,67,-60.8,3,2,1,0
14748,13912,276,271,3,2,2,3,6,5,0,0,22,18,4,0,0,0,1,0,0,0,0,0,836,5,1,-1,1,0,4,4,0,47.6,55.8,-8.2,4,4,0,1
16161,14918,275,256,6,3,3,6,9,6,0,0,16,27,3,2,0,1,1,0,0,0,0,0,1243,19,3,-3,3,0,-11,1,-1,25,11.8,13.2,3,3,0,1
15982,16401,265,249,5,9,9,5,5,10,0,0,12,52,9,1,1,0,1,0,0,0,0,0,-419,16,-4,4,-5,0,-40,8,1,11.8,91.2,-79.4,3,5,-2,0
15148,15251,256,265,6,6,6,6,6,6,0,0,12,16,3,1,0,0,0,1,0,0,0,0,-103,-9,0,0,0,0,-4,2,0,95.8,12.2,83.6,5,3,2,0
13536,13165,255,257,3,1,1,3,1,0,0,0,13,14,2,2,0,1,0,1,0,0,0,0,371,-2,2,-2,1,0,-1,0,-1,29.8,37.6,-7.8,4,4,0,1
14086,15526,273,292,2,5,5,2,2,6,0,1,21,71,4,2,2,0,1,0,0,1,0,0,-1440,-19,-3,3,-4,0,-50,2,2,86.2,10.8,75.4,3,2,1,0
16124,13494,280,271,6,1,1,6,6,1,0,0,20,15,4,3,2,1,1,0,0,0,0,0,2630,9,5,-5,5,0,5,1,1,40.6,44.2,-3.6,3,3,0,0
15357,15395,279,254,3,6,6,3,4,9,0,0,18,14,3,4,1,0,0,1,0,0,0,0,-38,25,-3,3,-5,0,4,-1,1,108.8,29.8,79,3,3,0,1
15448,15002,280,284,5,3,3,5,4,2,0,0,19,29,2,4,1,1,1,0,0,0,0,0,446,-4,2,-2,2,0,-10,-2,0,94.6,152.4,-57.8,3,4,-1,0
13524,15234,273,294,1,4,4,1,1,9,0,1,15,18,6,1,0,0,0,1,0,1,0,0,-1710,-21,-3,3,-8,0,-3,5,0,33.4,29.2,4.2,4,4,0,0
16272,14192,253,224,9,5,5,9,15,6,0,0,19,17,2,2,1,1,0,1,0,0,0,0,2080,29,4,-4,9,0,2,0,0,66,111,-45,5,5,0,1
15541,15404,263,303,6,3,3,6,7,2,0,0,22,16,4,4,1,1,1,0,0,0,0,0,137,-40,3,-3,5,0,6,0,0,92.2,139.2,-47,4,5,-1,1
13828,18724,256,275,2,15,15,3,1,22,0,1,29,24,0,1,0,3,0,1,0,1,0,0,-4896,-19,-13,12,-21,0,5,-1,-3,25.2,90.8,-65.6,3,5,-2,0
13954,13920,271,269,2,2,2,2,4,4,0,1,16,42,3,1,0,1,1,0,0,1,0,0,34,2,0,0,0,0,-26,2,-1,23.6,28.8,-5.2,5,3,2,1
15508,14741,284,285,5,4,4,5,7,3,0,0,18,16,4,3,1,0,0,1,0,0,0,0,767,-1,1,-1,4,0,2,1,1,62.6,64.6,-2,4,4,0,1
17016,16097,292,273,8,7,7,8,12,6,0,0,27,19,3,10,0,0,1,0,0,0,0,0,919,19,1,-1,6,0,8,-7,0,19.2,14.2,5,3,2,1,1
14203,16672,283,282,2,6,6,2,1,12,0,1,37,13,1,2,0,2,0,1,0,1,0,0,-2469,1,-4,4,-11,0,24,-1,-2,15,96.8,-81.8,4,4,0,1
16615,15290,270,249,8,6,6,8,6,7,0,0,15,35,3,2,1,0,0,1,0,0,0,0,1325,21,2,-2,-1,0,-20,1,1,28.2,33.2,-5,4,5,-1,1
16434,13509,296,265,7,2,4,8,6,0,1,0,14,15,4,2,0,0,1,0,1,0,0,0,2925,31,5,-4,6,0,-1,2,0,14.4,70,-55.6,4,3,1,1
16085,16639,218,245,9,8,8,9,10,10,0,1,17,15,3,2,0,0,1,0,0,1,0,0,-554,-27,1,-1,0,0,2,1,0,74,54,20,4,3,1,0
14681,14934,259,273,4,5,5,4,9,9,0,0,36,18,3,3,0,0,0,1,0,0,0,0,-253,-14,-1,1,0,0,18,0,0,160.2,134,26.2,5,4,1,0
17359,14659,254,258,11,3,3,11,17,4,0,1,12,36,7,3,0,2,1,0,0,1,0,0,2700,-4,8,-8,13,0,-24,4,-2,106.8,59,47.8,5,5,0,1
15874,15738,261,254,6,7,7,6,7,8,1,0,16,30,3,3,2,1,0,1,1,0,0,0,136,7,-1,1,-1,0,-14,0,1,22.4,120.8,-98.4,4,5,-1,0
15199,15229,279,248,4,5,5,4,6,7,0,1,17,38,4,5,2,1,1,0,0,1,0,0,-30,31,-1,1,-1,0,-21,-1,1,26.4,79.8,-53.4,5,5,0,1
14298,14358,287,280,1,2,2,1,2,3,0,0,19,17,5,3,0,0,0,1,0,0,0,0,-60,7,-1,1,-1,0,2,2,0,207.2,85,122.2,5,4,1,1
15907,14687,291,258,6,4,4,6,8,7,1,0,30,12,6,1,3,0,1,0,1,0,0,0,1220,33,2,-2,1,0,18,5,3,55.6,30.8,24.8,5,3,2,1
16177,12865,258,246,8,1,2,8,13,0,0,0,17,35,2,6,1,1,1,0,0,0,0,0,3312,12,7,-6,13,0,-18,-4,0,53,23.2,29.8,4,4,0,1
15052,13671,313,269,3,1,1,4,1,1,1,0,15,17,6,4,1,0,1,0,1,0,0,0,1381,44,2,-3,0,0,-2,2,1,47.8,108.6,-60.8,4,4,0,1
15827,15291,228,268,9,6,6,9,7,2,0,0,14,19,8,3,0,0,0,1,0,0,0,0,536,-40,3,-3,5,0,-5,5,0,88.2,23.8,64.4,4,4,0,1
15177,14780,265,285,5,4,4,5,5,3,0,0,19,18,2,2,0,0,0,1,0,0,0,0,397,-20,1,-1,2,0,1,0,0,81.8,103.4,-21.6,4,5,-1,1
15025,16119,248,261,5,7,7,5,8,13,0,1,15,45,5,2,1,1,0,1,0,1,0,0,-1094,-13,-2,2,-5,0,-30,3,0,42.6,94.2,-51.6,5,5,0,0
14503,16334,253,267,4,8,8,4,4,4,0,0,17,215,6,2,0,0,0,1,0,0,0,0,-1831,-14,-4,4,0,0,-198,4,0,19,63.2,-44.2,5,4,1,0
14733,14190,249,230,5,4,4,6,4,7,0,0,17,26,2,9,1,0,0,1,0,0,0,0,543,19,1,-2,-3,0,-9,-7,1,70.4,56.8,13.6,4,4,0,1
16554,15084,278,255,7,5,5,7,11,5,1,0,19,17,4,2,1,0,1,0,1,0,0,0,1470,23,2,-2,6,0,2,2,1,73.6,64.4,9.2,4,3,1,1
16056,16173,232,230,10,8,8,10,10,9,0,0,31,17,0,5,1,2,0,1,0,0,0,0,-117,2,2,-2,1,0,14,-5,-1,42,9.4,32.6,5,3,2,0
16047,15358,257,260,8,5,5,8,11,3,0,0,17,41,5,3,0,3,1,0,0,0,0,0,689,-3,3,-3,8,0,-24,2,-3,20.4,102,-81.6,4,5,-1,1
18737,13702,287,237,12,3,3,12,16,4,0,0,39,20,6,1,5,0,0,1,0,0,0,0,5035,50,9,-9,12,0,19,5,5,51.2,36.6,14.6,5,2,3,1
15417,16577,289,266,5,7,7,5,1,6,0,1,13,119,5,2,1,1,1,0,0,1,0,0,-1160,23,-2,2,-5,0,-106,3,0,11.2,40.2,-29,3,5,-2,1
14036,15166,289,265,2,5,5,2,2,9,0,0,22,15,2,2,0,1,0,1,0,0,0,0,-1130,24,-3,3,-7,0,7,0,-1,49.8,44,5.8,5,5,0,1
13807,15831,292,289,1,6,6,1,2,4,0,1,16,17,2,2,0,2,0,1,0,1,0,0,-2024,3,-5,5,-2,0,-1,0,-2,47,38.2,8.8,5,4,1,0
15743,13567,234,241,7,3,3,7,12,6,0,0,24,32,5,4,2,0,1,0,0,0,0,0,2176,-7,4,-4,6,0,-8,1,2,89.6,17.2,72.4,4,3,1,1
15579,15859,273,281,6,6,6,6,7,7,0,0,17,34,5,2,0,1,0,1,0,0,0,0,-280,-8,0,0,0,0,-17,3,-1,13,43,-30,4,4,0,1
15255,14797,288,299,5,2,2,5,3,3,0,0,19,16,3,2,0,0,1,0,0,0,0,0,458,-11,3,-3,0,0,3,1,0,95.2,19.6,75.6,3,3,0,1
14752,15246,269,272,4,5,5,4,3,3,0,1,14,14,3,3,0,0,0,1,0,1,0,0,-494,-3,-1,1,0,0,0,0,0,51,14,37,4,3,1,0
15338,14090,282,258,4,3,3,4,3,1,0,0,18,12,0,3,3,0,1,0,0,0,0,0,1248,24,1,-1,2,0,6,-3,3,51.6,45.6,6,5,5,0,1
12938,14392,270,287,0,3,3,0,0,1,1,0,19,21,3,4,0,2,0,1,1,0,0,0,-1454,-17,-3,3,-1,0,-2,-1,-2,13.8,31.8,-18,4,5,-1,0
14539,14850,257,283,4,4,5,4,3,3,0,1,16,114,5,5,0,0,0,1,0,1,0,0,-311,-26,0,1,0,0,-98,0,0,67.4,36,31.4,4,4,0,1
16947,13180,248,213,9,3,3,9,9,2,0,0,16,13,3,1,2,0,1,0,0,0,0,0,3767,35,6,-6,7,0,3,2,2,38,14,24,4,4,0,1
16177,14079,246,277,7,2,2,7,10,4,0,0,30,23,4,4,2,2,0,1,0,0,0,0,2098,-31,5,-5,6,0,7,0,0,35.6,17,18.6,4,3,1,1
16517,16864,244,219,9,9,9,9,11,8,0,0,18,108,3,2,1,3,0,1,0,0,0,0,-347,25,0,0,3,0,-90,1,-2,27.8,44,-16.2,3,5,-2,0
15252,14347,251,243,7,5,5,7,9,1,1,0,14,15,2,4,0,1,1,0,1,0,0,0,905,8,2,-2,8,0,-1,-2,-1,71.8,19.2,52.6,5,3,2,1
15295,17421,268,271,6,10,10,6,3,8,1,0,21,14,1,3,1,3,0,1,1,0,0,0,-2126,-3,-4,4,-5,0,7,-2,-2,77.4,15,62.4,4,4,0,1
16253,15298,260,265,8,5,5,8,11,7,0,0,16,17,3,5,0,0,1,0,0,0,0,0,955,-5,3,-3,4,0,-1,-2,0,15.8,9.4,6.4,5,1,4,0
16821,13878,275,247,8,2,2,8,10,2,0,0,49,17,1,3,2,1,1,0,0,0,0,0,2943,28,6,-6,8,0,32,-2,1,57.6,49.4,8.2,4,4,0,1
14434,15233,275,261,3,6,6,3,4,10,0,0,19,21,8,6,0,1,0,1,0,0,0,0,-799,14,-3,3,-6,0,-2,2,-1,24.2,18.8,5.4,5,3,2,0
15702,14226,287,270,6,3,3,6,5,3,0,0,35,13,1,4,1,0,1,0,0,0,0,0,1476,17,3,-3,2,0,22,-3,1,65.8,41,24.8,5,5,0,1
14553,15323,241,261,4,5,5,4,5,6,0,1,28,14,3,4,1,2,1,0,0,1,0,0,-770,-20,-1,1,-1,0,14,-1,-1,53.8,15.8,38,5,3,2,0
15250,14426,290,282,4,2,2,4,5,2,0,0,15,116,2,4,0,0,0,1,0,0,0,0,824,8,2,-2,3,0,-101,-2,0,7.8,35.8,-28,3,4,-1,0
15788,15366,233,259,9,3,3,9,7,4,1,0,15,34,1,5,1,4,1,0,1,0,0,0,422,-26,6,-6,3,0,-19,-4,-3,11.8,112.2,-100.4,2,4,-2,1
15045,13680,239,254,6,3,3,6,8,1,0,0,17,12,2,0,1,0,0,1,0,0,0,0,1365,-15,3,-3,7,0,5,2,1,10.6,6.4,4.2,3,2,1,1
16222,15431,266,218,9,8,8,9,7,11,0,1,20,20,3,2,1,1,1,0,0,1,0,0,791,48,1,-1,-4,0,0,1,0,102,23.2,78.8,4,5,-1,0
15318,15940,234,261,6,7,7,6,4,10,0,0,34,20,2,3,1,0,0,1,0,0,0,0,-622,-27,-1,1,-6,0,14,-1,1,42.4,35.6,6.8,4,5,-1,0
14790,15963,241,262,5,7,7,5,5,6,0,0,38,14,2,5,0,1,1,0,0,0,0,0,-1173,-21,-2,2,-1,0,24,-3,-1,20.8,21.4,-0.6,4,5,-1,0
15394,16601,296,288,4,7,7,4,6,8,0,1,16,18,2,3,0,0,0,1,0,1,0,0,-1207,8,-3,3,-2,0,-2,-1,0,40,31.4,8.6,4,3,1,0
16963,14004,279,263,9,3,3,9,13,2,1,0,20,19,3,4,1,0,0,1,1,0,0,0,2959,16,6,-6,11,0,1,-1,1,35.6,107.6,-72,5,4,1,1
14064,14567,238,265,4,5,5,4,2,1,0,1,15,16,3,3,1,0,1,0,0,1,0,0,-503,-27,-1,1,1,0,-1,0,1,46,9.6,36.4,4,4,0,0
16891,14137,290,287,9,2,2,9,8,1,0,1,29,16,2,6,1,0,1,0,0,1,0,0,2754,3,7,-7,7,0,13,-4,1,18.6,23,-4.4,4,2,2,1
13921,13672,276,269,3,1,1,3,1,2,0,0,105,35,2,5,0,0,1,0,0,0,0,0,249,7,2,-2,-1,0,70,-3,0,38.4,8.8,29.6,5,3,2,0
14899,14411,211,225,7,5,5,7,4,4,0,1,17,14,0,3,1,0,1,0,0,1,0,0,488,-14,2,-2,0,0,3,-3,1,11.2,52,-40.8,3,3,0,0
13943,15044,244,267,3,6,6,3,4,6,1,0,19,14,5,3,2,0,0,1,1,0,0,0,-1101,-23,-3,3,-2,0,5,2,2,89.6,55.2,34.4,4,4,0,0
15061,17076,242,276,5,9,9,5,6,9,0,1,14,18,5,5,0,2,1,0,0,1,0,0,-2015,-34,-4,4,-3,0,-4,0,-2,13.2,21.8,-8.6,4,5,-1,0
14612,17666,218,294,6,9,9,6,10,9,0,1,14,16,5,4,0,3,0,1,0,1,0,0,-3054,-76,-3,3,1,0,-2,1,-3,35.4,18.2,17.2,3,3,0,0
17899,13482,246,248,13,2,2,13,16,3,0,0,18,16,3,0,1,0,1,0,0,0,0,0,4417,-2,11,-11,13,0,2,3,1,24.4,16.8,7.6,5,3,2,1
15547,14684,239,280,7,3,3,7,13,3,0,0,20,15,3,6,0,1,1,0,0,0,0,0,863,-41,4,-4,10,0,5,-3,-1,24.2,30.6,-6.4,4,4,0,0
14650,17574,243,245,4,12,12,4,5,16,0,0,19,16,2,4,1,0,1,0,0,0,0,0,-2924,-2,-8,8,-11,0,3,-2,1,15.6,17.4,-1.8,2,3,-1,1
14674,14130,275,263,3,3,3,3,4,3,0,0,10,16,4,2,2,0,0,1,0,0,0,0,544,12,0,0,1,0,-6,2,2,10.4,14.2,-3.8,5,4,1,1
13600,14105,266,254,1,3,3,1,1,4,0,1,16,17,1,6,2,0,0,1,0,1,0,0,-505,12,-2,2,-3,0,-1,-5,2,42.2,70,-27.8,4,3,1,1
15500,16556,283,256,5,10,10,5,3,11,0,0,22,20,6,4,2,0,0,1,0,0,0,0,-1056,27,-5,5,-8,0,2,2,2,85.6,24.8,60.8,4,4,0,0
12824,15894,231,240,2,8,8,2,1,7,1,0,19,153,3,2,0,0,1,0,1,0,0,0,-3070,-9,-6,6,-6,0,-134,1,0,53.4,38,15.4,4,4,0,0
14562,15807,271,283,4,6,6,4,8,4,1,0,18,23,4,4,0,1,0,1,1,0,0,0,-1245,-12,-2,2,4,0,-5,0,-1,51.6,30.4,21.2,4,4,0,0
3459,3027,30,8,0,0,0,0,0,0,0,0,2,1,0,0,0,0,0,0,0,0,0,0,432,22,0,0,0,0,1,0,0,7.2,44.8,-37.6,2,3,-1,1
17234,17343,226,256,12,11,11,12,14,10,0,1,200,17,3,2,1,0,0,1,0,1,0,0,-109,-30,1,-1,4,0,183,1,1,41.8,21.6,20.2,4,2,2,1
15070,13825,257,277,5,2,2,5,6,2,0,1,13,190,6,1,0,0,0,1,0,1,0,0,1245,-20,3,-3,4,0,-177,5,0,19.4,30,-10.6,3,3,0,0
16454,14597,254,241,9,4,4,9,7,6,1,0,14,17,3,3,1,0,1,0,1,0,0,0,1857,13,5,-5,1,0,-3,0,1,83.6,22.6,61,4,4,0,0
14781,15773,257,256,4,6,6,4,2,10,0,0,12,42,1,3,1,1,1,0,0,0,0,0,-992,1,-2,2,-8,0,-30,-2,0,22.2,20.2,2,4,5,-1,1
16285,15020,250,272,8,4,4,8,7,4,0,0,17,15,3,3,0,1,1,0,0,0,0,0,1265,-22,4,-4,3,0,2,0,-1,77,21.2,55.8,4,2,2,1
16456,17670,252,263,8,10,10,8,6,8,0,0,11,23,3,1,1,4,0,1,0,0,0,0,-1214,-11,-2,2,-2,0,-12,2,-3,16.2,32.8,-16.6,4,4,0,1
13968,16011,237,274,4,6,6,4,3,10,0,0,12,21,2,2,0,1,1,0,0,0,0,0,-2043,-37,-2,2,-7,0,-9,0,-1,50.6,53.6,-3,4,4,0,0
15180,14036,265,264,5,2,2,5,4,2,0,0,16,14,3,4,0,0,0,1,0,0,0,0,1144,1,3,-3,2,0,2,-1,0,23.6,11.6,12,3,4,-1,1
13787,14556,268,267,2,4,4,2,3,9,0,1,15,40,6,4,0,0,0,1,0,1,0,0,-769,1,-2,2,-6,0,-25,2,0,19,21.6,-2.6,5,5,0,1
16302,15750,269,258,7,6,6,7,13,8,0,0,17,14,3,4,0,0,1,0,0,0,0,0,552,11,1,-1,5,0,3,-1,0,18,20.4,-2.4,4,4,0,0
16121,16038,293,293,5,5,5,5,11,9,1,0,13,42,3,1,0,1,0,1,1,0,0,0,83,0,0,0,2,0,-29,2,-1,78.6,25.4,53.2,4,4,0,0
18227,13934,279,246,11,3,3,11,18,4,0,0,192,16,5,2,0,0,1,0,0,0,0,0,4293,33,8,-8,14,0,176,3,0,27,26.6,0.4,4,4,0,0
17999,16312,267,258,12,9,9,12,15,11,0,0,13,14,1,3,3,0,1,0,0,0,0,0,1687,9,3,-3,4,0,-1,-2,3,62.4,63,-0.6,3,3,0,1
13482,15253,264,291,2,4,4,2,4,5,0,0,11,37,4,2,0,0,0,1,0,0,0,0,-1771,-27,-2,2,-1,0,-26,2,0,36.4,25.8,10.6,4,5,-1,0
13018,15124,263,280,1,4,4,1,0,4,0,0,15,16,4,5,0,1,0,1,0,0,0,0,-2106,-17,-3,3,-4,0,-1,-1,-1,22.4,11,11.4,2,4,-2,0
15171,15800,263,273,6,7,8,6,2,6,0,1,36,14,2,3,1,0,1,0,0,1,0,0,-629,-10,-1,2,-4,0,22,-1,1,76.2,26.6,49.6,5,3,2,1
16155,16283,241,256,9,9,10,9,9,13,1,0,14,19,2,2,1,1,0,1,1,0,0,0,-128,-15,0,1,-4,0,-5,0,0,14.2,105.4,-91.2,3,3,0,0
17248,16070,228,255,11,7,8,11,10,7,0,0,14,17,1,1,1,2,0,1,0,0,0,0,1178,-27,4,-3,3,0,-3,0,-1,72.8,154.6,-81.8,4,5,-1,1
13398,16924,219,271,3,9,9,3,3,7,0,1,15,19,1,4,0,2,0,1,0,1,0,0,-3526,-52,-6,6,-4,0,-4,-3,-2,44.2,74,-29.8,4,4,0,1
15122,16035,282,296,4,6,6,4,6,6,0,1,12,17,3,3,0,1,0,1,0,1,0,0,-913,-14,-2,2,0,0,-5,0,-1,20,9,11,2,2,0,0
15132,16626,285,264,4,9,9,4,2,10,0,0,40,16,6,7,0,0,1,0,0,0,0,0,-1494,21,-5,5,-8,0,24,-1,0,67,95.4,-28.4,4,4,0,0
14349,14083,243,241,5,4,4,5,2,3,0,1,18,18,4,0,1,0,1,0,0,1,0,0,266,2,1,-1,-1,0,0,4,1,82,62,20,3,2,1,0
15329,15733,256,269,5,6,6,5,5,10,0,0,12,20,3,4,0,0,0,1,0,0,0,0,-404,-13,-1,1,-5,0,-8,-1,0,50.2,56.2,-6,4,3,1,0
17814,14197,285,210,10,5,6,10,7,5,0,0,15,16,4,0,1,0,1,0,0,0,0,0,3617,75,5,-4,2,0,-1,4,1,34,15.6,18.4,4,4,0,1
14294,14512,258,256,4,4,4,4,4,3,1,0,14,15,3,3,0,0,1,0,1,0,0,0,-218,2,0,0,1,0,-1,0,0,48.4,14,34.4,2,3,-1,1
16093,16595,282,262,6,10,10,6,6,7,1,0,16,71,3,3,0,0,0,1,1,0,0,0,-502,20,-4,4,-1,0,-55,0,0,13.4,43.2,-29.8,3,4,-1,0
15153,18868,250,254,7,14,14,8,1,14,0,0,15,13,1,5,2,0,0,1,0,0,0,0,-3715,-4,-7,6,-13,0,2,-4,2,25.2,71,-45.8,2,5,-3,0
14853,14094,287,280,3,2,2,3,5,1,1,0,18,25,7,2,1,0,0,1,1,0,0,0,759,7,1,-1,4,0,-7,5,1,75.2,86.6,-11.4,4,4,0,1
15462,16522,247,252,6,9,9,7,5,9,0,0,14,34,1,3,1,0,0,1,0,0,0,0,-1060,-5,-3,2,-4,0,-20,-2,1,100.2,45.2,55,5,4,1,0
13792,15981,244,269,3,8,8,3,4,10,0,1,18,26,1,5,0,0,1,0,0,1,0,0,-2189,-25,-5,5,-6,0,-8,-4,0,45.6,28,17.6,4,3,1,0
15338,16513,251,249,6,9,9,6,8,14,0,0,19,19,7,7,0,3,0,1,0,0,0,0,-1175,2,-3,3,-6,0,0,0,-3,149.4,20.4,129,5,5,0,1
18618,14880,212,219,15,5,5,15,21,6,0,0,18,20,6,2,1,0,1,0,0,0,0,0,3738,-7,10,-10,15,0,-2,4,1,74.6,12,62.6,4,3,1,1
14029,15126,252,291,3,3,3,4,3,4,0,0,15,17,1,4,0,0,1,0,0,0,0,0,-1097,-39,0,-1,-1,0,-2,-3,0,29.2,8.8,20.4,4,2,2,1
14145,16919,240,280,3,8,8,3,4,9,0,1,26,18,2,2,1,1,0,1,0,1,0,0,-2774,-40,-5,5,-5,0,8,0,0,76.6,18.8,57.8,2,3,-1,0
14134,16203,258,269,3,8,8,3,2,7,0,0,15,15,2,3,0,1,1,0,0,0,0,0,-2069,-11,-5,5,-5,0,0,-1,-1,20,41,-21,3,5,-2,0
14478,16639,242,299,4,6,6,4,6,7,0,1,17,36,3,3,0,2,1,0,0,1,0,0,-2161,-57,-2,2,-1,0,-19,0,-2,24.6,12.6,12,3,3,0,0
12896,14753,256,281,1,4,4,1,0,2,0,0,22,37,2,6,0,0,0,1,0,0,0,0,-1857,-25,-3,3,-2,0,-15,-4,0,16.4,15,1.4,3,5,-2,1
16106,15108,292,269,6,3,4,6,5,5,0,0,20,13,3,6,1,0,1,0,0,0,0,0,998,23,3,-2,0,0,7,-3,1,130.4,10.4,120,5,2,3,1
16319,14362,283,266,6,3,3,6,10,3,0,1,138,15,5,3,0,0,1,0,0,1,0,0,1957,17,3,-3,7,0,123,2,0,84,19.8,64.2,5,3,2,1
17095,14145,286,245,9,3,3,9,8,3,0,1,17,33,3,2,2,0,1,0,0,1,0,0,2950,41,6,-6,5,0,-16,1,2,14.6,84.6,-70,4,4,0,1
12858,16581,231,289,1,7,7,1,1,10,0,0,14,15,1,3,0,0,0,1,0,0,0,0,-3723,-58,-6,6,-9,0,-1,-2,0,103.8,29.4,74.4,5,4,1,0
15710,18110,264,272,5,11,11,5,6,15,0,0,25,18,4,4,0,1,0,1,0,0,0,0,-2400,-8,-6,6,-9,0,7,0,-1,29.6,79,-49.4,3,5,-2,0
16628,14469,296,266,8,2,2,8,5,3,1,0,15,14,4,1,2,2,1,0,1,0,0,0,2159,30,6,-6,2,0,1,3,0,8,174.4,-166.4,2,4,-2,1
14883,15174,259,265,5,5,5,5,3,5,0,1,23,16,2,5,0,1,1,0,0,1,0,0,-291,-6,0,0,-2,0,7,-3,-1,100.6,26.6,74,5,5,0,1
14478,14526,263,266,4,4,4,4,4,3,0,1,18,13,0,5,0,0,0,1,0,1,0,0,-48,-3,0,0,1,0,5,-5,0,7.4,13.4,-6,3,5,-2,1
14935,15824,304,254,3,9,9,3,0,14,0,0,15,15,2,3,2,0,0,1,0,0,0,0,-889,50,-6,6,-14,0,0,-1,2,84,13,71,4,3,1,0
14907,17766,226,289,6,9,9,6,7,12,0,1,14,17,3,5,1,1,0,1,0,1,0,0,-2859,-63,-3,3,-5,0,-3,-2,0,69.2,41,28.2,3,4,-1,0
15761,13482,276,242,5,2,2,5,6,3,0,0,15,51,5,1,1,0,1,0,0,0,0,0,2279,34,3,-3,3,0,-36,4,1,44,96,-52,3,4,-1,1
16213,15815,265,289,8,6,6,8,7,5,0,1,15,12,1,4,0,0,0,1,0,1,0,0,398,-24,2,-2,2,0,3,-3,0,24.6,40.2,-15.6,5,5,0,1
14166,15208,285,269,3,5,5,3,1,8,0,1,22,34,3,4,0,0,0,1,0,1,0,0,-1042,16,-2,2,-7,0,-12,-1,0,25.6,32,-6.4,4,5,-1,0
16598,15100,269,264,8,5,5,8,10,3,0,0,16,16,3,2,1,0,1,0,0,0,0,0,1498,5,3,-3,7,0,0,1,1,50.2,29.8,20.4,5,4,1,1
15921,16271,291,283,5,7,8,5,8,7,0,1,20,15,2,2,1,1,0,1,0,1,0,0,-350,8,-2,3,1,0,5,0,0,123.2,27.4,95.8,5,3,2,0
16106,13739,307,268,4,2,2,4,2,1,0,0,34,31,6,3,2,0,1,0,0,0,0,0,2367,39,2,-2,1,0,3,3,2,46.6,91.6,-45,4,4,0,1
14910,15403,239,234,5,8,8,5,6,10,0,1,16,22,2,5,1,0,0,1,0,1,0,0,-493,5,-3,3,-4,0,-6,-3,1,23.6,47.2,-23.6,3,5,-2,0
16884,12984,288,277,8,0,0,8,9,0,1,0,15,36,4,2,1,0,1,0,1,0,0,0,3900,11,8,-8,9,0,-21,2,1,31.4,8.6,22.8,5,4,1,1
17275,15180,292,287,9,4,5,9,16,3,0,0,15,68,4,1,0,2,1,0,0,0,0,0,2095,5,5,-4,13,0,-53,3,-2,31.4,19,12.4,3,5,-2,1
15724,15787,300,289,4,5,6,4,8,6,0,0,13,20,5,2,2,1,1,0,0,0,0,0,-63,11,-1,2,2,0,-7,3,1,64.2,117.8,-53.6,3,5,-2,1
14610,14037,254,241,3,4,4,3,3,5,0,0,21,17,2,4,0,0,1,0,0,0,0,0,573,13,-1,1,-2,0,4,-2,0,8.8,44.6,-35.8,2,2,0,1
13880,15245,286,286,1,5,5,1,1,4,0,1,13,17,2,2,0,1,0,1,0,1,0,0,-1365,0,-4,4,-3,0,-4,0,-1,49,23.8,25.2,4,3,1,1
18432,13874,286,259,11,2,3,11,12,2,0,0,17,13,3,2,2,0,1,0,0,0,0,0,4558,27,9,-8,10,0,4,1,2,41.4,14.6,26.8,5,4,1,1
16017,15286,282,260,7,6,6,7,7,7,0,1,18,118,4,2,1,1,1,0,0,1,0,0,731,22,1,-1,0,0,-100,2,0,13.8,96,-82.2,4,4,0,0
14350,14407,280,303,2,2,2,2,1,1,1,0,14,16,0,6,2,0,1,0,1,0,0,0,-57,-23,0,0,0,0,-2,-6,2,25.2,16.4,8.8,4,4,0,0
13353,15589,259,301,1,5,5,1,1,3,0,1,36,17,2,2,1,0,1,0,0,1,0,0,-2236,-42,-4,4,-2,0,19,0,1,98.4,43.4,55,3,3,0,0
15761,13697,278,282,6,1,1,6,5,0,0,0,18,13,0,3,1,0,1,0,0,0,0,0,2064,-4,5,-5,5,0,5,-3,1,62.4,19.6,42.8,4,3,1,0
15611,13868,308,276,5,1,1,5,3,1,1,0,20,14,3,4,0,0,1,0,1,0,0,0,1743,32,4,-4,2,0,6,-1,0,21,5,16,5,2,3,0
15772,12954,287,235,4,3,3,4,4,0,0,0,13,17,4,1,2,0,1,0,0,0,0,0,2818,52,1,-1,4,0,-4,3,2,74.8,78.6,-3.8,5,3,2,1
14725,15941,267,257,4,7,7,4,7,8,1,0,11,15,3,4,0,1,0,1,1,0,0,0,-1216,10,-3,3,-1,0,-4,-1,-1,141.6,16.8,124.8,3,4,-1,1
14012,16786,267,281,2,8,8,2,0,8,0,0,31,121,2,3,2,0,0,1,0,0,0,0,-2774,-14,-6,6,-8,0,-90,-1,2,25.4,40,-14.6,5,5,0,0
13782,14710,271,276,2,3,3,2,2,2,0,0,14,11,1,5,1,1,0,1,0,0,0,0,-928,-5,-1,1,0,0,3,-4,0,14.4,32,-17.6,4,5,-1,0
13715,17444,261,291,3,9,9,3,2,6,0,0,37,25,3,9,0,1,0,1,0,0,0,0,-3729,-30,-6,6,-4,0,12,-6,-1,16.4,63,-46.6,3,4,-1,0
14828,16616,252,244,4,9,9,4,4,12,0,0,12,20,6,1,1,0,0,1,0,0,0,0,-1788,8,-5,5,-8,0,-8,5,1,19.8,24.4,-4.6,4,4,0,1
15095,15630,249,215,7,10,11,7,4,8,0,0,13,38,1,1,1,1,0,1,0,0,0,0,-535,34,-3,4,-4,0,-25,0,0,132.4,7,125.4,3,2,1,0
14111,14959,261,286,3,4,4,3,3,6,1,0,21,23,4,5,1,0,1,0,1,0,0,0,-848,-25,-1,1,-3,0,-2,-1,1,46.8,90.4,-43.6,4,4,0,1
15247,15591,251,252,7,7,7,7,6,12,0,0,12,25,3,3,0,1,0,1,0,0,0,0,-344,-1,0,0,-6,0,-13,0,-1,17.6,79,-61.4,2,5,-3,1
15736,15148,221,257,9,5,5,9,5,4,0,1,17,16,1,3,0,2,0,1,0,1,0,0,588,-36,4,-4,1,0,1,-2,-2,11.8,36.4,-24.6,4,4,0,1
16585,14786,273,264,8,4,4,8,8,8,0,1,12,14,2,1,2,0,1,0,0,1,0,0,1799,9,4,-4,0,0,-2,1,2,5.8,26.2,-20.4,1,4,-3,1
16645,17888,209,249,10,12,12,10,17,14,0,0,23,18,3,5,0,1,1,0,0,0,0,0,-1243,-40,-2,2,3,0,5,-2,-1,13,12.4,0.6,4,3,1,1
14515,14869,284,251,3,5,5,3,2,8,0,1,106,20,4,1,0,0,1,0,0,1,0,0,-354,33,-2,2,-6,0,86,3,0,32.2,22,10.2,4,4,0,0
14105,14122,267,269,3,3,3,3,5,1,0,0,36,43,1,4,0,0,1,0,0,0,0,0,-17,-2,0,0,4,0,-7,-3,0,68.8,10.6,58.2,5,4,1,0
16105,12704,262,215,7,1,1,7,9,1,0,0,21,36,3,4,1,1,0,1,0,0,0,0,3401,47,6,-6,8,0,-15,-1,0,35.6,39.2,-3.6,4,2,2,1
16762,15916,237,240,10,6,6,10,11,11,0,1,18,22,7,4,1,1,0,1,0,1,0,0,846,-3,4,-4,0,0,-4,3,0,24.2,79.6,-55.4,4,4,0,0
15997,15735,278,252,7,7,7,7,5,10,0,0,14,22,4,2,0,1,1,0,0,0,0,0,262,26,0,0,-5,0,-8,2,-1,19.8,17.6,2.2,3,3,0,1
15337,15210,238,256,6,6,6,6,9,8,1,0,14,18,4,0,1,0,0,1,1,0,0,0,127,-18,0,0,1,0,-4,4,1,137.8,32.6,105.2,4,3,1,1
16193,15358,285,277,7,5,5,7,8,7,0,0,119,30,5,3,0,0,1,0,0,0,0,0,835,8,2,-2,1,0,89,2,0,38,12.6,25.4,4,3,1,0
15319,14896,256,273,6,4,4,6,10,6,1,0,36,220,3,3,0,0,1,0,1,0,0,0,423,-17,2,-2,4,0,-184,0,0,15,35.2,-20.2,2,5,-3,1
16735,13538,274,259,7,2,2,7,13,1,0,0,71,24,4,3,0,0,0,1,0,0,0,0,3197,15,5,-5,12,0,47,1,0,12.8,22.6,-9.8,2,3,-1,1
15615,15052,247,264,7,4,4,7,14,4,0,0,15,37,2,7,0,0,1,0,0,0,0,0,563,-17,3,-3,10,0,-22,-5,0,24.8,26.4,-1.6,3,3,0,0
15361,14497,257,280,5,2,2,5,8,2,0,1,13,17,2,3,1,2,1,0,0,1,0,0,864,-23,3,-3,6,0,-4,-1,-1,37.8,24.8,13,3,3,0,1
15246,14579,283,257,4,4,4,4,3,5,0,0,20,15,0,2,1,1,0,1,0,0,0,0,667,26,0,0,-2,0,5,-2,0,33.4,11,22.4,4,4,0,1
15875,16593,308,287,5,7,7,5,3,11,0,1,14,16,5,2,1,0,0,1,0,1,0,0,-718,21,-2,2,-8,0,-2,3,1,45.4,84.6,-39.2,5,5,0,1
14452,14542,245,278,4,3,3,4,4,1,0,0,34,22,5,1,0,0,0,1,0,0,0,0,-90,-33,1,-1,3,0,12,4,0,193.6,33.2,160.4,5,3,2,0
16920,14996,239,249,11,6,6,11,9,2,0,1,19,12,1,2,0,0,1,0,0,1,0,0,1924,-10,5,-5,7,0,7,-1,0,37.6,27,10.6,4,2,2,1
16003,16808,240,278,8,9,9,8,9,11,0,1,16,15,2,5,0,0,0,1,0,1,0,0,-805,-38,-1,1,-2,0,1,-3,0,30.4,32.2,-1.8,2,4,-2,0
15597,14597,253,265,6,5,5,6,6,3,0,0,16,17,3,3,1,1,0,1,0,0,0,0,1000,-12,1,-1,3,0,-1,0,0,37.6,56.6,-19,4,5,-1,1
13497,15839,250,279,2,6,6,2,1,6,0,0,15,34,3,3,0,1,0,1,0,0,0,0,-2342,-29,-4,4,-5,0,-19,0,-1,86,23.6,62.4,4,5,-1,0
13051,14741,222,229,2,6,6,2,3,6,0,0,22,180,3,3,1,0,0,1,0,0,0,0,-1690,-7,-4,4,-3,0,-158,0,1,114,45.8,68.2,5,4,1,0
13642,14986,236,283,3,3,3,3,5,3,0,1,13,14,2,2,0,3,1,0,0,1,0,0,-1344,-47,0,0,2,0,-1,0,-3,17.2,67.6,-50.4,4,3,1,1
14501,14803,270,271,4,4,4,4,2,1,0,1,30,16,1,3,1,1,0,1,0,1,0,0,-302,-1,0,0,1,0,14,-2,0,66.8,17.8,49,5,4,1,0
15022,14046,291,291,4,1,1,4,3,1,0,0,17,14,6,5,0,2,0,1,0,0,0,0,976,0,3,-3,2,0,3,1,-2,33.8,27.2,6.6,4,4,0,1
15769,14786,265,268,7,4,4,7,8,5,0,1,23,15,0,4,1,0,1,0,0,1,0,0,983,-3,3,-3,3,0,8,-4,1,82.4,36.6,45.8,4,4,0,1
15499,14291,285,286,5,3,3,5,4,3,0,1,15,19,2,1,0,0,0,1,0,1,0,0,1208,-1,2,-2,1,0,-4,1,0,30.6,87.6,-57,1,3,-2,0
15222,16446,248,264,5,8,8,5,11,12,0,1,12,15,2,2,0,0,0,1,0,1,0,0,-1224,-16,-3,3,-1,0,-3,0,0,30.8,88,-57.2,5,5,0,1
14067,14809,269,281,2,4,4,2,3,4,0,1,18,12,5,1,1,0,0,1,0,1,0,0,-742,-12,-2,2,-1,0,6,4,1,21.8,88.4,-66.6,3,1,2,0
16876,13836,275,231,10,4,4,10,5,2,0,0,14,11,2,1,2,0,1,0,0,0,0,0,3040,44,6,-6,3,0,3,1,2,27.2,7.2,20,3,2,1,1
15274,16046,279,278,4,6,6,4,4,11,0,0,13,61,2,3,0,1,0,1,0,0,0,0,-772,1,-2,2,-7,0,-48,-1,-1,23.4,223.8,-200.4,4,3,1,0
13941,15873,257,262,3,7,7,3,4,13,0,0,15,16,1,0,0,0,1,0,0,0,0,0,-1932,-5,-4,4,-9,0,-1,1,0,19.6,59.6,-40,4,4,0,0
15487,13711,288,266,4,2,2,4,5,3,0,1,12,17,2,1,1,0,0,1,0,1,0,0,1776,22,2,-2,2,0,-5,1,1,22,16.8,5.2,3,4,-1,1
15162,14709,263,257,5,5,6,5,6,2,0,0,15,16,2,1,0,1,0,1,0,0,0,0,453,6,0,1,4,0,-1,1,-1,33.6,41.4,-7.8,3,5,-2,1
14836,15625,231,263,6,7,7,6,5,4,0,0,106,20,3,2,0,2,0,1,0,0,0,0,-789,-32,-1,1,1,0,86,1,-2,33.2,50.6,-17.4,3,3,0,0
17293,14670,272,253,10,5,5,10,9,6,1,0,17,14,1,3,2,0,1,0,1,0,0,0,2623,19,5,-5,3,0,3,-2,2,45,18.8,26.2,4,3,1,1
14585,13716,296,291,2,1,1,2,3,0,1,0,17,13,1,4,1,0,1,0,1,0,0,0,869,5,1,-1,3,0,4,-3,1,10.6,28,-17.4,4,3,1,1
14471,16600,239,287,4,7,7,4,7,11,0,0,33,15,2,4,0,2,0,1,0,0,0,0,-2129,-48,-3,3,-4,0,18,-2,-2,41.4,36.6,4.8,4,4,0,0
16199,13432,246,226,9,3,3,9,11,2,1,0,16,16,2,4,1,0,1,0,1,0,0,0,2767,20,6,-6,9,0,0,-2,1,52.2,55.6,-3.4,3,3,0,1
16725,13502,281,244,10,1,1,10,10,1,1,0,15,17,1,4,1,1,1,0,1,0,0,0,3223,37,9,-9,9,0,-2,-3,0,21.2,21.6,-0.4,5,5,0,1
16862,14177,261,253,10,3,3,10,17,5,0,0,18,11,4,3,0,1,1,0,0,0,0,0,2685,8,7,-7,12,0,7,1,-1,14.4,70,-55.6,3,5,-2,1
13701,15152,256,256,1,6,6,1,2,6,0,1,30,17,4,3,0,1,0,1,0,1,0,0,-1451,0,-5,5,-4,0,13,1,-1,37.4,83,-45.6,5,4,1,1
14332,15934,279,277,2,6,6,2,2,7,1,0,17,15,4,5,0,1,1,0,1,0,0,0,-1602,2,-4,4,-5,0,2,-1,-1,19,31.8,-12.8,2,4,-2,0
14671,14120,245,232,4,5,5,4,6,5,0,0,14,12,3,2,0,0,0,1,0,0,0,0,551,13,-1,1,1,0,2,1,0,50.8,11,39.8,4,2,2,1
15542,15875,291,272,5,6,6,5,6,8,1,0,15,22,2,2,0,0,1,0,1,0,0,0,-333,19,-1,1,-2,0,-7,0,0,20.4,51,-30.6,4,5,-1,0
15271,14940,271,272,5,3,3,5,6,4,0,0,18,13,4,9,1,0,1,0,0,0,0,0,331,-1,2,-2,2,0,5,-5,1,79.6,10.4,69.2,5,4,1,0
14315,17068,257,258,4,10,10,5,1,12,0,0,18,23,0,6,0,0,1,0,0,0,0,0,-2753,-1,-6,5,-11,0,-5,-6,0,41,87.8,-46.8,5,2,3,0
15105,16905,208,269,7,9,9,7,8,11,0,0,15,17,1,4,0,0,1,0,0,0,0,0,-1800,-61,-2,2,-3,0,-2,-3,0,73.2,13,60.2,4,4,0,1
14930,14929,286,294,3,3,3,3,5,4,0,1,21,16,7,5,0,0,0,1,0,1,0,0,1,-8,0,0,1,0,5,2,0,164.8,57,107.8,3,5,-2,1
15087,15494,263,303,5,4,4,5,4,8,0,1,13,15,5,4,0,0,1,0,0,1,0,0,-407,-40,1,-1,-4,0,-2,1,0,20.6,66.2,-45.6,4,3,1,0
15245,14027,242,258,6,3,3,6,8,2,0,1,44,69,4,6,0,0,1,0,0,1,0,0,1218,-16,3,-3,6,0,-25,-2,0,71.8,10,61.8,4,3,1,1
16343,15869,272,233,8,7,7,8,7,12,0,0,20,104,5,2,0,0,0,1,0,0,0,0,474,39,1,-1,-5,0,-84,3,0,72.8,59,13.8,4,5,-1,0
12929,17525,268,289,0,10,10,0,0,14,1,0,49,19,3,0,1,1,0,1,1,0,0,0,-4596,-21,-10,10,-14,0,30,3,0,106.4,37.4,69,4,3,1,0
17545,13603,310,262,9,2,2,9,10,4,0,1,44,16,6,5,1,0,1,0,0,1,0,0,3942,48,7,-7,6,0,28,1,1,53.4,36,17.4,2,4,-2,1
15415,14182,274,276,5,2,2,5,5,2,0,0,13,15,2,4,1,1,0,1,0,0,0,0,1233,-2,3,-3,3,0,-2,-2,0,81.2,32,49.2,5,4,1,1
16317,15390,277,283,7,4,4,7,9,5,0,1,17,20,5,4,1,0,1,0,0,1,0,0,927,-6,3,-3,4,0,-3,1,1,113.6,53,60.6,5,4,1,0
15719,15003,270,255,6,4,4,6,9,3,0,0,14,19,5,2,1,2,1,0,0,0,0,0,716,15,2,-2,6,0,-5,3,-1,68.2,28.8,39.4,4,3,1,0
13589,16165,282,265,0,8,8,0,0,10,0,1,16,18,2,3,1,3,0,1,0,1,0,0,-2576,17,-8,8,-10,0,-2,-1,-2,24.4,99.8,-75.4,4,4,0,0
15235,15383,273,279,4,5,5,4,6,6,0,1,51,18,3,4,2,2,0,1,0,1,0,0,-148,-6,-1,1,0,0,33,-1,0,27,8.4,18.6,4,3,1,1
15189,15102,272,268,6,6,6,6,3,5,0,0,18,16,5,3,0,0,1,0,0,0,0,0,87,4,0,0,-2,0,2,2,0,45.2,72.8,-27.6,3,4,-1,0
16417,15323,291,262,5,5,5,5,5,5,0,0,16,18,4,0,1,2,1,0,0,0,0,0,1094,29,0,0,0,0,-2,4,-1,16,30.2,-14.2,3,4,-1,0
13631,14164,277,309,1,1,1,1,1,1,1,0,16,35,3,3,0,0,1,0,1,0,0,0,-533,-32,0,0,0,0,-19,0,0,10.4,70.6,-60.2,3,4,-1,0
15344,15751,273,258,6,6,6,6,3,6,0,1,18,18,5,3,1,1,0,1,0,1,0,0,-407,15,0,0,-3,0,0,2,0,20,23.2,-3.2,5,5,0,0
14498,14140,255,258,4,3,3,4,9,3,0,0,106,14,1,3,0,1,1,0,0,0,0,0,358,-3,1,-1,6,0,92,-2,-1,109.4,28.4,81,4,4,0,1
17272,15263,272,271,9,5,6,9,8,4,0,1,13,16,3,1,1,0,1,0,0,1,0,0,2009,1,4,-3,4,0,-3,2,1,14.4,33.4,-19,2,5,-3,0
14830,16053,264,301,4,6,6,4,4,4,0,1,12,15,3,0,1,0,0,1,0,1,0,0,-1223,-37,-2,2,0,0,-3,3,1,5.8,13.6,-7.8,3,3,0,0
15444,14567,227,244,8,4,4,8,10,6,0,1,52,13,2,4,0,0,1,0,0,1,0,0,877,-17,4,-4,4,0,39,-2,0,101.6,20.6,81,4,3,1,1
16614,15390,248,242,9,6,6,9,13,4,0,0,21,19,6,3,0,1,1,0,0,0,0,0,1224,6,3,-3,9,0,2,3,-1,139.8,70.6,69.2,5,3,2,1
15109,16312,257,275,5,7,7,5,8,12,0,1,14,16,1,4,0,1,0,1,0,1,0,0,-1203,-18,-2,2,-4,0,-2,-3,-1,11.6,18,-6.4,3,3,0,1
16966,14959,277,257,8,5,6,8,10,6,0,0,17,27,2,1,2,0,1,0,0,0,0,0,2007,20,3,-2,4,0,-10,1,2,17.2,28.6,-11.4,3,4,-1,1
16197,15828,260,245,7,6,6,7,6,9,0,0,16,19,5,3,2,1,1,0,0,0,0,0,369,15,1,-1,-3,0,-3,2,1,34.8,12.6,22.2,5,4,1,1
12581,18461,229,256,1,15,15,1,1,10,0,1,12,40,3,3,1,1,0,1,0,1,0,0,-5880,-27,-14,14,-9,0,-28,0,0,128.4,158,-29.6,5,4,1,0
15111,15522,261,290,6,5,5,6,3,5,1,0,37,16,1,2,0,1,0,1,1,0,0,0,-411,-29,1,-1,-2,0,21,-1,-1,54.4,31.8,22.6,3,4,-1,0
14942,14737,305,311,3,2,3,3,2,3,0,1,18,14,1,5,0,0,1,0,0,1,0,0,205,-6,1,0,-1,0,4,-4,0,76,52.2,23.8,3,5,-2,0
17615,19503,237,258,12,14,14,12,13,18,0,1,17,16,4,5,0,0,0,1,0,1,0,0,-1888,-21,-2,2,-5,0,1,-1,0,13.6,58.4,-44.8,5,4,1,1
14522,16595,269,288,3,8,8,3,1,8,0,1,17,26,2,2,1,1,1,0,0,1,0,0,-2073,-19,-5,5,-7,0,-9,0,0,46.4,55.2,-8.8,3,4,-1,0
13423,14666,257,271,2,3,3,2,2,4,0,1,50,17,3,1,0,1,0,1,0,1,0,0,-1243,-14,-1,1,-2,0,33,2,-1,68.4,60.2,8.2,3,4,-1,0
13193,15713,266,283,2,6,6,2,0,4,0,1,16,24,0,4,0,1,0,1,0,1,0,0,-2520,-17,-4,4,-4,0,-8,-4,-1,61.8,49.2,12.6,2,2,0,0
16542,13264,268,239,9,2,2,9,8,2,0,0,17,15,1,1,2,0,1,0,0,0,0,0,3278,29,7,-7,6,0,2,0,2,9.2,122.8,-113.6,3,4,-1,1
13335,14610,197,274,4,3,3,5,4,2,1,0,12,18,3,1,0,3,0,1,1,0,0,0,-1275,-77,1,-2,2,0,-6,2,-3,83.8,65.6,18.2,4,5,-1,0
16280,15456,273,280,6,6,6,6,11,6,0,0,21,96,4,5,1,0,1,0,0,0,0,0,824,-7,0,0,5,0,-75,-1,1,98.6,97.2,1.4,5,5,0,1
17627,16008,266,269,11,7,7,12,12,9,0,0,13,15,3,1,0,1,0,1,0,0,0,0,1619,-3,4,-5,3,0,-2,2,-1,63.6,40,23.6,4,3,1,1
14494,16945,269,290,3,9,9,5,4,14,0,1,14,32,4,3,0,0,0,1,0,1,0,0,-2451,-21,-6,4,-10,0,-18,1,0,20,86.4,-66.4,3,4,-1,0
15603,12696,278,231,5,1,1,5,10,1,0,1,17,17,3,3,0,0,0,1,0,1,0,0,2907,47,4,-4,9,0,0,0,0,22,65.8,-43.8,3,5,-2,0
15925,15003,273,265,7,5,5,7,8,3,1,0,18,16,3,6,1,0,1,0,1,0,0,0,922,8,2,-2,5,0,2,-3,1,173.2,67.8,105.4,4,4,0,1
14409,15711,231,269,5,6,6,5,4,4,0,0,22,17,2,4,0,1,0,1,0,0,0,0,-1302,-38,-1,1,0,0,5,-2,-1,45.2,30,15.2,3,5,-2,0
15217,14332,316,295,4,1,1,4,2,2,0,1,35,13,3,2,0,1,1,0,0,1,0,0,885,21,3,-3,0,0,22,1,-1,14.2,80,-65.8,5,4,1,1
14043,16768,250,263,3,10,10,3,4,12,0,1,15,89,3,7,0,2,0,1,0,1,0,0,-2725,-13,-7,7,-8,0,-74,-4,-2,106.2,87,19.2,4,4,0,0
14986,17652,215,271,6,10,10,6,10,11,0,0,16,18,4,3,0,2,0,1,0,0,0,0,-2666,-56,-4,4,-1,0,-2,1,-2,62.4,19.8,42.6,5,4,1,0
15584,15757,282,276,5,7,7,5,3,4,0,0,14,14,3,5,2,0,0,1,0,0,0,0,-173,6,-2,2,-1,0,0,-2,2,14,50.8,-36.8,3,4,-1,0
18294,13420,276,244,11,3,3,11,16,1,1,0,17,15,2,2,3,0,1,0,1,0,0,0,4874,32,8,-8,15,0,2,0,3,128,67.6,60.4,4,3,1,1
14161,14109,253,269,3,2,2,3,7,4,0,1,16,96,4,7,0,1,1,0,0,1,0,0,52,-16,1,-1,3,0,-80,-3,-1,54.8,75.4,-20.6,4,5,-1,0
14489,15890,253,280,4,6,6,4,5,5,0,0,11,20,5,1,0,1,1,0,0,0,0,0,-1401,-27,-2,2,0,0,-9,4,-1,18.2,99,-80.8,4,5,-1,0
14744,16829,253,257,4,9,9,4,3,11,0,0,14,20,3,1,1,2,1,0,0,0,0,0,-2085,-4,-5,5,-8,0,-6,2,-1,160.2,29.2,131,5,3,2,0
15478,14942,267,258,5,5,5,5,6,5,0,1,14,15,2,3,0,0,1,0,0,1,0,0,536,9,0,0,1,0,-1,-1,0,30,50.8,-20.8,5,4,1,1
2884,2515,0,0,1,0,0,1,2,0,0,0,2,2,0,0,0,0,1,0,0,0,0,0,369,0,1,-1,2,0,0,0,0,19.4,24.2,-4.8,5,4,1,0
16874,15578,273,260,10,6,6,10,13,5,0,1,13,26,5,2,0,0,1,0,0,1,0,0,1296,13,4,-4,8,0,-13,3,0,21,13,8,5,2,3,0
14604,16701,253,264,4,7,7,4,9,6,0,0,52,18,4,1,0,1,1,0,0,0,0,0,-2097,-11,-3,3,3,0,34,3,-1,13.2,19.6,-6.4,4,4,0,0
14682,14160,189,232,8,4,4,8,6,4,0,0,15,35,4,3,1,0,0,1,0,0,0,0,522,-43,4,-4,2,0,-20,1,1,29.6,68,-38.4,5,5,0,0
15395,15135,264,280,6,4,4,6,9,4,1,0,14,13,3,4,1,0,1,0,1,0,0,0,260,-16,2,-2,5,0,1,-1,1,75.6,64.4,11.2,4,5,-1,0
15539,14495,272,269,5,4,4,5,6,6,0,1,16,23,3,3,1,1,1,0,0,1,0,0,1044,3,1,-1,0,0,-7,0,0,25.8,27.8,-2,4,4,0,1
15623,14336,278,264,5,3,3,5,5,4,0,1,14,16,6,4,0,0,1,0,0,1,0,0,1287,14,2,-2,1,0,-2,2,0,73.4,41.6,31.8,4,2,2,0
14857,15609,250,261,4,6,6,4,5,4,0,0,21,17,2,5,0,1,0,1,0,0,0,0,-752,-11,-2,2,1,0,4,-3,-1,68.2,68.2,0,5,4,1,0
14467,15293,285,252,4,5,5,4,2,8,1,0,18,21,5,1,0,1,0,1,1,0,0,0,-826,33,-1,1,-6,0,-3,4,-1,69.8,47.4,22.4,4,5,-1,1
15021,14386,283,262,5,3,3,5,3,4,1,0,14,12,0,2,1,3,0,1,1,0,0,0,635,21,2,-2,-1,0,2,-2,-2,31.6,8.6,23,3,2,1,0
15542,13871,301,273,4,2,2,4,4,3,1,0,124,16,1,2,1,0,0,1,1,0,0,0,1671,28,2,-2,1,0,108,-1,1,36.4,11,25.4,5,3,2,1
15389,15841,241,223,6,8,8,6,12,14,0,0,37,19,2,3,1,0,0,1,0,0,0,0,-452,18,-2,2,-2,0,18,-1,1,24.4,48.8,-24.4,5,5,0,0
15486,14256,248,254,7,3,3,7,8,3,0,0,16,34,4,3,0,0,1,0,0,0,0,0,1230,-6,4,-4,5,0,-18,1,0,42.2,82.2,-40,4,5,-1,1
16226,14127,273,251,8,4,4,9,6,3,0,0,14,17,4,5,1,0,0,1,0,0,0,0,2099,22,4,-5,3,0,-3,-1,1,42.6,26.6,16,5,5,0,0
13693,14697,231,207,3,7,7,3,2,6,0,0,24,16,3,4,0,1,0,1,0,0,0,0,-1004,24,-4,4,-4,0,8,-1,-1,41.6,88.8,-47.2,5,5,0,1
15832,15163,272,268,6,5,5,7,4,8,0,1,20,16,3,4,2,0,0,1,0,1,0,0,669,4,1,-2,-4,0,4,-1,2,37.2,21.2,16,4,4,0,0
15385,15826,251,264,6,7,7,6,5,6,0,1,12,12,2,3,0,0,0,1,0,1,0,0,-441,-13,-1,1,-1,0,0,-1,0,19.6,25.2,-5.6,5,3,2,0
15017,14276,270,244,5,5,5,5,5,3,0,0,17,22,3,6,1,0,1,0,0,0,0,0,741,26,0,0,2,0,-5,-3,1,9.4,78.2,-68.8,3,3,0,1
15149,13802,247,293,6,2,2,6,7,0,0,0,41,16,1,5,0,0,0,1,0,0,0,0,1347,-46,4,-4,7,0,25,-4,0,16.6,36,-19.4,5,5,0,1
16144,14469,259,252,6,5,5,6,10,3,0,1,38,17,3,2,2,2,0,1,0,1,0,0,1675,7,1,-1,7,0,21,1,0,23,156.8,-133.8,4,5,-1,0
15676,15450,313,287,4,5,5,5,5,6,1,0,16,16,1,1,0,0,0,1,1,0,0,0,226,26,-1,0,-1,0,0,0,0,88.2,89,-0.8,5,4,1,1
15947,12771,311,259,5,0,0,5,8,0,0,0,38,47,4,2,1,0,1,0,0,0,0,0,3176,52,5,-5,8,0,-9,2,1,27.6,96.8,-69.2,5,4,1,1
14974,15427,283,258,3,6,6,3,2,7,0,0,13,20,3,1,2,2,0,1,0,0,0,0,-453,25,-3,3,-5,0,-7,2,0,36,67.4,-31.4,5,4,1,1
16009,14332,255,255,9,3,3,9,8,3,0,0,18,15,3,3,0,0,1,0,0,0,0,0,1677,0,6,-6,5,0,3,0,0,26.2,23.2,3,4,4,0,1
15310,18308,256,251,5,13,13,5,7,15,0,1,178,17,3,3,1,1,0,1,0,1,0,0,-2998,5,-8,8,-8,0,161,0,0,21,79.4,-58.4,2,5,-3,0
16120,13584,272,274,8,1,1,8,14,2,0,0,17,48,2,1,0,0,1,0,0,0,0,0,2536,-2,7,-7,12,0,-31,1,0,183.2,11.6,171.6,5,4,1,1
15767,14996,273,273,6,5,5,7,8,5,0,0,15,17,2,4,0,0,0,1,0,0,0,0,771,0,1,-2,3,0,-2,-2,0,111.2,63,48.2,5,2,3,1
16420,15664,244,254,9,7,7,9,12,6,0,1,17,109,0,3,0,1,0,1,0,1,0,0,756,-10,2,-2,6,0,-92,-3,-1,13.2,33,-19.8,2,4,-2,1
14121,14821,231,257,4,5,5,4,5,7,0,1,11,17,5,2,0,1,1,0,0,1,0,0,-700,-26,-1,1,-2,0,-6,3,-1,86.4,18.2,68.2,5,3,2,1
14143,15294,282,269,2,5,5,2,4,8,1,0,15,15,3,3,0,2,0,1,1,0,0,0,-1151,13,-3,3,-4,0,0,0,-2,15.6,28,-12.4,2,4,-2,1
13947,13669,268,303,2,0,0,2,2,0,0,0,17,16,0,2,0,1,1,0,0,0,0,0,278,-35,2,-2,2,0,1,-2,-1,108,16.4,91.6,4,4,0,1
16678,15292,247,266,11,5,5,11,8,3,0,0,18,19,2,2,1,0,1,0,0,0,0,0,1386,-19,6,-6,5,0,-1,0,1,77.2,8.2,69,4,3,1,1
15813,15199,221,256,9,6,6,9,7,5,0,0,17,12,4,0,0,0,1,0,0,0,0,0,614,-35,3,-3,2,0,5,4,0,69.6,14,55.6,4,2,2,0
15940,15895,234,232,9,8,8,9,10,11,0,0,22,16,0,3,0,1,1,0,0,0,0,0,45,2,1,-1,-1,0,6,-3,-1,28,30.2,-2.2,4,4,0,1
17195,15372,259,266,11,4,4,11,11,7,1,0,24,16,0,2,0,1,0,1,1,0,0,0,1823,-7,7,-7,4,0,8,-2,-1,90.2,93.4,-3.2,4,4,0,1
13542,16014,251,279,2,6,6,2,4,8,0,0,18,37,2,6,0,1,0,1,0,0,0,0,-2472,-28,-4,4,-4,0,-19,-4,-1,35.4,15.6,19.8,4,3,1,0
14247,17066,252,291,4,7,7,4,4,11,1,0,16,19,3,5,0,2,0,1,1,0,0,0,-2819,-39,-3,3,-7,0,-3,-2,-2,20,106.2,-86.2,4,4,0,0
13994,16402,276,277,3,7,7,3,1,6,0,0,17,16,3,3,1,1,0,1,0,0,0,0,-2408,-1,-4,4,-5,0,1,0,0,6,121.8,-115.8,2,3,-1,0
13473,15538,244,286,3,5,5,3,1,6,0,0,37,16,5,5,0,0,0,1,0,0,0,0,-2065,-42,-2,2,-5,0,21,0,0,20,6,14,4,3,1,1
15772,16712,247,262,7,8,8,8,9,9,1,0,21,16,2,1,0,3,0,1,1,0,0,0,-940,-15,-1,0,0,0,5,1,-3,26.4,35,-8.6,4,3,1,1
2773,2756,7,7,0,0,0,0,0,0,0,0,3,3,0,0,0,0,0,0,0,0,0,0,17,0,0,0,0,0,0,0,0,7.8,18.4,-10.6,3,2,1,0
14420,16705,267,280,4,7,7,4,2,10,0,0,17,29,6,4,0,2,0,1,0,0,0,0,-2285,-13,-3,3,-8,0,-12,2,-2,12.4,11.2,1.2,2,2,0,0
14681,16238,268,278,4,7,7,4,4,8,0,0,17,35,4,5,0,2,0,1,0,0,0,0,-1557,-10,-3,3,-4,0,-18,-1,-2,41.2,73.8,-32.6,3,3,0,1
16111,16685,214,261,10,9,9,10,10,5,0,0,9,17,2,0,0,1,1,0,0,0,0,0,-574,-47,1,-1,5,0,-8,2,-1,4,56.8,-52.8,0,3,-3,0
16600,16672,247,248,8,9,10,8,11,17,0,1,14,17,3,4,1,2,1,0,0,1,0,0,-72,-1,-1,2,-6,0,-3,-1,-1,119.4,197.2,-77.8,4,4,0,0
14024,16430,230,267,3,8,8,3,3,8,0,1,12,12,3,1,2,1,0,1,0,1,0,0,-2406,-37,-5,5,-5,0,0,2,1,67.8,44.6,23.2,5,2,3,0
15693,15487,241,229,8,7,7,8,5,10,0,0,13,35,4,1,2,3,0,1,0,0,0,0,206,12,1,-1,-5,0,-22,3,-1,3.8,12.6,-8.8,1,3,-2,1
16742,14543,270,242,8,4,4,8,8,4,0,1,11,28,2,2,1,1,0,1,0,1,0,0,2199,28,4,-4,4,0,-17,0,0,14.8,11,3.8,3,4,-1,0
14201,15103,247,265,4,4,4,4,3,5,1,0,15,12,1,0,1,0,1,0,1,0,0,0,-902,-18,0,0,-2,0,3,1,1,19.8,61.6,-41.8,5,5,0,1
14169,15497,257,264,4,5,5,5,1,6,0,1,13,12,0,1,0,3,1,0,0,1,0,0,-1328,-7,-1,0,-5,0,1,-1,-3,20.8,7.2,13.6,4,3,1,0
16350,15995,249,255,7,10,10,7,7,14,0,0,19,17,2,1,0,0,0,1,0,0,0,0,355,-6,-3,3,-7,0,2,1,0,19.4,28.4,-9,3,4,-1,1
14491,15453,206,246,6,7,7,6,4,8,1,0,13,20,2,0,1,0,0,1,1,0,0,0,-962,-40,-1,1,-4,0,-7,2,1,34.6,6.2,28.4,2,1,1,1
14642,14303,256,246,5,4,4,5,1,4,0,0,20,16,2,5,1,0,0,1,0,0,0,0,339,10,1,-1,-3,0,4,-3,1,22.2,18.8,3.4,5,3,2,1
16149,14242,283,249,7,4,4,7,5,8,0,0,13,13,3,2,0,0,1,0,0,0,0,0,1907,34,3,-3,-3,0,0,1,0,73.6,23.6,50,5,5,0,0
13673,18065,263,274,2,12,12,2,1,10,0,1,13,16,2,3,0,1,0,1,0,1,0,0,-4392,-11,-10,10,-9,0,-3,-1,-1,88.6,49.8,38.8,5,4,1,0
14609,17043,241,268,5,8,8,5,4,11,0,0,11,29,3,4,0,1,1,0,0,0,0,0,-2434,-27,-3,3,-7,0,-18,-1,-1,13.8,22.2,-8.4,5,5,0,0
13993,14697,247,269,3,3,3,3,4,3,0,1,16,39,2,2,0,1,1,0,0,1,0,0,-704,-22,0,0,1,0,-23,0,-1,43.6,18.4,25.2,5,5,0,0
15723,14707,294,287,5,3,3,5,3,6,0,1,105,21,4,3,1,0,1,0,0,1,0,0,1016,7,2,-2,-3,0,84,1,1,36.4,20,16.4,4,2,2,1
14464,14937,253,264,5,5,5,5,3,1,0,0,14,13,4,5,0,2,1,0,0,0,0,0,-473,-11,0,0,2,0,1,-1,-2,61.6,16.4,45.2,4,3,1,0
14914,15984,271,271,4,6,6,4,4,6,0,0,15,15,3,1,0,1,0,1,0,0,0,0,-1070,0,-2,2,-2,0,0,2,-1,8,19.8,-11.8,3,4,-1,1
13574,16000,255,241,2,7,7,2,2,7,0,0,14,13,0,6,1,0,0,1,0,0,0,0,-2426,14,-5,5,-5,0,1,-6,1,28.4,100.2,-71.8,4,3,1,1
15225,14703,259,246,7,5,5,7,5,5,0,0,15,12,1,3,0,0,1,0,0,0,0,0,522,13,2,-2,0,0,3,-2,0,66,8.6,57.4,3,3,0,1
16186,16849,261,260,7,9,9,7,7,12,0,0,16,16,3,4,0,0,0,1,0,0,0,0,-663,1,-2,2,-5,0,0,-1,0,14.6,55.6,-41,4,3,1,0
15662,14741,274,253,6,5,5,6,4,4,0,1,17,39,2,1,0,0,0,1,0,1,0,0,921,21,1,-1,0,0,-22,1,0,29.4,12.2,17.2,2,4,-2,1
13961,17904,249,268,2,12,12,2,2,17,0,0,13,39,3,2,1,1,0,1,0,0,0,0,-3943,-19,-10,10,-15,0,-26,1,0,19.6,47.4,-27.8,4,5,-1,1
16469,15631,240,264,7,6,6,7,9,6,0,0,13,16,2,1,1,0,1,0,0,0,0,0,838,-24,1,-1,3,0,-3,1,1,78,10.8,67.2,5,3,2,0
16370,15474,259,250,8,8,8,8,8,4,0,0,15,15,6,1,0,1,1,0,0,0,0,0,896,9,0,0,4,0,0,5,-1,11.8,67.8,-56,4,5,-1,1
13698,13632,276,260,3,2,2,3,0,1,0,0,13,23,1,4,1,0,0,1,0,0,0,0,66,16,1,-1,-1,0,-10,-3,1,63,102.6,-39.6,5,5,0,0
13784,15667,263,275,2,5,5,2,2,3,0,1,38,21,5,4,0,3,0,1,0,1,0,0,-1883,-12,-3,3,-1,0,17,1,-3,8.8,134,-125.2,3,5,-2,0
16741,15881,265,243,9,7,7,9,8,7,0,0,16,16,2,3,2,0,1,0,0,0,0,0,860,22,2,-2,1,0,0,-1,2,23.6,10.4,13.2,5,1,4,1
16358,15441,241,243,8,8,8,8,8,5,0,1,16,12,2,2,1,2,0,1,0,1,0,0,917,-2,0,0,3,0,4,0,-1,105.4,10.2,95.2,4,3,1,0
15199,14254,264,256,5,3,3,5,2,4,0,1,16,16,2,4,1,2,1,0,0,1,0,0,945,8,2,-2,-2,0,0,-2,-1,69.2,76.6,-7.4,4,4,0,1
15520,15024,258,245,6,6,6,6,5,4,0,1,33,15,1,2,1,0,0,1,0,1,0,0,496,13,0,0,1,0,18,-1,1,12.6,30,-17.4,3,4,-1,1
15039,14637,265,276,5,4,4,5,4,2,0,1,28,14,3,1,0,1,1,0,0,1,0,0,402,-11,1,-1,2,0,14,2,-1,31,36.4,-5.4,5,3,2,0
14974,12762,279,266,5,0,0,5,4,0,0,0,15,15,4,3,0,0,1,0,0,0,0,0,2212,13,5,-5,4,0,0,1,0,70.8,36.8,34,3,5,-2,1
15800,15647,261,290,7,5,5,7,6,3,0,0,13,13,2,2,1,1,1,0,0,0,0,0,153,-29,2,-2,3,0,0,0,0,13.6,30,-16.4,3,5,-2,0
14677,16016,259,265,5,7,7,5,4,6,0,0,18,14,4,1,0,1,1,0,0,0,0,0,-1339,-6,-2,2,-2,0,4,3,-1,21.8,38.2,-16.4,4,4,0,0
15738,14484,263,263,6,4,4,6,7,5,0,0,32,16,3,3,0,0,1,0,0,0,0,0,1254,0,2,-2,2,0,16,0,0,64,69,-5,4,4,0,1
14580,16574,273,275,3,8,8,3,2,13,1,0,16,22,6,4,0,0,1,0,1,0,0,0,-1994,-2,-5,5,-11,0,-6,2,0,66,76.2,-10.2,5,4,1,0
15077,15749,273,294,5,5,5,5,5,5,0,0,16,15,1,3,0,0,1,0,0,0,0,0,-672,-21,0,0,0,0,1,-2,0,8,19.4,-11.4,2,4,-2,1
15136,15102,277,263,4,5,5,4,3,8,0,0,23,16,4,2,1,0,0,1,0,0,0,0,34,14,-1,1,-5,0,7,2,1,31.2,18.8,12.4,5,4,1,1
16766,16156,266,269,9,7,7,9,8,8,0,1,8,13,2,1,1,0,0,1,0,1,0,0,610,-3,2,-2,0,0,-5,1,1,19.2,16.6,2.6,3,2,1,1
17100,14348,276,267,9,3,3,9,11,5,1,0,21,17,5,2,1,0,1,0,1,0,0,0,2752,9,6,-6,6,0,4,3,1,32.4,57.8,-25.4,4,4,0,1
15356,16963,246,225,6,11,11,6,4,14,1,0,34,42,2,3,1,1,1,0,1,0,0,0,-1607,21,-5,5,-10,0,-8,-1,0,23.2,21.4,1.8,2,4,-2,0
17907,15225,259,234,12,4,4,12,16,10,0,1,16,16,4,1,2,2,1,0,0,1,0,0,2682,25,8,-8,6,0,0,3,0,25.6,170.8,-145.2,4,4,0,1
17543,13327,279,241,6,2,2,6,6,2,0,0,16,18,4,5,6,0,0,1,0,0,1,0,4216,38,4,-4,4,0,-2,-1,6,93.2,13.4,79.8,4,2,2,1
14549,15450,246,269,4,5,5,4,4,10,0,0,19,113,4,4,0,0,1,0,0,0,0,0,-901,-23,-1,1,-6,0,-94,0,0,61.2,22.6,38.6,5,5,0,0
14368,15075,276,241,3,6,6,3,1,9,0,1,16,14,4,1,0,1,0,1,0,1,0,0,-707,35,-3,3,-8,0,2,3,-1,30.8,15.2,15.6,4,3,1,0
13750,15284,284,289,1,4,4,3,1,9,0,0,18,14,2,6,0,0,0,1,0,0,0,0,-1534,-5,-3,1,-8,0,4,-4,0,62.8,73,-10.2,4,4,0,1
14291,17205,261,289,4,9,9,4,1,10,0,0,16,14,4,4,0,1,0,1,0,0,0,0,-2914,-28,-5,5,-9,0,2,0,-1,29.4,72.4,-43,3,3,0,0
14500,13536,276,278,3,1,1,3,5,1,0,0,18,15,2,4,0,1,1,0,0,0,0,0,964,-2,2,-2,4,0,3,-2,-1,6.4,45.4,-39,2,5,-3,0
15829,17371,257,234,7,12,12,7,11,21,0,0,18,20,2,4,1,1,1,0,0,0,0,0,-1542,23,-5,5,-10,0,-2,-2,0,32.2,55.8,-23.6,5,4,1,1
16113,15803,249,267,7,8,8,7,15,8,0,1,15,14,2,2,1,0,0,1,0,1,0,0,310,-18,-1,1,7,0,1,0,1,9.6,16,-6.4,4,3,1,1
18320,15715,254,231,13,7,7,13,13,8,0,0,14,31,6,3,0,2,1,0,0,0,0,0,2605,23,6,-6,5,0,-17,3,-2,131.4,46.8,84.6,4,3,1,1
16602,15677,266,259,8,6,6,8,11,7,0,0,32,12,2,4,1,2,0,1,0,0,0,0,925,7,2,-2,4,0,20,-2,-1,135.6,189.8,-54.2,4,4,0,1
15085,13304,276,288,5,0,0,5,3,0,0,0,76,14,5,4,0,1,1,0,0,0,0,0,1781,-12,5,-5,3,0,62,1,-1,53,7.4,45.6,5,3,2,1
16918,15338,291,262,8,5,5,8,15,9,0,0,32,16,3,2,1,2,1,0,0,0,0,0,1580,29,3,-3,6,0,16,1,-1,91.6,17,74.6,3,2,1,1
15856,14659,291,295,5,3,3,5,6,5,0,0,13,16,6,3,0,0,0,1,0,0,0,0,1197,-4,2,-2,1,0,-3,3,0,66.4,37.8,28.6,3,4,-1,1
13482,14028,263,225,2,5,5,2,2,4,1,0,13,127,3,2,0,0,0,1,1,0,0,0,-546,38,-3,3,-2,0,-114,1,0,38.6,35.6,3,3,3,0,1
14323,16283,240,257,3,8,8,3,4,13,0,0,26,184,0,2,0,0,0,1,0,0,0,0,-1960,-17,-5,5,-9,0,-158,-2,0,80,14,66,5,4,1,1
15245,14125,269,283,5,2,3,5,5,2,1,0,20,16,3,4,2,0,1,0,1,0,0,0,1120,-14,3,-2,3,0,4,-1,2,61,10.6,50.4,5,4,1,0
13971,15271,254,290,3,5,5,3,3,10,0,0,21,15,2,3,0,0,1,0,0,0,0,0,-1300,-36,-2,2,-7,0,6,-1,0,89,44,45,4,4,0,0
14297,19183,202,260,6,15,15,6,6,17,0,0,20,35,2,3,0,0,0,1,0,0,0,0,-4886,-58,-9,9,-11,0,-15,-1,0,91,154.2,-63.2,3,5,-2,0
15736,14438,298,312,5,2,2,6,8,1,1,0,21,17,6,5,1,0,1,0,1,0,0,0,1298,-14,3,-4,7,0,4,1,1,41.8,98.6,-56.8,4,4,0,1
16550,14459,295,276,7,3,3,7,3,3,0,0,15,17,6,1,2,0,1,0,0,0,0,0,2091,19,4,-4,0,0,-2,5,2,74.4,75.8,-1.4,5,4,1,1
13368,14907,235,291,2,4,4,2,3,3,0,0,39,23,2,2,0,0,0,1,0,0,0,0,-1539,-56,-2,2,0,0,16,0,0,34.4,24.8,9.6,4,5,-1,1
3789,4414,28,44,0,1,1,0,0,1,0,0,6,2,0,0,0,0,0,1,0,0,0,0,-625,-16,-1,1,-1,0,4,0,0,9.2,35.4,-26.2,3,3,0,0
15951,14052,255,243,8,3,3,8,4,5,0,0,15,15,1,0,0,1,1,0,0,0,0,0,1899,12,5,-5,-1,0,0,1,-1,36.2,5.8,30.4,3,3,0,1
17701,14488,252,263,12,3,3,12,16,6,0,1,19,17,4,5,1,0,1,0,0,1,0,0,3213,-11,9,-9,10,0,2,-1,1,91.6,90.6,1,5,4,1,1
17325,13347,277,270,9,1,1,9,12,2,0,0,14,104,4,5,0,0,1,0,0,0,0,0,3978,7,8,-8,10,0,-90,-1,0,77,21.4,55.6,3,4,-1,1
16300,14808,259,248,7,5,5,7,7,5,0,0,19,23,2,6,0,0,0,1,0,0,0,0,1492,11,2,-2,2,0,-4,-4,0,17.2,18.8,-1.6,3,5,-2,1
14866,16192,244,272,5,9,9,5,5,11,0,0,16,13,4,8,1,0,0,1,0,0,0,0,-1326,-28,-4,4,-6,0,3,-4,1,28.2,44.4,-16.2,2,5,-3,0
14870,13068,298,270,2,0,0,2,2,0,0,0,11,15,3,1,2,1,1,0,0,0,0,0,1802,28,2,-2,2,0,-4,2,1,76.8,170.4,-93.6,4,4,0,1
15538,14663,265,228,6,6,6,6,8,8,0,0,25,18,4,1,0,0,0,1,0,0,0,0,875,37,0,0,0,0,7,3,0,42.4,60,-17.6,4,3,1,1
13746,18166,206,268,3,12,12,3,5,18,1,0,18,42,1,8,1,5,0,1,1,0,0,0,-4420,-62,-9,9,-13,0,-24,-7,-4,73.2,20,53.2,4,4,0,0
14598,15497,256,291,4,5,5,4,3,2,1,0,14,19,2,2,1,1,0,1,1,0,0,0,-899,-35,-1,1,1,0,-5,0,0,14.2,23.4,-9.2,3,3,0,0
15858,13393,268,255,6,1,2,6,8,2,1,0,17,57,4,2,1,1,1,0,1,0,0,0,2465,13,5,-4,6,0,-40,2,0,93.2,15.8,77.4,5,3,2,1
14619,15542,286,300,3,3,3,3,4,6,0,0,15,15,2,3,1,1,1,0,0,0,0,0,-923,-14,0,0,-2,0,0,-1,0,55.6,162.8,-107.2,4,5,-1,1
14388,16992,241,309,5,7,7,6,8,8,0,1,16,15,2,6,0,3,0,1,0,1,0,0,-2604,-68,-2,1,0,0,1,-4,-3,19.6,106.6,-87,5,5,0,0
15409,13694,294,298,4,1,1,4,8,0,0,0,18,16,2,4,0,0,1,0,0,0,0,0,1715,-4,3,-3,8,0,2,-2,0,170,32.6,137.4,5,4,1,1
13613,13673,235,292,3,1,2,3,6,0,0,1,41,23,3,3,0,0,0,1,0,1,0,0,-60,-57,2,-1,6,0,18,0,0,44.8,56.8,-12,5,4,1,1
15853,14375,249,228,8,5,5,8,18,7,1,0,18,16,6,3,0,1,0,1,1,0,0,0,1478,21,3,-3,11,0,2,3,-1,60.6,60.8,-0.2,5,5,0,1
18991,16372,272,243,15,8,8,15,17,7,0,1,15,21,1,1,1,0,1,0,0,1,0,0,2619,29,7,-7,10,0,-6,0,1,21.8,86.4,-64.6,3,5,-2,1
14837,15748,236,269,6,6,6,6,5,6,0,1,14,20,8,1,0,1,0,1,0,1,0,0,-911,-33,0,0,-1,0,-6,7,-1,79.2,12.2,67,4,4,0,0
17140,14469,258,230,10,4,4,10,15,2,0,0,18,12,0,0,1,1,1,0,0,0,0,0,2671,28,6,-6,13,0,6,0,0,31.6,51.8,-20.2,4,3,1,1
13618,15072,264,287,2,5,5,2,2,7,0,1,32,25,3,5,0,0,0,1,0,1,0,0,-1454,-23,-3,3,-5,0,7,-2,0,18.2,28.2,-10,5,4,1,0
13484,13492,292,286,0,1,1,0,0,0,0,1,16,17,5,3,0,0,0,1,0,1,0,0,-8,6,-1,1,0,0,-1,2,0,12.2,21,-8.8,5,4,1,0
15095,16097,223,288,6,4,4,6,9,5,0,0,16,29,2,6,1,2,1,0,0,0,0,0,-1002,-65,2,-2,4,0,-13,-4,-1,9.8,9.6,0.2,4,4,0,1
16249,13769,258,246,9,3,3,9,7,2,1,0,14,13,3,1,1,0,1,0,1,0,0,0,2480,12,6,-6,5,0,1,2,1,80,15.4,64.6,3,3,0,1
16211,15200,278,262,7,5,5,7,9,6,0,0,15,18,4,5,0,1,0,1,0,0,0,0,1011,16,2,-2,3,0,-3,-1,-1,32.6,8,24.6,5,4,1,0
14423,14852,276,273,4,4,4,4,5,8,1,0,20,12,5,1,0,0,1,0,1,0,0,0,-429,3,0,0,-3,0,8,4,0,100.4,25.4,75,4,4,0,1
15258,15114,269,211,5,7,7,5,6,7,0,1,17,21,2,2,0,0,1,0,0,1,0,0,144,58,-2,2,-1,0,-4,0,0,15,54,-39,5,5,0,0
16285,14621,260,216,7,6,6,7,12,5,0,0,18,14,4,6,0,1,1,0,0,0,0,0,1664,44,1,-1,7,0,4,-2,-1,43.6,26.8,16.8,3,4,-1,0
12901,14457,248,268,1,4,4,1,0,1,0,0,17,18,2,3,0,0,0,1,0,0,0,0,-1556,-20,-3,3,-1,0,-1,-1,0,31.2,10.2,21,5,4,1,1
16052,16690,260,267,8,9,9,8,8,13,0,0,16,28,4,1,1,1,1,0,0,0,0,0,-638,-7,-1,1,-5,0,-12,3,0,17.4,16.2,1.2,5,4,1,1
14676,14389,284,249,3,5,5,3,4,4,0,1,14,114,4,1,0,0,1,0,0,1,0,0,287,35,-2,2,0,0,-100,3,0,9.4,47,-37.6,2,4,-2,1
15594,17202,249,246,5,11,11,5,7,19,0,1,17,18,3,4,1,0,1,0,0,1,0,0,-1608,3,-6,6,-12,0,-1,-1,1,18,99.6,-81.6,5,4,1,0
15304,15735,301,291,3,5,5,3,3,6,0,0,118,19,6,2,0,0,0,1,0,0,0,0,-431,10,-2,2,-3,0,99,4,0,54.4,30.2,24.2,5,3,2,0
15099,14168,289,272,4,3,3,4,4,1,0,0,15,15,3,5,0,0,1,0,0,0,0,0,931,17,1,-1,3,0,0,-2,0,17.8,11.6,6.2,4,3,1,0
14306,15224,235,283,4,4,4,4,8,6,0,1,16,14,1,3,1,2,0,1,0,1,0,0,-918,-48,0,0,2,0,2,-2,-1,10,21.8,-11.8,4,5,-1,0
16095,14122,296,251,6,3,3,6,6,2,1,0,14,15,5,2,0,1,1,0,1,0,0,0,1973,45,3,-3,4,0,-1,3,-1,35.4,14,21.4,4,2,2,1
15044,17696,229,257,6,11,11,6,8,19,0,0,12,17,3,2,0,1,0,1,0,0,0,0,-2652,-28,-5,5,-11,0,-5,1,-1,32.6,9.6,23,4,4,0,0
15121,14171,241,259,8,3,3,8,8,4,0,0,37,25,3,4,1,0,1,0,0,0,0,0,950,-18,5,-5,4,0,12,-1,1,59.8,35.6,24.2,3,5,-2,1
12688,13938,242,278,0,2,2,0,0,3,0,0,34,14,3,2,0,0,0,1,0,0,0,0,-1250,-36,-2,2,-3,0,20,1,0,28.4,21.4,7,5,4,1,1
16354,13005,278,260,7,1,2,7,9,0,0,0,25,11,5,0,2,0,1,0,0,0,0,0,3349,18,6,-5,9,0,14,5,2,25.4,20.6,4.8,5,3,2,1
16189,13144,261,240,6,1,1,6,6,2,0,1,15,35,1,4,2,2,1,0,0,1,0,0,3045,21,5,-5,4,0,-20,-3,0,74,14.8,59.2,4,4,0,1
17060,14850,301,298,7,2,2,7,9,5,0,0,23,15,6,4,2,0,1,0,0,0,0,0,2210,3,5,-5,4,0,8,2,2,50.6,23,27.6,4,4,0,0
15243,14007,273,249,5,3,3,5,3,5,0,0,38,45,7,6,1,0,1,0,0,0,0,0,1236,24,2,-2,-2,0,-7,1,1,41,106,-65,3,5,-2,0
14693,15208,278,259,3,5,5,3,1,6,0,1,16,18,2,2,0,1,0,1,0,1,0,0,-515,19,-2,2,-5,0,-2,0,-1,5.8,11.8,-6,2,2,0,0
15709,15092,255,259,6,4,4,6,7,4,0,1,15,16,5,2,2,2,0,1,0,1,0,0,617,-4,2,-2,3,0,-1,3,0,8.8,13.6,-4.8,2,3,-1,0
15755,13657,259,234,7,3,3,7,8,3,0,0,15,15,4,1,0,0,0,1,0,0,0,0,2098,25,4,-4,5,0,0,3,0,21.2,10.8,10.4,4,3,1,1
16400,15311,248,250,9,6,6,9,15,6,0,0,17,9,2,5,1,0,1,0,0,0,0,0,1089,-2,3,-3,9,0,8,-3,1,27.4,13.6,13.8,5,3,2,1
15232,15214,240,270,7,5,5,7,7,4,0,0,16,13,2,3,0,0,0,1,0,0,0,0,18,-30,2,-2,3,0,3,-1,0,21.8,18.6,3.2,4,2,2,0
14132,13655,277,292,2,1,1,2,2,1,1,0,13,19,4,4,2,0,1,0,1,0,0,0,477,-15,1,-1,1,0,-6,0,2,36,52.4,-16.4,4,4,0,0
14645,13972,270,234,3,4,4,3,3,3,0,0,16,13,3,3,1,0,0,1,0,0,0,0,673,36,-1,1,0,0,3,0,1,21,40.4,-19.4,4,3,1,1
12516,17043,179,254,3,11,11,3,4,5,1,0,14,15,0,1,0,3,0,1,1,0,0,0,-4527,-75,-8,8,-1,0,-1,-1,-3,16.2,20.8,-4.6,4,3,1,0
14581,14980,272,252,3,5,5,3,3,6,0,0,13,14,3,5,0,1,0,1,0,0,0,0,-399,20,-2,2,-3,0,-1,-2,-1,29.4,13.2,16.2,4,4,0,0
18278,13154,261,230,12,2,3,12,11,3,0,1,70,33,2,4,1,0,1,0,0,1,0,0,5124,31,10,-9,8,0,37,-2,1,38,32,6,3,4,-1,1
17106,14990,274,267,8,4,4,8,12,5,0,0,20,16,5,4,1,0,1,0,0,0,0,0,2116,7,4,-4,7,0,4,1,1,35,9.6,25.4,3,3,0,1
14814,15329,241,259,5,6,6,5,5,4,0,0,14,12,2,2,0,2,0,1,0,0,0,0,-515,-18,-1,1,1,0,2,0,-2,22.2,7.6,14.6,2,3,-1,1
16074,17147,245,294,8,9,9,8,12,9,0,0,121,12,4,2,0,0,0,1,0,0,0,0,-1073,-49,-1,1,3,0,109,2,0,36,22.4,13.6,3,4,-1,0
16822,15551,249,263,10,7,7,10,12,2,0,1,19,15,4,4,0,1,1,0,0,1,0,0,1271,-14,3,-3,10,0,4,0,-1,20.2,9.6,10.6,4,1,3,0
15457,14466,284,246,4,4,4,4,5,8,0,0,115,24,2,3,1,1,1,0,0,0,0,0,991,38,0,0,-3,0,91,-1,0,51.8,40.8,11,5,1,4,1
18187,15170,270,220,12,7,8,12,10,7,0,1,29,15,4,2,0,1,0,1,0,1,0,0,3017,50,5,-4,3,0,14,2,-1,10.2,21,-10.8,3,3,0,1
15377,15288,242,251,7,6,6,8,5,7,0,1,39,37,2,4,1,0,1,0,0,1,0,0,89,-9,1,-2,-2,0,2,-2,1,97.4,33,64.4,4,3,1,1
13723,14491,229,237,4,6,6,4,2,1,0,0,13,21,2,1,1,1,1,0,0,0,0,0,-768,-8,-2,2,1,0,-8,1,0,5.8,10,-4.2,2,2,0,0
14607,16110,271,278,5,6,6,5,4,12,1,0,19,18,4,6,0,1,1,0,1,0,0,0,-1503,-7,-1,1,-8,0,1,-2,-1,17,58.2,-41.2,4,4,0,0
16252,15105,284,258,7,5,5,7,4,5,0,0,15,14,0,1,2,0,1,0,0,0,0,0,1147,26,2,-2,-1,0,1,-1,2,84.4,12.4,72,4,5,-1,1
14294,17385,246,241,4,11,11,4,6,13,1,0,13,15,4,1,2,5,0,1,1,0,0,0,-3091,5,-7,7,-7,0,-2,3,-3,12.8,65.6,-52.8,4,5,-1,0
15084,15329,275,287,4,4,4,4,3,7,1,0,16,111,1,3,2,0,1,0,1,0,0,0,-245,-12,0,0,-4,0,-95,-2,2,26.8,74,-47.2,3,5,-2,1
14411,16018,279,276,3,7,7,3,3,8,0,0,22,20,3,2,0,1,0,1,0,0,0,0,-1607,3,-4,4,-5,0,2,1,-1,45.2,33.2,12,4,3,1,1
16731,14250,247,243,10,3,3,10,11,2,1,0,160,14,2,0,0,0,1,0,1,0,0,0,2481,4,7,-7,9,0,146,2,0,24.4,41.6,-17.2,4,4,0,1
14754,14464,242,262,5,4,4,5,3,2,0,1,19,17,3,5,0,1,0,1,0,1,0,0,290,-20,1,-1,1,0,2,-2,-1,18.4,28,-9.6,3,4,-1,0
15665,16073,299,294,5,6,6,5,6,9,0,1,14,16,3,2,0,1,0,1,0,1,0,0,-408,5,-1,1,-3,0,-2,1,-1,42.4,18.6,23.8,3,4,-1,0
16961,13375,236,246,13,2,2,13,9,1,0,0,15,14,3,2,1,0,1,0,0,0,0,0,3586,-10,11,-11,8,0,1,1,1,114.6,58.2,56.4,3,4,-1,1
15892,15195,274,268,5,6,6,5,6,6,0,0,19,53,3,6,2,0,1,0,0,0,0,0,697,6,-1,1,0,0,-34,-3,2,50.2,43.4,6.8,1,4,-3,0
15688,14990,254,260,7,5,6,7,9,6,0,1,14,13,0,1,0,0,1,0,0,1,0,0,698,-6,2,-1,3,0,1,-1,0,43.4,57.6,-14.2,5,4,1,1
15619,16382,283,270,6,8,8,6,3,5,0,0,14,14,1,2,0,0,0,1,0,0,0,0,-763,13,-2,2,-2,0,0,-1,0,35.2,64.4,-29.2,3,3,0,1
15507,17273,220,233,7,12,12,7,10,19,0,1,15,15,1,1,1,0,0,1,0,1,0,0,-1766,-13,-5,5,-9,0,0,0,1,11.4,23,-11.6,3,4,-1,1
17206,16544,232,259,10,8,8,10,12,8,0,0,12,24,5,2,4,1,1,0,0,0,0,0,662,-27,2,-2,4,0,-12,3,3,25.8,37.6,-11.8,4,4,0,0
15512,15245,284,229,5,6,6,5,4,14,1,0,12,147,2,1,1,0,1,0,1,0,0,0,267,55,-1,1,-10,0,-135,1,1,106.8,8,98.8,3,2,1,1
15223,15013,266,254,6,5,5,6,3,8,0,1,15,43,2,1,0,0,1,0,0,1,0,0,210,12,1,-1,-5,0,-28,1,0,21.4,11.8,9.6,3,2,1,0
14545,14748,247,260,4,5,6,4,5,2,0,0,17,87,2,1,0,0,1,0,0,0,0,0,-203,-13,-1,2,3,0,-70,1,0,43.6,37.4,6.2,4,4,0,1
15049,14955,246,244,6,6,6,6,4,8,0,0,16,30,1,3,1,0,0,1,0,0,0,0,94,2,0,0,-4,0,-14,-2,1,39.8,137.6,-97.8,3,4,-1,1
16711,14067,248,279,9,2,2,9,19,2,1,0,15,15,1,2,1,0,0,1,1,0,0,0,2644,-31,7,-7,17,0,0,-1,1,124.2,19.6,104.6,5,3,2,1
15804,15228,245,249,7,5,5,7,10,8,1,0,14,188,5,3,0,0,1,0,1,0,0,0,576,-4,2,-2,2,0,-174,2,0,48.4,30,18.4,5,3,2,0
17626,16189,240,245,10,8,8,10,15,10,1,0,65,29,0,3,1,1,1,0,1,0,0,0,1437,-5,2,-2,5,0,36,-3,0,13.4,67.6,-54.2,2,3,-1,1
16817,13604,270,243,9,2,2,9,12,2,0,0,17,13,3,3,1,1,1,0,0,0,0,0,3213,27,7,-7,10,0,4,0,0,28.2,50.8,-22.6,4,4,0,1
16216,15566,289,237,6,7,7,6,8,11,0,0,15,37,4,2,2,0,0,1,0,0,0,0,650,52,-1,1,-3,0,-22,2,2,59.6,88.8,-29.2,4,4,0,0
15730,16468,268,249,7,8,8,7,6,14,0,0,16,15,4,2,1,2,0,1,0,0,0,0,-738,19,-1,1,-8,0,1,2,-1,74.2,116.8,-42.6,4,5,-1,0
17997,15684,257,268,12,5,5,12,15,4,0,0,33,20,5,2,2,1,0,1,0,0,0,0,2313,-11,7,-7,11,0,13,3,1,41.6,34.6,7,4,2,2,0
15363,14559,247,253,6,5,5,6,7,7,0,1,97,34,4,1,1,0,0,1,0,1,0,0,804,-6,1,-1,0,0,63,3,1,37,45.4,-8.4,5,4,1,0
17390,12518,255,186,10,3,3,10,14,4,0,0,37,16,1,0,3,0,1,0,0,0,0,0,4872,69,7,-7,10,0,21,1,3,83.8,32,51.8,4,3,1,1
14844,15801,268,282,3,6,6,3,4,5,0,1,19,11,2,3,1,0,0,1,0,1,0,0,-957,-14,-3,3,-1,0,8,-1,1,72.8,62.4,10.4,4,4,0,1
14170,14373,265,258,3,3,3,3,6,3,0,0,14,38,3,2,0,0,1,0,0,0,0,0,-203,7,0,0,3,0,-24,1,0,30.6,17.6,13,5,2,3,1
16592,15059,278,265,8,4,4,8,6,4,0,0,19,13,4,9,1,1,0,1,0,0,0,0,1533,13,4,-4,2,0,6,-5,0,42.4,42,0.4,5,4,1,1
15585,15994,280,265,4,6,6,4,7,9,0,1,13,16,3,0,1,0,1,0,0,1,0,0,-409,15,-2,2,-2,0,-3,3,1,9.4,54.2,-44.8,3,4,-1,1
14919,14078,277,243,4,3,3,4,3,3,0,0,19,37,3,2,1,1,1,0,0,0,0,0,841,34,1,-1,0,0,-18,1,0,16,18,-2,3,5,-2,1
14621,15481,249,264,5,7,7,5,4,4,0,0,15,11,0,2,0,2,0,1,0,0,0,0,-860,-15,-2,2,0,0,4,-2,-2,93.4,16.2,77.2,4,4,0,0
15299,15908,265,264,4,7,7,4,6,7,0,0,14,13,2,1,0,3,0,1,0,0,0,0,-609,1,-3,3,-1,0,1,1,-3,90.6,66.4,24.2,3,2,1,0
16529,13218,285,237,7,2,2,7,13,4,1,0,27,11,3,1,2,0,0,1,1,0,0,0,3311,48,5,-5,9,0,16,2,2,15.6,18.6,-3,4,3,1,1
15493,17098,262,267,6,10,10,6,5,11,0,1,15,20,4,3,0,1,1,0,0,1,0,0,-1605,-5,-4,4,-6,0,-5,1,-1,58.6,76,-17.4,5,3,2,1
17803,13694,256,225,11,3,3,11,20,4,1,0,40,16,3,4,4,0,1,0,1,0,0,0,4109,31,8,-8,16,0,24,-1,4,34.8,49.8,-15,4,3,1,1
17050,14015,260,269,10,3,3,10,12,2,0,0,17,13,1,1,2,0,1,0,0,0,0,0,3035,-9,7,-7,10,0,4,0,2,83.6,57.4,26.2,4,3,1,1
12983,14706,253,272,0,4,4,0,0,6,0,1,24,222,4,4,0,0,0,1,0,1,0,0,-1723,-19,-4,4,-6,0,-198,0,0,74,92.4,-18.4,3,5,-2,0
16489,13728,287,231,8,3,3,8,6,4,0,0,18,14,2,3,0,0,1,0,0,0,0,0,2761,56,5,-5,2,0,4,-1,0,32.4,56.4,-24,4,4,0,1
14396,15710,264,264,3,7,7,3,2,7,0,1,17,14,5,4,0,2,0,1,0,1,0,0,-1314,0,-4,4,-5,0,3,1,-2,43.8,6.4,37.4,3,2,1,0
15384,16289,228,262,8,9,9,8,6,9,0,0,15,15,3,3,1,0,1,0,0,0,0,0,-905,-34,-1,1,-3,0,0,0,1,3.8,54.4,-50.6,1,5,-4,0
13942,17995,215,244,4,13,13,4,4,13,0,0,11,37,4,0,1,0,0,1,0,0,0,0,-4053,-29,-9,9,-9,0,-26,4,1,14.4,14.6,-0.2,2,4,-2,0
17993,14901,221,253,13,4,4,13,13,5,0,0,16,35,4,2,1,0,1,0,0,0,0,0,3092,-32,9,-9,8,0,-19,2,1,32.6,21.6,11,5,3,2,1
16243,14111,325,277,4,2,2,4,5,3,1,0,15,14,3,5,4,0,1,0,1,0,0,0,2132,48,2,-2,2,0,1,-2,4,57.4,21.6,35.8,4,4,0,1
15362,14266,264,216,5,5,5,5,10,5,0,1,32,21,5,1,1,0,0,1,0,1,0,0,1096,48,0,0,5,0,11,4,1,39.6,62.4,-22.8,5,4,1,1
14366,14373,250,271,3,3,3,3,4,6,0,0,244,11,1,3,1,0,0,1,0,0,0,0,-7,-21,0,0,-2,0,233,-2,1,21.8,21.6,0.2,4,5,-1,0
14824,14932,260,266,4,4,4,5,5,6,0,0,12,17,4,2,2,1,1,0,0,0,0,0,-108,-6,0,-1,-1,0,-5,2,1,18.4,43.6,-25.2,3,2,1,1
15462,18494,288,282,3,12,12,3,3,17,0,1,14,32,4,2,0,0,0,1,0,1,0,0,-3032,6,-9,9,-14,0,-18,2,0,55.2,76,-20.8,5,5,0,0
14829,15542,246,220,5,8,9,5,8,16,0,0,17,115,5,2,0,0,1,0,0,0,0,0,-713,26,-3,4,-8,0,-98,3,0,28.8,14.4,14.4,4,4,0,0
16554,14162,264,265,8,3,3,8,6,3,0,0,17,38,7,2,2,0,1,0,0,0,0,0,2392,-1,5,-5,3,0,-21,5,2,8,32,-24,2,2,0,1
12384,15743,207,276,1,6,6,1,1,6,0,0,12,223,3,2,0,2,0,1,0,0,0,0,-3359,-69,-5,5,-5,0,-211,1,-2,42.2,37.8,4.4,4,5,-1,0
15665,15748,283,290,5,5,5,5,8,4,0,1,13,13,2,1,1,2,1,0,0,1,0,0,-83,-7,0,0,4,0,0,1,-1,42.6,9.4,33.2,4,3,1,0
15557,15818,292,290,4,5,5,4,6,4,0,0,106,16,5,9,0,1,1,0,0,0,0,0,-261,2,-1,1,2,0,90,-4,-1,10.2,22.6,-12.4,3,5,-2,0
17589,15119,261,248,13,7,7,13,21,7,1,0,15,16,7,2,0,0,1,0,1,0,0,0,2470,13,6,-6,14,0,-1,5,0,13.4,41.6,-28.2,5,4,1,1
15022,14935,272,280,4,5,5,4,7,3,0,1,44,19,2,5,0,0,0,1,0,1,0,0,87,-8,-1,1,4,0,25,-3,0,13.4,15.6,-2.2,3,3,0,0
15234,14381,301,286,3,2,2,3,6,3,0,0,33,10,2,6,1,0,1,0,0,0,0,0,853,15,1,-1,3,0,23,-4,1,90.6,19,71.6,4,3,1,1
17122,13319,292,257,8,1,1,8,11,1,0,0,17,34,3,3,0,0,0,1,0,0,0,0,3803,35,7,-7,10,0,-17,0,0,17.8,51.6,-33.8,2,5,-3,1
15664,18066,217,224,6,14,14,6,8,16,0,0,11,19,1,2,1,1,0,1,0,0,0,0,-2402,-7,-8,8,-8,0,-8,-1,0,18.2,42.8,-24.6,3,3,0,0
14861,14033,275,254,4,3,3,4,3,2,0,0,27,11,3,4,0,1,0,1,0,0,0,0,828,21,1,-1,1,0,16,-1,-1,99.2,14.8,84.4,3,4,-1,0
16207,14807,260,264,8,5,5,8,9,3,0,0,18,15,2,5,0,0,0,1,0,0,0,0,1400,-4,3,-3,6,0,3,-3,0,136.8,5.2,131.6,4,1,3,0
14087,15802,248,248,4,11,11,4,4,7,0,1,33,13,1,6,0,0,0,1,0,1,0,0,-1715,0,-7,7,-3,0,20,-5,0,15.2,45,-29.8,4,4,0,0
15087,16183,212,259,7,7,7,7,10,8,0,1,26,108,6,6,0,1,0,1,0,1,0,0,-1096,-47,0,0,2,0,-82,0,-1,23.2,71.8,-48.6,4,5,-1,0
16614,13070,256,223,9,2,2,9,11,2,0,0,28,17,3,3,1,0,0,1,0,0,0,0,3544,33,7,-7,9,0,11,0,1,95.4,30.4,65,3,4,-1,0
16022,15790,260,248,6,8,8,7,9,11,0,0,14,15,3,4,1,1,0,1,0,0,0,0,232,12,-2,1,-2,0,-1,-1,0,14.2,10,4.2,5,2,3,0
18005,15344,265,240,13,6,7,13,14,6,0,0,17,13,2,1,3,0,1,0,0,0,0,0,2661,25,7,-6,8,0,4,1,3,71.4,44.4,27,5,4,1,1
13603,16348,249,280,3,6,6,3,3,7,0,1,12,108,3,5,0,1,1,0,0,1,0,0,-2745,-31,-3,3,-4,0,-96,-2,-1,72.6,43.4,29.2,3,5,-2,0
16802,14744,259,245,9,5,5,9,8,6,1,0,16,15,4,1,2,0,1,0,1,0,0,0,2058,14,4,-4,2,0,1,3,2,30.6,15.8,14.8,4,3,1,1
16142,13345,285,263,7,1,1,7,3,2,0,1,25,16,8,3,2,0,1,0,0,1,0,0,2797,22,6,-6,1,0,9,5,2,128.6,20.8,107.8,4,5,-1,1
15717,15646,229,199,9,9,9,9,10,10,0,0,17,18,6,4,0,0,0,1,0,0,0,0,71,30,0,0,0,0,-1,2,0,43.4,63.8,-20.4,4,4,0,0
14969,13871,260,261,5,3,3,5,9,1,0,0,14,32,6,3,1,0,0,1,0,0,0,0,1098,-1,2,-2,8,0,-18,3,1,39.6,12.8,26.8,5,4,1,1
13912,16597,259,285,2,7,7,2,1,14,0,1,13,108,6,3,1,1,0,1,0,1,0,0,-2685,-26,-5,5,-13,0,-95,3,0,33.8,46.6,-12.8,3,3,0,0
16556,15406,247,260,10,7,7,10,14,7,0,0,16,17,2,2,0,0,1,0,0,0,0,0,1150,-13,3,-3,7,0,-1,0,0,81.6,63.8,17.8,5,4,1,1
16500,16522,254,267,10,8,8,10,9,6,0,0,20,33,3,2,2,1,1,0,0,0,0,0,-22,-13,2,-2,3,0,-13,1,1,11.6,65.4,-53.8,3,5,-2,1
15097,13479,252,256,7,2,2,7,5,0,1,0,34,23,2,2,1,0,1,0,1,0,0,0,1618,-4,5,-5,5,0,11,0,1,21.6,20.8,0.8,5,5,0,1
18039,14771,232,231,14,6,6,14,17,7,0,0,34,20,6,5,2,0,0,1,0,0,0,0,3268,1,8,-8,10,0,14,1,2,36.4,24.8,11.6,3,4,-1,1
17591,15258,260,207,11,7,7,11,11,11,0,0,36,16,3,3,2,0,1,0,0,0,0,0,2333,53,4,-4,0,0,20,0,2,29,17.4,11.6,5,3,2,0
15541,16899,243,246,7,10,10,8,6,13,0,0,15,19,1,0,1,1,1,0,0,0,0,0,-1358,-3,-3,2,-7,0,-4,1,0,37.2,26.2,11,5,5,0,1
15099,17498,255,254,5,10,10,5,7,19,0,1,18,20,1,6,0,1,1,0,0,1,0,0,-2399,1,-5,5,-12,0,-2,-5,-1,36.2,28.6,7.6,3,4,-1,0
15117,16129,261,247,4,8,8,5,4,10,0,0,16,16,4,5,0,0,0,1,0,0,0,0,-1012,14,-4,3,-6,0,0,-1,0,27.8,33.4,-5.6,5,4,1,0
17711,16137,247,235,12,7,7,12,15,16,0,0,26,15,2,2,1,1,1,0,0,0,0,0,1574,12,5,-5,-1,0,11,0,0,23.2,47.4,-24.2,4,5,-1,0
15496,14972,260,268,4,4,4,4,8,4,0,0,17,19,4,1,3,2,1,0,0,0,0,0,524,-8,0,0,4,0,-2,3,1,81.4,39.6,41.8,3,3,0,0
15335,15150,277,280,5,4,4,5,3,6,0,0,20,16,6,1,0,0,1,0,0,0,0,0,185,-3,1,-1,-3,0,4,5,0,88,20.8,67.2,5,4,1,0
15865,15875,274,283,8,5,5,8,7,8,1,0,13,16,2,2,0,3,1,0,1,0,0,0,-10,-9,3,-3,-1,0,-3,0,-3,41,52.4,-11.4,4,4,0,1
14228,14688,279,301,3,3,4,3,3,1,0,1,17,19,4,3,0,2,0,1,0,1,0,0,-460,-22,0,1,2,0,-2,1,-2,24,26.8,-2.8,4,4,0,1
16412,12937,262,266,9,0,0,9,13,0,0,0,22,15,2,4,0,0,1,0,0,0,0,0,3475,-4,9,-9,13,0,7,-2,0,22.8,30.2,-7.4,5,5,0,1
13088,14504,226,285,3,2,2,3,1,3,0,1,15,18,0,3,0,2,1,0,0,1,0,0,-1416,-59,1,-1,-2,0,-3,-3,-2,59.2,21.6,37.6,3,4,-1,0
14665,14659,238,233,6,6,6,6,5,5,0,1,16,12,3,3,0,2,0,1,0,1,0,0,6,5,0,0,0,0,4,0,-2,65.4,31,34.4,3,4,-1,0
14643,15112,276,285,4,5,5,4,4,6,0,1,23,17,1,5,0,0,0,1,0,1,0,0,-469,-9,-1,1,-2,0,6,-4,0,44,17.2,26.8,5,4,1,0
16767,13636,279,238,8,3,3,8,4,4,1,0,17,35,3,4,2,0,1,0,1,0,0,0,3131,41,5,-5,0,0,-18,-1,2,120.4,35.8,84.6,4,4,0,1
15579,13879,263,244,7,3,3,7,6,4,0,0,15,22,4,2,1,1,1,0,0,0,0,0,1700,19,4,-4,2,0,-7,2,0,73.8,29.4,44.4,5,2,3,0
16208,14152,276,276,7,2,2,7,12,1,0,0,31,17,3,3,0,1,1,0,0,0,0,0,2056,0,5,-5,11,0,14,0,-1,12.8,87.2,-74.4,3,4,-1,1
14574,14112,278,285,3,2,2,3,5,4,0,0,20,18,1,7,1,0,1,0,0,0,0,0,462,-7,1,-1,1,0,2,-6,1,28.8,9.4,19.4,5,3,2,0
15075,15047,234,261,5,5,5,5,3,7,0,1,36,16,2,2,2,1,1,0,0,1,0,0,28,-27,0,0,-4,0,20,0,1,44.2,61.6,-17.4,4,4,0,1
14339,14658,251,250,3,4,4,3,5,9,0,1,24,35,5,7,1,1,1,0,0,1,0,0,-319,1,-1,1,-4,0,-11,-2,0,17,66.8,-49.8,1,3,-2,1
14463,16931,268,275,4,9,9,4,3,10,1,0,22,14,2,6,0,0,0,1,1,0,0,0,-2468,-7,-5,5,-7,0,8,-4,0,12.2,53.6,-41.4,2,5,-3,0
16660,14861,234,228,9,7,8,9,11,5,0,1,115,34,3,3,1,1,1,0,0,1,0,0,1799,6,2,-1,6,0,81,0,0,35.6,18.8,16.8,4,2,2,1
17456,13763,298,255,9,3,4,9,6,0,1,0,16,16,3,3,1,0,1,0,1,0,0,0,3693,43,6,-5,6,0,0,0,1,36.2,41.8,-5.6,3,4,-1,1
17563,14335,260,259,11,3,3,11,14,3,1,0,16,27,5,1,3,1,1,0,1,0,0,0,3228,1,8,-8,11,0,-11,4,2,14.4,8,6.4,4,4,0,1
15091,15922,258,261,6,7,7,6,3,7,1,0,20,17,3,7,1,0,1,0,1,0,0,0,-831,-3,-1,1,-4,0,3,-4,1,19.4,44.4,-25,5,4,1,1
13311,15745,249,270,2,7,7,2,3,11,0,1,15,18,3,0,0,1,0,1,0,1,0,0,-2434,-21,-5,5,-8,0,-3,3,-1,25,14.8,10.2,5,4,1,0
13006,13947,288,289,0,1,1,0,0,0,1,0,12,20,8,2,0,0,0,1,1,0,0,0,-941,-1,-1,1,0,0,-8,6,0,9,78,-69,3,5,-2,0
13952,15763,252,285,2,6,6,2,2,5,0,0,32,16,3,3,0,1,0,1,0,0,0,0,-1811,-33,-4,4,-3,0,16,0,-1,59.2,20,39.2,5,5,0,0
16214,15482,266,221,6,8,8,6,7,7,0,1,14,17,2,1,2,0,1,0,0,1,0,0,732,45,-2,2,0,0,-3,1,2,30.6,8.8,21.8,3,2,1,1
12961,16646,236,278,1,8,8,1,1,12,0,0,31,20,2,8,1,1,0,1,0,0,0,0,-3685,-42,-7,7,-11,0,11,-6,0,37,16,21,5,3,2,0
16381,15814,222,258,9,8,8,9,12,4,0,1,36,19,3,6,0,2,0,1,0,1,0,0,567,-36,1,-1,8,0,17,-3,-2,21.8,20.8,1,4,4,0,0
15628,13804,290,255,5,2,2,5,6,1,0,0,24,15,3,3,1,0,0,1,0,0,0,0,1824,35,3,-3,5,0,9,0,1,28.2,64.4,-36.2,2,4,-2,1
15731,15073,247,262,7,5,5,7,8,6,0,1,18,18,3,4,0,1,0,1,0,1,0,0,658,-15,2,-2,2,0,0,-1,-1,15.6,18.2,-2.6,4,5,-1,0
15163,15661,272,280,5,5,5,5,5,5,1,0,14,15,5,2,0,0,1,0,1,0,0,0,-498,-8,0,0,0,0,-1,3,0,35.6,165.6,-130,3,4,-1,1
15489,15183,243,253,8,6,6,8,4,9,0,0,15,18,5,1,2,0,0,1,0,0,0,0,306,-10,2,-2,-5,0,-3,4,2,7.4,69.4,-62,2,3,-1,1
16263,15561,279,272,7,5,5,7,7,8,1,0,20,19,8,6,2,0,1,0,1,0,0,0,702,7,2,-2,-1,0,1,2,2,45.6,55.4,-9.8,4,5,-1,0
14370,17172,247,288,4,9,10,5,3,11,0,0,13,16,2,2,0,0,0,1,0,0,0,0,-2802,-41,-5,5,-8,0,-3,0,0,59.8,25.6,34.2,4,4,0,0
15473,14526,279,265,5,4,4,5,7,2,0,1,15,9,2,2,1,1,1,0,0,1,0,0,947,14,1,-1,5,0,6,0,0,21.6,31,-9.4,4,4,0,0
16025,13887,296,271,5,2,2,5,6,1,0,1,16,17,6,4,0,1,1,0,0,1,0,0,2138,25,3,-3,5,0,-1,2,-1,17.4,26,-8.6,4,4,0,0
16383,13952,270,276,8,1,1,8,6,1,0,0,14,30,2,3,1,1,1,0,0,0,0,0,2431,-6,7,-7,5,0,-16,-1,0,91.8,37.6,54.2,5,4,1,1
14802,14393,284,257,3,3,3,3,5,2,0,1,16,15,2,3,0,0,1,0,0,1,0,0,409,27,0,0,3,0,1,-1,0,8.6,8.4,0.2,3,4,-1,0
14863,16452,283,241,3,9,9,3,2,14,0,1,17,17,2,2,0,0,1,0,0,1,0,0,-1589,42,-6,6,-12,0,0,0,0,38.8,96.8,-58,4,4,0,0
15804,17627,209,263,8,11,11,8,8,17,0,1,21,16,3,8,1,1,1,0,0,1,0,0,-1823,-54,-3,3,-9,0,5,-5,0,38.4,11.2,27.2,5,4,1,0
14363,14287,229,268,6,4,4,6,6,6,0,0,12,18,3,2,0,0,1,0,0,0,0,0,76,-39,2,-2,0,0,-6,1,0,46,7.6,38.4,4,3,1,1
14928,14116,276,278,5,3,3,5,2,1,0,1,39,17,2,5,0,0,1,0,0,1,0,0,812,-2,2,-2,1,0,22,-3,0,9.6,11.6,-2,5,4,1,0
14477,17669,252,296,4,9,9,4,3,14,0,0,17,18,3,4,0,2,0,1,0,0,0,0,-3192,-44,-5,5,-11,0,-1,-1,-2,8.4,17,-8.6,4,2,2,0
15671,16819,248,285,6,8,8,6,10,8,0,1,44,13,2,3,0,1,0,1,0,1,0,0,-1148,-37,-2,2,2,0,31,-1,-1,112.4,25.2,87.2,5,4,1,0
14233,16770,259,282,3,7,7,3,4,8,0,0,27,18,2,4,1,0,1,0,0,0,0,0,-2537,-23,-4,4,-4,0,9,-2,1,10.6,21.8,-11.2,2,4,-2,1
16235,14962,288,282,6,4,5,6,5,5,0,0,35,15,3,4,0,0,0,1,0,0,0,0,1273,6,2,-1,0,0,20,-1,0,19.6,92.6,-73,3,5,-2,0
14767,14862,265,280,5,3,3,5,4,5,0,0,43,112,2,2,0,2,0,1,0,0,0,0,-95,-15,2,-2,-1,0,-69,0,-2,43.6,44.8,-1.2,4,4,0,0
18940,15638,243,190,15,10,10,15,22,14,0,0,20,11,2,2,1,1,0,1,0,0,0,0,3302,53,5,-5,8,0,9,0,0,15.8,52.2,-36.4,5,4,1,1
13870,15507,259,287,2,5,5,2,4,7,0,0,15,17,4,6,0,0,0,1,0,0,0,0,-1637,-28,-3,3,-3,0,-2,-2,0,9,12,-3,4,3,1,0
15013,16601,275,276,5,8,8,5,4,13,1,0,18,16,2,5,0,0,1,0,1,0,0,0,-1588,-1,-3,3,-9,0,2,-3,0,74,12.2,61.8,5,5,0,0
15325,16583,256,251,4,9,9,4,5,12,0,0,11,17,5,2,2,0,1,0,0,0,0,0,-1258,5,-5,5,-7,0,-6,3,2,31.2,11.2,20,3,1,2,1
13751,16543,271,253,2,8,8,2,4,13,0,1,18,36,4,6,0,0,0,1,0,1,0,0,-2792,18,-6,6,-9,0,-18,-2,0,40,15.4,24.6,4,5,-1,0
15543,14059,266,279,7,2,2,7,5,1,0,0,16,15,3,3,0,0,1,0,0,0,0,0,1484,-13,5,-5,4,0,1,0,0,8.2,17.6,-9.4,3,4,-1,0
14282,16804,249,265,3,8,8,3,4,11,0,1,14,18,2,2,0,3,0,1,0,1,0,0,-2522,-16,-5,5,-7,0,-4,0,-3,57.4,19.6,37.8,3,5,-2,0
15605,14399,279,235,6,4,4,6,9,6,0,0,46,17,4,2,0,1,1,0,0,0,0,0,1206,44,2,-2,3,0,29,2,-1,52.4,29.4,23,3,3,0,1
15154,17882,238,250,5,13,13,6,6,18,0,0,16,28,3,3,1,0,0,1,0,0,0,0,-2728,-12,-8,7,-12,0,-12,0,1,45.6,26.4,19.2,5,4,1,0
16097,15921,249,255,9,7,7,10,9,7,0,0,16,18,2,4,0,0,0,1,0,0,0,0,176,-6,2,-3,2,0,-2,-2,0,15.6,20.4,-4.8,4,3,1,1
15832,17076,283,245,6,10,10,6,9,13,1,0,14,20,3,2,0,0,0,1,1,0,0,0,-1244,38,-4,4,-4,0,-6,1,0,41,44.2,-3.2,3,4,-1,0
16745,15610,278,269,8,5,5,8,9,7,0,0,19,19,2,4,0,1,0,1,0,0,0,0,1135,9,3,-3,2,0,0,-2,-1,8.8,39.6,-30.8,3,4,-1,1
15281,14215,262,243,6,4,4,7,6,4,0,0,35,29,6,2,0,0,0,1,0,0,0,0,1066,19,2,-3,2,0,6,4,0,22.2,16.6,5.6,5,4,1,1
15546,13727,279,263,4,2,2,4,4,3,0,0,20,16,5,7,0,0,1,0,0,0,0,0,1819,16,2,-2,1,0,4,-2,0,14,6,8,3,3,0,1
15549,15313,282,272,4,6,6,4,5,8,0,1,78,42,3,5,0,2,0,1,0,1,0,0,236,10,-2,2,-3,0,36,-2,-2,57.2,26.2,31,5,4,1,0
13326,16064,259,289,1,7,7,1,0,7,0,1,16,13,2,3,0,0,0,1,0,1,0,0,-2738,-30,-6,6,-7,0,3,-1,0,26,11.8,14.2,3,4,-1,0
14107,15762,268,233,2,8,8,2,2,16,0,0,56,36,3,5,1,0,0,1,0,0,0,0,-1655,35,-6,6,-14,0,20,-2,1,25.8,48.4,-22.6,5,5,0,0
15378,16075,269,265,6,6,6,6,10,6,0,0,13,11,2,2,0,1,1,0,0,0,0,0,-697,4,0,0,4,0,2,0,-1,139.8,41.2,98.6,5,4,1,0
16808,15532,238,268,10,5,5,10,11,4,0,0,18,18,4,4,1,1,1,0,0,0,0,0,1276,-30,5,-5,7,0,0,0,0,30.6,15.2,15.4,2,4,-2,1
14748,14162,199,235,6,3,3,6,12,8,1,0,14,16,3,4,2,0,1,0,1,0,0,0,586,-36,3,-3,4,0,-2,-1,2,26.4,24.4,2,4,3,1,0
15952,17181,219,273,9,9,9,9,9,6,1,0,15,199,1,5,0,3,0,1,1,0,0,0,-1229,-54,0,0,3,0,-184,-4,-3,147,16,131,4,3,1,0
14348,14395,279,269,2,3,3,2,1,5,0,0,16,16,1,3,1,1,1,0,0,0,0,0,-47,10,-1,1,-4,0,0,-2,0,84.8,80,4.8,3,4,-1,1
15895,15143,260,260,7,5,6,7,9,6,0,0,32,35,2,3,0,0,1,0,0,0,0,0,752,0,2,-1,3,0,-3,-1,0,13.6,75,-61.4,3,5,-2,1
14699,15151,274,297,4,3,3,4,3,4,0,0,15,17,2,5,0,0,1,0,0,0,0,0,-452,-23,1,-1,-1,0,-2,-3,0,131.8,78,53.8,5,4,1,0
15940,15810,286,280,6,8,8,6,3,7,1,0,14,19,2,5,0,0,0,1,1,0,0,0,130,6,-2,2,-4,0,-5,-3,0,19.4,22.4,-3,4,4,0,0
15845,15382,290,257,6,6,6,6,6,5,1,0,23,27,2,1,0,0,1,0,1,0,0,0,463,33,0,0,1,0,-4,1,0,33.4,18.6,14.8,5,4,1,1
16331,12850,237,230,9,1,1,9,9,1,0,0,37,12,7,4,1,0,1,0,0,0,0,0,3481,7,8,-8,8,0,25,3,1,18.4,16.6,1.8,5,4,1,1
15107,16170,286,274,4,7,7,4,7,8,0,0,52,34,4,5,0,2,1,0,0,0,0,0,-1063,12,-3,3,-1,0,18,-1,-2,20.4,30.4,-10,4,5,-1,0
14209,14458,269,270,3,4,4,3,5,1,0,0,21,15,3,1,0,0,1,0,0,0,0,0,-249,-1,-1,1,4,0,6,2,0,36.4,21.2,15.2,3,5,-2,1
15949,17519,245,258,6,10,10,6,11,17,0,0,30,24,8,1,0,2,0,1,0,0,0,0,-1570,-13,-4,4,-6,0,6,7,-2,76.8,10.6,66.2,5,4,1,0
14141,15921,258,281,4,5,5,4,2,8,1,0,15,13,3,4,0,2,0,1,1,0,0,0,-1780,-23,-1,1,-6,0,2,-1,-2,125.2,50.4,74.8,5,5,0,0
15961,17028,241,221,7,11,11,7,10,9,1,0,12,14,2,0,0,1,0,1,1,0,0,0,-1067,20,-4,4,1,0,-2,2,-1,14.4,36,-21.6,3,5,-2,0
15893,14104,293,296,6,2,2,6,8,3,0,1,17,14,0,1,0,0,0,1,0,1,0,0,1789,-3,4,-4,5,0,3,-1,0,103,43.2,59.8,3,4,-1,1
14697,17908,250,260,3,12,12,3,4,16,0,0,17,116,4,4,1,2,0,1,0,0,0,0,-3211,-10,-9,9,-12,0,-99,0,-1,34.6,94.8,-60.2,4,5,-1,0
12929,16255,263,279,0,7,7,0,0,12,0,1,107,15,0,4,1,1,0,1,0,1,0,0,-3326,-16,-7,7,-12,0,92,-4,0,14,34,-20,4,2,2,0
13304,15151,244,263,2,6,6,2,2,5,0,1,13,15,3,4,0,0,1,0,0,1,0,0,-1847,-19,-4,4,-3,0,-2,-1,0,73.8,30.6,43.2,4,3,1,0
14723,16048,242,252,4,8,9,4,5,7,1,0,17,26,7,2,0,1,0,1,1,0,0,0,-1325,-10,-4,5,-2,0,-9,5,-1,59.2,18.6,40.6,5,3,2,1
16554,15343,254,249,10,6,6,10,6,15,0,0,18,16,6,2,1,0,1,0,0,0,0,0,1211,5,4,-4,-9,0,2,4,1,10.6,12.4,-1.8,3,4,-1,1
16119,15324,255,235,9,8,8,9,5,7,1,0,113,16,3,2,0,1,0,1,1,0,0,0,795,20,1,-1,-2,0,97,1,-1,185.4,10.4,175,4,3,1,0
13595,15790,185,278,5,4,4,5,7,6,0,0,13,13,1,2,0,1,1,0,0,0,0,0,-2195,-93,1,-1,1,0,0,-1,-1,37.2,19.8,17.4,4,5,-1,1
14183,17154,244,250,5,11,11,5,2,6,0,0,22,16,2,3,0,2,0,1,0,0,0,0,-2971,-6,-6,6,-4,0,6,-1,-2,31.6,74.4,-42.8,5,3,2,1
14024,17788,238,253,3,13,13,3,3,12,0,0,15,15,0,3,0,1,1,0,0,0,0,0,-3764,-15,-10,10,-9,0,0,-3,-1,21.8,10,11.8,5,3,2,1
14518,15212,258,253,3,6,6,3,8,9,0,1,17,27,1,2,2,1,0,1,0,1,0,0,-694,5,-3,3,-1,0,-10,-1,1,6.6,39.2,-32.6,3,3,0,0
14524,13550,286,260,3,2,2,3,4,3,0,1,25,17,0,4,1,0,0,1,0,1,0,0,974,26,1,-1,1,0,8,-4,1,58.8,58.8,0,3,2,1,1
12724,16816,220,293,1,7,7,1,1,5,0,0,15,16,0,6,0,4,0,1,0,0,0,0,-4092,-73,-6,6,-4,0,-1,-6,-4,37,30.4,6.6,5,5,0,0
15460,13422,275,282,5,1,1,5,6,0,0,0,17,18,1,1,0,0,0,1,0,0,0,0,2038,-7,4,-4,6,0,-1,0,0,54.4,22.8,31.6,5,4,1,1
17842,15828,270,259,11,7,7,11,22,11,0,1,14,14,2,3,1,2,0,1,0,1,0,0,2014,11,4,-4,11,0,0,-1,-1,11.2,30.6,-19.4,4,5,-1,0
15376,14106,237,212,8,6,6,8,5,4,0,0,13,16,2,2,1,0,1,0,0,0,0,0,1270,25,2,-2,1,0,-3,0,1,6.2,5.6,0.6,2,2,0,0
14364,13900,265,274,4,2,2,4,4,2,1,0,13,13,0,4,0,0,1,0,1,0,0,0,464,-9,2,-2,2,0,0,-4,0,27.4,8.8,18.6,3,2,1,1
14363,13842,248,239,4,3,3,4,3,3,1,0,15,17,6,2,1,1,1,0,1,0,0,0,521,9,1,-1,0,0,-2,4,0,60.6,90.2,-29.6,3,3,0,1
14268,14437,247,255,4,4,4,4,6,0,0,0,10,17,2,1,0,1,1,0,0,0,0,0,-169,-8,0,0,6,0,-7,1,-1,79.2,27.2,52,5,4,1,0
15644,15075,204,236,9,7,7,9,8,4,0,0,14,11,0,2,2,1,1,0,0,0,0,0,569,-32,2,-2,4,0,3,-2,1,10.8,8.2,2.6,1,2,-1,1
15464,15921,266,264,6,6,6,6,7,7,0,0,14,14,1,2,0,0,1,0,0,0,0,0,-457,2,0,0,0,0,0,-1,0,33.4,113.8,-80.4,3,5,-2,0
15816,18294,246,256,7,13,13,8,5,9,0,0,44,15,3,1,1,1,0,1,0,0,0,0,-2478,-10,-6,5,-4,0,29,2,0,72.4,31.2,41.2,3,5,-2,0
15635,14831,268,276,6,4,4,6,5,2,0,0,19,26,2,4,0,0,0,1,0,0,0,0,804,-8,2,-2,3,0,-7,-2,0,11.4,55.8,-44.4,2,2,0,1
14780,17476,212,276,6,11,11,6,8,10,0,1,34,19,1,3,0,2,0,1,0,1,0,0,-2696,-64,-5,5,-2,0,15,-2,-2,39.4,57.8,-18.4,4,4,0,0
14766,15529,257,274,4,5,5,4,4,9,0,0,19,15,4,3,0,0,1,0,0,0,0,0,-763,-17,-1,1,-5,0,4,1,0,10.2,57.4,-47.2,2,3,-1,0
13218,16817,204,259,4,8,8,4,3,7,0,0,14,16,0,2,0,3,0,1,0,0,0,0,-3599,-55,-4,4,-4,0,-2,-2,-3,5.4,25.2,-19.8,1,5,-4,0
15917,15580,262,258,7,6,6,7,7,9,0,0,33,13,4,3,1,0,0,1,0,0,0,0,337,4,1,-1,-2,0,20,1,1,26.2,28.6,-2.4,3,4,-1,1
13488,16815,254,302,2,8,8,2,1,6,0,0,13,17,4,1,0,0,1,0,0,0,0,0,-3327,-48,-6,6,-5,0,-4,3,0,18.4,67.2,-48.8,3,4,-1,0
15144,16031,250,259,6,7,7,6,7,10,0,0,19,19,0,4,0,0,0,1,0,0,0,0,-887,-9,-1,1,-3,0,0,-4,0,21.6,17.4,4.2,2,4,-2,0
17172,14755,253,253,10,5,5,10,7,5,0,0,13,20,0,3,1,0,1,0,0,0,0,0,2417,0,5,-5,2,0,-7,-3,1,4,5.6,-1.6,1,2,-1,1
14270,15889,244,246,3,8,8,3,5,11,0,0,16,14,2,6,0,0,0,1,0,0,0,0,-1619,-2,-5,5,-6,0,2,-4,0,14.4,32,-17.6,4,4,0,0
5611,6850,72,96,0,2,2,0,0,1,0,0,12,5,0,0,0,1,0,1,0,0,0,0,-1239,-24,-2,2,-1,0,7,0,-1,71.2,28.8,42.4,5,4,1,0
15280,15626,269,258,5,6,6,5,5,10,1,0,20,14,1,5,0,1,0,1,1,0,0,0,-346,11,-1,1,-5,0,6,-4,-1,10.6,16,-5.4,3,5,-2,1
13456,15933,278,295,1,6,6,1,1,5,0,1,36,22,4,4,0,1,0,1,0,1,0,0,-2477,-17,-5,5,-4,0,14,0,-1,129.8,15.6,114.2,4,4,0,0
13926,15072,269,256,3,4,4,4,2,9,0,0,17,22,1,1,0,0,0,1,0,0,0,0,-1146,13,-1,0,-7,0,-5,0,0,83.8,45.2,38.6,3,3,0,0
17117,13914,287,260,9,2,2,9,12,3,0,1,20,17,3,3,0,0,0,1,0,1,0,0,3203,27,7,-7,9,0,3,0,0,46,52.2,-6.2,4,4,0,1
16292,14213,274,240,7,5,5,7,7,7,0,1,17,15,4,2,2,0,1,0,0,1,0,0,2079,34,2,-2,0,0,2,2,2,29.6,65.6,-36,4,5,-1,1
15391,15457,279,218,5,8,8,5,2,10,0,1,16,15,5,3,0,0,1,0,0,1,0,0,-66,61,-3,3,-8,0,1,2,0,34.2,30.4,3.8,5,3,2,1
14460,16212,229,250,5,9,9,5,6,11,1,0,23,26,3,4,1,1,0,1,1,0,0,0,-1752,-21,-4,4,-5,0,-3,-1,0,80.4,58.8,21.6,3,3,0,0
17132,13080,286,222,8,2,2,8,9,1,0,0,15,11,2,1,2,0,0,1,0,0,0,0,4052,64,6,-6,8,0,4,1,2,40.8,69.2,-28.4,4,5,-1,1
14463,16814,207,242,6,11,11,6,8,5,0,1,12,18,5,2,1,2,0,1,0,1,0,0,-2351,-35,-5,5,3,0,-6,3,-1,18,25.8,-7.8,3,4,-1,1
14201,15828,304,299,1,7,7,1,3,14,0,1,14,17,3,1,2,0,0,1,0,1,0,0,-1627,5,-6,6,-11,0,-3,2,2,41.2,57.4,-16.2,5,4,1,0
16109,16228,253,257,7,7,7,7,6,7,0,0,28,15,1,3,0,2,0,1,0,0,0,0,-119,-4,0,0,-1,0,13,-2,-2,44.8,26.6,18.2,2,5,-3,0
13319,16609,216,263,4,10,10,4,1,8,0,0,27,19,5,3,0,1,0,1,0,0,0,0,-3290,-47,-6,6,-7,0,8,2,-1,79.6,13,66.6,5,4,1,0
14280,15918,274,263,2,7,7,2,3,8,0,0,34,11,3,1,1,2,0,1,0,0,0,0,-1638,11,-5,5,-5,0,23,2,-1,132,31.4,100.6,3,4,-1,0
17748,15614,237,240,12,6,6,12,19,10,0,0,23,19,4,2,1,0,0,1,0,0,0,0,2134,-3,6,-6,9,0,4,2,1,32.2,37.8,-5.6,4,4,0,1
14002,17708,261,262,2,11,11,2,1,15,0,0,14,125,1,1,2,1,1,0,0,0,0,0,-3706,-1,-9,9,-14,0,-111,0,1,12.8,28.4,-15.6,4,3,1,0
16167,14133,270,250,8,3,3,8,11,2,1,0,13,46,2,0,1,0,1,0,1,0,0,0,2034,20,5,-5,9,0,-33,2,1,34.8,145,-110.2,4,5,-1,1
15198,16316,230,275,8,8,8,8,9,4,0,0,14,41,1,2,2,3,1,0,0,0,0,0,-1118,-45,0,0,5,0,-27,-1,-1,12.8,43.8,-31,4,4,0,0
17599,16639,230,260,11,9,9,11,15,7,0,0,16,12,1,1,0,0,0,1,0,0,0,0,960,-30,2,-2,8,0,4,0,0,24.2,27.4,-3.2,5,4,1,1
15424,13634,244,233,7,3,3,7,13,3,0,0,16,14,4,2,0,0,1,0,0,0,0,0,1790,11,4,-4,10,0,2,2,0,16.8,22,-5.2,4,2,2,1
15406,15195,269,247,5,6,6,5,7,8,0,0,16,18,3,1,1,0,0,1,0,0,0,0,211,22,-1,1,-1,0,-2,2,1,30.6,39.8,-9.2,4,4,0,1
16224,14598,249,192,8,7,7,8,8,5,0,0,10,15,2,2,1,1,0,1,0,0,0,0,1626,57,1,-1,3,0,-5,0,0,49.4,8.4,41,4,2,2,1
14706,15867,263,248,5,7,7,5,2,8,0,0,14,12,2,3,0,1,0,1,0,0,0,0,-1161,15,-2,2,-6,0,2,-1,-1,134.2,47.4,86.8,5,5,0,1
16382,16485,271,236,8,9,9,8,6,9,0,0,9,15,2,3,1,1,1,0,0,0,0,0,-103,35,-1,1,-3,0,-6,-1,0,29.2,42.2,-13,5,4,1,1
14548,14715,274,255,4,4,4,5,4,5,0,0,14,38,1,2,0,0,1,0,0,0,0,0,-167,19,0,-1,-1,0,-24,-1,0,53,29,24,4,5,-1,0
18113,14503,270,219,13,4,4,13,17,8,1,0,29,11,3,2,4,1,1,0,1,0,0,0,3610,51,9,-9,9,0,18,1,3,33.4,32.8,0.6,4,4,0,1
17062,15735,246,247,10,6,6,11,14,4,0,0,16,273,3,2,2,0,0,1,0,0,0,0,1327,-1,4,-5,10,0,-257,1,2,46.6,96.8,-50.2,4,3,1,1
14248,16141,244,261,4,9,9,4,5,6,0,0,14,15,3,2,0,1,0,1,0,0,0,0,-1893,-17,-5,5,-1,0,-1,1,-1,4.4,3.6,0.8,1,1,0,1
15690,16668,229,224,7,10,10,7,7,8,1,0,18,17,1,2,1,1,1,0,1,0,0,0,-978,5,-3,3,-1,0,1,-1,0,89.6,56.4,33.2,4,3,1,0
13888,15338,239,255,4,6,6,4,3,11,0,1,18,16,1,4,1,1,0,1,0,1,0,0,-1450,-16,-2,2,-8,0,2,-3,0,102.4,57,45.4,5,5,0,0
14647,14853,257,277,4,4,4,4,2,3,0,1,17,54,3,2,2,1,1,0,0,1,0,0,-206,-20,0,0,-1,0,-37,1,1,126.4,14.4,112,4,4,0,0
14832,14538,270,269,4,3,3,4,4,6,1,0,14,16,2,2,0,0,0,1,1,0,0,0,294,1,1,-1,-2,0,-2,0,0,58.8,52.8,6,5,4,1,1
14237,13941,248,242,4,3,3,4,5,1,1,0,15,23,1,1,2,2,0,1,1,0,0,0,296,6,1,-1,4,0,-8,0,0,77.2,15.2,62,5,3,2,0
16176,14543,277,263,6,4,4,6,6,3,0,0,14,18,4,4,1,0,1,0,0,0,0,0,1633,14,2,-2,3,0,-4,0,1,15.2,14.2,1,4,2,2,0
15825,16917,251,279,8,8,8,8,3,13,0,0,22,30,1,5,0,1,0,1,0,0,0,0,-1092,-28,0,0,-10,0,-8,-4,-1,36.4,45.8,-9.4,4,4,0,0
13839,14133,248,265,3,4,4,3,3,1,0,0,90,22,1,2,0,0,0,1,0,0,0,0,-294,-17,-1,1,2,0,68,-1,0,60.2,53.8,6.4,4,4,0,1
18767,14408,293,223,11,5,5,11,16,5,0,0,16,18,3,1,2,1,0,1,0,0,0,0,4359,70,6,-6,11,0,-2,2,1,86.8,61,25.8,3,4,-1,0
13435,16905,234,273,3,9,9,3,5,7,0,1,17,17,1,2,0,3,1,0,0,1,0,0,-3470,-39,-6,6,-2,0,0,-1,-3,61.2,13.8,47.4,4,3,1,0
14324,16255,265,248,3,8,8,3,3,12,0,1,17,18,4,4,1,1,0,1,0,1,0,0,-1931,17,-5,5,-9,0,-1,0,0,8,15.6,-7.6,2,5,-3,0
12569,16010,203,262,3,7,7,3,1,7,0,1,15,23,1,3,0,1,1,0,0,1,0,0,-3441,-59,-4,4,-6,0,-8,-2,-1,40,32.8,7.2,3,4,-1,0
16512,16817,260,207,9,12,12,9,7,15,0,0,34,18,4,6,3,1,1,0,0,0,0,0,-305,53,-3,3,-8,0,16,-2,2,22.8,79.2,-56.4,4,4,0,1
17545,14216,266,249,11,4,4,11,9,4,0,0,117,14,1,3,2,1,1,0,0,0,0,0,3329,17,7,-7,5,0,103,-2,1,54.6,11.4,43.2,5,2,3,1
14132,15664,253,290,3,5,5,3,3,4,0,1,18,17,1,2,0,0,0,1,0,1,0,0,-1532,-37,-2,2,-1,0,1,-1,0,39,15,24,4,4,0,1
15549,16531,252,262,5,9,9,6,8,7,0,0,16,18,2,2,0,1,0,1,0,0,0,0,-982,-10,-4,3,1,0,-2,0,-1,13,86.2,-73.2,4,5,-1,0
14584,16840,274,244,3,10,10,3,3,24,0,0,12,20,5,2,0,1,0,1,0,0,0,0,-2256,30,-7,7,-21,0,-8,3,-1,32.6,109,-76.4,4,3,1,0
2586,2546,2,0,0,0,0,0,0,0,0,0,1,4,0,0,0,0,0,0,0,0,0,0,40,2,0,0,0,0,-3,0,0,19.2,60.4,-41.2,3,4,-1,0
16724,13561,272,260,7,3,3,7,5,1,0,0,55,18,6,4,3,0,1,0,0,0,0,0,3163,12,4,-4,4,0,37,2,3,54.6,6.8,47.8,4,3,1,1
15548,15239,250,235,8,6,6,8,6,6,0,0,10,20,4,1,0,0,1,0,0,0,0,0,309,15,2,-2,0,0,-10,3,0,33.2,5,28.2,4,2,2,0
14101,17312,253,249,3,11,11,3,2,22,0,0,16,21,3,3,0,0,1,0,0,0,0,0,-3211,4,-8,8,-20,0,-5,0,0,34.6,35.2,-0.6,4,5,-1,0
16086,14446,262,237,8,5,5,8,6,7,0,0,16,20,4,0,1,0,1,0,0,0,0,0,1640,25,3,-3,-1,0,-4,4,1,43,18.8,24.2,4,3,1,1
16626,14969,259,226,10,6,6,10,5,8,0,0,17,17,5,1,0,1,1,0,0,0,0,0,1657,33,4,-4,-3,0,0,4,-1,65,6.6,58.4,5,2,3,1
18207,15145,257,268,12,5,5,12,19,5,0,0,29,11,1,3,2,0,1,0,0,0,0,0,3062,-11,7,-7,14,0,18,-2,2,61.6,79.4,-17.8,4,5,-1,1
15770,15561,282,228,5,7,7,5,7,7,0,0,16,15,2,2,1,0,0,1,0,0,0,0,209,54,-2,2,0,0,1,0,1,19.2,32.2,-13,3,5,-2,1
15324,15152,275,262,5,5,5,5,12,10,0,0,17,22,0,2,0,1,0,1,0,0,0,0,172,13,0,0,2,0,-5,-2,-1,14.4,97.6,-83.2,2,4,-2,1
16429,16087,301,256,5,8,8,5,5,12,0,1,19,103,5,6,1,0,0,1,0,1,0,0,342,45,-3,3,-7,0,-84,-1,1,26.8,27.6,-0.8,5,4,1,1
16501,15512,249,260,8,6,6,8,12,7,0,0,10,17,5,2,0,0,1,0,0,0,0,0,989,-11,2,-2,5,0,-7,3,0,59.6,82.8,-23.2,4,4,0,1
17202,15752,244,254,11,7,7,11,15,9,0,0,17,20,4,2,0,1,1,0,0,0,0,0,1450,-10,4,-4,6,0,-3,2,-1,76.6,14.2,62.4,4,4,0,1
17302,15673,267,282,9,5,5,9,13,4,0,1,17,14,2,5,0,2,1,0,0,1,0,0,1629,-15,4,-4,9,0,3,-3,-2,28.8,41,-12.2,4,5,-1,0
16892,14196,269,246,8,4,4,8,9,2,0,0,38,19,3,1,0,1,0,1,0,0,0,0,2696,23,4,-4,7,0,19,2,-1,91.2,29.2,62,4,4,0,1
17210,16058,254,218,11,8,8,11,11,12,0,0,20,38,5,2,0,0,1,0,0,0,0,0,1152,36,3,-3,-1,0,-18,3,0,70.2,10.8,59.4,3,2,1,1
16003,15312,275,257,6,7,7,6,6,3,0,0,17,15,6,3,1,1,1,0,0,0,0,0,691,18,-1,1,3,0,2,3,0,43,114.6,-71.6,4,5,-1,0
14655,15118,247,267,4,5,5,4,5,3,0,0,10,15,0,2,1,1,0,1,0,0,0,0,-463,-20,-1,1,2,0,-5,-2,0,84.2,122.2,-38,4,5,-1,0
13588,14941,250,296,2,3,3,2,3,3,0,0,27,18,4,5,0,0,1,0,0,0,0,0,-1353,-46,-1,1,0,0,9,-1,0,77,17.8,59.2,4,3,1,0
14661,14625,290,273,4,4,4,4,1,3,0,0,15,27,5,3,0,0,0,1,0,0,0,0,36,17,0,0,-2,0,-12,2,0,19.8,19.6,0.2,4,4,0,0
18148,13530,275,227,11,3,3,11,16,3,1,0,13,16,4,3,3,0,1,0,1,0,0,0,4618,48,8,-8,13,0,-3,1,3,44,31.6,12.4,4,5,-1,1
15318,14523,253,281,7,3,3,7,5,1,0,1,26,17,4,5,1,0,1,0,0,1,0,0,795,-28,4,-4,4,0,9,-1,1,29.2,9.8,19.4,3,4,-1,0
13920,14948,264,262,3,5,5,3,1,7,0,1,17,106,1,4,1,0,0,1,0,1,0,0,-1028,2,-2,2,-6,0,-89,-3,1,24,35.2,-11.2,3,4,-1,1
14926,16536,239,254,5,9,9,5,4,7,0,0,19,12,1,8,2,0,1,0,0,0,0,0,-1610,-15,-4,4,-3,0,7,-7,2,40.6,63,-22.4,1,4,-3,1
15025,14144,303,251,4,3,3,4,2,4,0,0,29,20,2,0,0,0,1,0,0,0,0,0,881,52,1,-1,-2,0,9,2,0,8.4,30.8,-22.4,2,5,-3,1
17177,14654,286,246,8,4,4,8,10,7,0,0,113,16,5,3,0,0,1,0,0,0,0,0,2523,40,4,-4,3,0,97,2,0,71.4,48.4,23,5,3,2,1
13015,14703,278,285,0,3,3,0,0,8,0,1,104,23,4,2,0,1,0,1,0,1,0,0,-1688,-7,-3,3,-8,0,81,2,-1,37.8,15,22.8,5,4,1,0
14854,16106,257,286,4,5,5,4,5,5,0,0,20,24,6,5,2,4,0,1,0,0,0,0,-1252,-29,-1,1,0,0,-4,1,-2,17.2,11,6.2,2,5,-3,0
16100,15601,267,215,7,9,9,7,12,19,0,1,14,12,3,3,1,0,0,1,0,1,0,0,499,52,-2,2,-7,0,2,0,1,32.4,36.4,-4,3,4,-1,0
13851,14997,276,268,2,4,4,2,1,6,0,0,16,19,6,6,0,1,1,0,0,0,0,0,-1146,8,-2,2,-5,0,-3,0,-1,14.2,19.2,-5,4,3,1,1
16215,17300,257,264,7,11,11,7,12,12,0,0,20,16,2,10,1,0,1,0,0,0,0,0,-1085,-7,-4,4,0,0,4,-8,1,20,29.8,-9.8,5,5,0,1
15855,12766,277,264,4,0,0,4,4,0,0,1,19,14,2,4,1,0,1,0,0,1,0,0,3089,13,4,-4,4,0,5,-2,1,12,17.8,-5.8,2,3,-1,1
16701,12699,278,241,10,0,0,10,7,0,0,0,22,13,2,4,0,1,1,0,0,0,0,0,4002,37,10,-10,7,0,9,-2,-1,32.2,5.4,26.8,2,2,0,1
14815,13255,257,270,5,1,1,5,4,0,0,0,23,19,9,8,0,0,1,0,0,0,0,0,1560,-13,4,-4,4,0,4,1,0,14,18.2,-4.2,4,3,1,1
15470,16069,233,233,9,8,8,9,10,9,0,0,21,17,4,0,0,0,1,0,0,0,0,0,-599,0,1,-1,1,0,4,4,0,19.2,9.4,9.8,3,2,1,0
14778,14403,307,314,2,1,1,2,2,0,0,0,16,13,3,5,0,1,1,0,0,0,0,0,375,-7,1,-1,2,0,3,-2,-1,7.4,21,-13.6,4,3,1,0
15787,16079,268,277,5,6,6,5,9,7,0,1,16,14,3,3,1,1,0,1,0,1,0,0,-292,-9,-1,1,2,0,2,0,0,54,13.4,40.6,5,5,0,0
14762,13717,269,256,5,2,2,5,3,2,0,0,24,18,2,4,0,0,0,1,0,0,0,0,1045,13,3,-3,1,0,6,-2,0,25.2,93.6,-68.4,4,3,1,1
14884,15133,240,255,4,6,6,4,7,6,0,1,17,14,1,1,0,0,1,0,0,1,0,0,-249,-15,-2,2,1,0,3,0,0,25.6,28.2,-2.6,3,4,-1,0
14221,17439,241,294,4,10,10,4,3,6,0,1,15,22,4,4,0,1,0,1,0,1,0,0,-3218,-53,-6,6,-3,0,-7,0,-1,23.4,19.4,4,3,3,0,0
13786,15961,276,281,1,6,6,1,2,9,1,0,21,38,3,7,0,1,0,1,1,0,0,0,-2175,-5,-5,5,-7,0,-17,-4,-1,13,104.4,-91.4,4,4,0,1
14346,15512,241,265,4,6,6,4,8,11,1,0,19,21,3,5,0,0,0,1,1,0,0,0,-1166,-24,-2,2,-3,0,-2,-2,0,26.2,19.8,6.4,4,4,0,1
15547,14659,265,264,7,4,4,7,4,6,0,0,37,13,1,2,0,0,1,0,0,0,0,0,888,1,3,-3,-2,0,24,-1,0,23.6,82.6,-59,2,4,-2,1
16834,14206,267,245,9,3,3,9,12,2,0,0,14,16,2,1,1,0,1,0,0,0,0,0,2628,22,6,-6,10,0,-2,1,1,22.6,14.2,8.4,3,4,-1,1
15445,15203,262,260,5,6,6,5,6,3,0,0,17,38,3,4,1,0,0,1,0,0,0,0,242,2,-1,1,3,0,-21,-1,1,11.2,12.4,-1.2,3,4,-1,1
14934,18445,247,248,5,12,12,5,4,14,0,0,19,19,1,7,0,2,0,1,0,0,0,0,-3511,-1,-7,7,-10,0,0,-6,-2,6.8,46.6,-39.8,2,5,-3,0
15102,14827,260,283,5,4,4,5,5,2,0,0,18,17,4,0,0,1,1,0,0,0,0,0,275,-23,1,-1,3,0,1,4,-1,14.2,29.2,-15,1,4,-3,0
14856,13513,286,272,4,1,1,4,4,0,0,0,19,19,2,4,0,0,1,0,0,0,0,0,1343,14,3,-3,4,0,0,-2,0,17.6,37.6,-20,3,5,-2,0
15767,14391,254,266,7,4,4,7,8,1,0,0,13,39,2,2,1,0,1,0,0,0,0,0,1376,-12,3,-3,7,0,-26,0,1,23.6,8.6,15,4,3,1,0
15663,15259,259,264,7,6,6,7,8,7,0,0,13,33,3,2,0,1,1,0,0,0,0,0,404,-5,1,-1,1,0,-20,1,-1,67,48.8,18.2,2,3,-1,1
13828,17215,258,277,2,9,9,2,2,8,0,1,17,21,7,2,0,4,0,1,0,1,0,0,-3387,-19,-7,7,-6,0,-4,5,-4,14.6,10.2,4.4,4,2,2,0
15638,14568,249,231,7,5,5,7,7,6,0,1,44,33,0,3,1,1,1,0,0,1,0,0,1070,18,2,-2,1,0,11,-3,0,19.2,29.6,-10.4,2,3,-1,0
15122,15062,261,292,6,3,3,6,3,3,0,0,38,17,4,5,0,0,1,0,0,0,0,0,60,-31,3,-3,0,0,21,-1,0,35.2,38.4,-3.2,5,4,1,0
17575,15123,272,254,11,5,5,11,19,5,0,0,25,21,6,3,0,0,1,0,0,0,0,0,2452,18,6,-6,14,0,4,3,0,10,89.6,-79.6,3,5,-2,0
17474,15398,299,247,9,6,7,9,9,6,0,0,15,19,5,2,1,0,1,0,0,0,0,0,2076,52,3,-2,3,0,-4,3,1,77.4,15.2,62.2,5,4,1,1
15252,15093,278,280,4,4,4,4,4,3,0,0,13,16,4,2,0,1,0,1,0,0,0,0,159,-2,0,0,1,0,-3,2,-1,21.2,8.2,13,3,2,1,0
16952,14073,258,252,10,3,3,10,8,5,0,1,15,16,5,4,1,2,0,1,0,1,0,0,2879,6,7,-7,3,0,-1,1,-1,70.6,28.6,42,5,4,1,1
14743,16984,227,244,6,9,9,6,6,12,0,1,17,27,3,1,0,1,0,1,0,1,0,0,-2241,-17,-3,3,-6,0,-10,2,-1,48.2,98.8,-50.6,5,5,0,0
16117,13160,278,238,8,2,2,8,9,1,0,0,17,14,3,4,0,0,1,0,0,0,0,0,2957,40,6,-6,8,0,3,-1,0,16.4,47.8,-31.4,4,3,1,1
16500,13047,262,209,8,2,2,8,12,3,1,0,17,15,3,3,2,1,0,1,1,0,0,0,3453,53,6,-6,9,0,2,0,1,25.8,30.8,-5,3,4,-1,1
15751,13852,244,274,8,2,2,8,6,1,0,0,16,22,2,3,0,0,0,1,0,0,0,0,1899,-30,6,-6,5,0,-6,-1,0,17.8,16.6,1.2,5,3,2,0
15731,15141,296,267,5,5,5,5,6,3,0,1,16,19,3,4,0,0,0,1,0,1,0,0,590,29,0,0,3,0,-3,-1,0,34,14.6,19.4,4,4,0,0
16145,12108,283,237,6,0,0,6,12,0,0,0,36,13,3,2,2,0,1,0,0,0,0,0,4037,46,6,-6,12,0,23,1,2,91.8,13,78.8,5,3,2,0
15551,15673,272,280,5,6,6,5,8,5,0,1,15,15,3,5,1,0,1,0,0,1,0,0,-122,-8,-1,1,3,0,0,-2,1,9.6,26,-16.4,5,5,0,0
15942,13945,275,269,7,2,2,7,8,1,0,1,18,17,1,4,1,1,1,0,0,1,0,0,1997,6,5,-5,7,0,1,-3,0,16.4,9.8,6.6,4,2,2,1
14934,15738,272,291,4,6,6,4,6,3,0,1,15,15,2,4,1,0,0,1,0,1,0,0,-804,-19,-2,2,3,0,0,-2,1,31.8,45.2,-13.4,3,4,-1,1
16175,16287,231,248,9,7,7,9,10,7,0,0,36,18,5,3,1,1,1,0,0,0,0,0,-112,-17,2,-2,3,0,18,2,0,13,26.6,-13.6,2,3,-1,1
13726,16366,266,288,2,7,7,2,1,9,0,1,17,34,1,5,0,0,0,1,0,1,0,0,-2640,-22,-5,5,-8,0,-17,-4,0,53,34.8,18.2,3,4,-1,0
14397,14172,260,251,4,4,4,4,2,4,0,1,13,18,5,2,0,2,1,0,0,1,0,0,225,9,0,0,-2,0,-5,3,-2,42.6,40.6,2,4,4,0,0
16924,14179,273,273,9,3,3,9,11,8,0,0,14,16,1,2,3,0,1,0,0,0,0,0,2745,0,6,-6,3,0,-2,-1,3,79.2,35,44.2,5,4,1,1
16764,16176,253,267,9,8,8,9,8,9,0,1,16,150,1,2,1,0,1,0,0,1,0,0,588,-14,1,-1,-1,0,-134,-1,1,21.6,25.6,-4,4,3,1,1
13476,16913,231,273,3,9,9,3,3,9,0,1,15,17,1,0,0,0,0,1,0,1,0,0,-3437,-42,-6,6,-6,0,-2,1,0,97.6,15.8,81.8,5,2,3,0
17939,15221,230,231,14,6,6,14,14,5,0,0,16,14,4,2,0,0,1,0,0,0,0,0,2718,-1,8,-8,9,0,2,2,0,59.2,208.2,-149,4,5,-1,1
13913,16378,232,248,3,8,8,3,5,9,0,1,15,15,1,7,1,0,0,1,0,1,0,0,-2465,-16,-5,5,-4,0,0,-6,1,7.6,31,-23.4,3,3,0,0
15321,14044,249,271,5,2,2,5,7,2,0,0,35,18,1,1,3,1,1,0,0,0,0,0,1277,-22,3,-3,5,0,17,0,2,167.4,33.2,134.2,5,3,2,1
15587,16041,269,258,5,7,7,5,5,10,0,0,33,19,2,5,1,0,0,1,0,0,0,0,-454,11,-2,2,-5,0,14,-3,1,17.4,43.4,-26,4,4,0,0
2754,2951,2,12,0,0,0,0,0,0,0,0,3,2,0,0,0,0,0,0,0,0,0,0,-197,-10,0,0,0,0,1,0,0,3.4,4,-0.6,0,1,-1,0
14662,14103,287,297,3,2,2,3,3,1,0,1,11,36,3,0,1,0,0,1,0,1,0,0,559,-10,1,-1,2,0,-25,3,1,95,13.2,81.8,4,4,0,0
15545,12978,268,252,6,0,0,6,12,0,0,0,22,39,4,4,0,1,1,0,0,0,0,0,2567,16,6,-6,12,0,-17,0,-1,118.2,12.8,105.4,4,2,2,0
14536,15630,244,280,5,6,6,5,2,12,1,0,15,15,3,2,1,0,1,0,1,0,0,0,-1094,-36,-1,1,-10,0,0,1,1,123,40,83,4,3,1,1
15195,14584,290,303,5,2,2,5,6,3,0,1,17,11,2,4,0,0,1,0,0,1,0,0,611,-13,3,-3,3,0,6,-2,0,7,91.2,-84.2,1,5,-4,0
15019,14924,248,252,5,5,5,5,6,6,0,0,15,19,4,1,0,1,0,1,0,0,0,0,95,-4,0,0,0,0,-4,3,-1,16.4,87.2,-70.8,3,4,-1,0
17518,15959,259,239,9,9,9,9,12,12,1,0,14,15,3,1,2,0,1,0,1,0,0,0,1559,20,0,0,0,0,-1,2,2,92.8,34.2,58.6,3,5,-2,0
14757,15091,289,279,3,3,3,3,4,6,0,1,19,14,2,6,0,1,0,1,0,1,0,0,-334,10,0,0,-2,0,5,-4,-1,43.4,21.4,22,4,4,0,1
14878,13379,278,259,3,1,1,3,5,1,0,0,32,20,8,4,0,0,1,0,0,0,0,0,1499,19,2,-2,4,0,12,4,0,33.2,80.8,-47.6,4,4,0,1
15050,17089,255,262,5,9,9,5,4,12,0,1,33,19,4,2,1,2,0,1,0,1,0,0,-2039,-7,-4,4,-8,0,14,2,-1,4.2,30.2,-26,1,4,-3,1
15558,15729,240,267,8,5,5,8,9,9,0,0,19,20,5,4,1,0,1,0,0,0,0,0,-171,-27,3,-3,0,0,-1,1,1,88.4,23.4,65,5,4,1,0
15941,15510,259,274,6,5,5,6,11,4,0,1,16,16,4,3,0,2,0,1,0,1,0,0,431,-15,1,-1,7,0,0,1,-2,27.4,36.2,-8.8,4,4,0,0
14409,15759,234,259,5,7,7,5,7,9,0,0,20,14,4,6,0,0,1,0,0,0,0,0,-1350,-25,-2,2,-2,0,6,-2,0,18.2,34.8,-16.6,4,4,0,0
15004,15096,259,282,5,5,6,5,4,5,0,0,37,18,4,4,0,1,0,1,0,0,0,0,-92,-23,0,1,-1,0,19,0,-1,16.8,65.8,-49,3,4,-1,1
16064,17017,227,230,10,12,12,10,7,11,0,1,15,33,2,3,1,2,0,1,0,1,0,0,-953,-3,-2,2,-4,0,-18,-1,-1,79.4,30,49.4,5,4,1,0
16193,15377,269,275,7,5,5,7,8,8,0,0,21,15,2,4,0,1,1,0,0,0,0,0,816,-6,2,-2,0,0,6,-2,-1,88,22.4,65.6,5,4,1,1
14569,15720,248,260,4,5,6,6,6,9,0,1,90,14,2,2,1,2,0,1,0,1,0,0,-1151,-12,-1,0,-3,0,76,0,-1,22,177.4,-155.4,3,5,-2,0
16184,15688,270,270,6,6,6,6,9,8,0,1,16,36,2,1,1,1,0,1,0,1,0,0,496,0,0,0,1,0,-20,1,0,8,8.6,-0.6,3,4,-1,1
13573,13583,277,277,1,1,1,1,1,1,0,1,14,18,5,1,0,1,1,0,0,1,0,0,-10,0,0,0,0,0,-4,4,-1,10.8,60,-49.2,4,4,0,1
15624,15228,265,244,6,5,5,6,4,8,0,0,28,18,5,1,1,0,1,0,0,0,0,0,396,21,1,-1,-4,0,10,4,1,40.4,23.4,17,4,3,1,1
14843,12997,299,251,4,1,1,4,4,1,0,1,15,13,5,2,0,0,1,0,0,1,0,0,1846,48,3,-3,3,0,2,3,0,27.2,45.4,-18.2,4,4,0,1
16630,17231,223,212,11,11,11,11,12,15,0,1,17,14,4,5,0,1,1,0,0,1,0,0,-601,11,0,0,-3,0,3,-1,-1,140.8,16,124.8,5,3,2,0
13963,14217,259,262,3,3,3,3,4,4,0,0,36,19,6,2,0,1,1,0,0,0,0,0,-254,-3,0,0,0,0,17,4,-1,189.8,41.4,148.4,3,4,-1,0
15814,14305,291,283,5,2,2,6,6,1,0,0,30,18,3,0,2,1,1,0,0,0,0,0,1509,8,3,-4,5,0,12,3,1,19.8,73.2,-53.4,4,5,-1,0
14640,15182,278,269,3,5,5,3,3,6,0,1,13,17,0,2,0,0,0,1,0,1,0,0,-542,9,-2,2,-3,0,-4,-2,0,47.2,26.6,20.6,3,2,1,0
14630,13842,269,254,4,3,3,4,4,2,0,1,16,18,9,2,1,0,1,0,0,1,0,0,788,15,1,-1,2,0,-2,7,1,16.6,137,-120.4,4,5,-1,1
14933,15973,245,283,5,6,6,5,7,6,0,0,16,52,5,1,0,1,0,1,0,0,0,0,-1040,-38,-1,1,1,0,-36,4,-1,88.8,18.2,70.6,4,4,0,1
15198,15860,267,262,5,6,6,5,3,9,0,0,17,33,1,2,0,1,1,0,0,0,0,0,-662,5,-1,1,-6,0,-16,-1,-1,60,26.4,33.6,3,5,-2,1
14638,14539,261,292,4,3,3,4,6,3,0,0,16,12,2,4,0,0,1,0,0,0,0,0,99,-31,1,-1,3,0,4,-2,0,12.2,86.8,-74.6,3,3,0,1
14332,14730,208,272,5,3,3,5,5,4,0,0,15,14,1,1,1,2,1,0,0,0,0,0,-398,-64,2,-2,1,0,1,0,-1,49,16.6,32.4,3,2,1,0
13081,16024,255,293,1,6,6,1,2,12,0,1,36,31,4,3,0,0,0,1,0,1,0,0,-2943,-38,-5,5,-10,0,5,1,0,58.4,25.2,33.2,5,5,0,1
15036,13923,281,269,4,1,1,4,6,1,0,0,13,17,3,5,0,1,1,0,0,0,0,0,1113,12,3,-3,5,0,-4,-2,-1,21.4,20.4,1,4,5,-1,1
14713,16887,217,246,5,12,13,5,12,11,0,1,18,12,0,5,0,2,0,1,0,1,0,0,-2174,-29,-7,8,1,0,6,-5,-2,99.8,57.6,42.2,4,4,0,1
16779,15703,265,251,9,7,7,9,9,5,1,0,16,18,2,2,0,0,1,0,1,0,0,0,1076,14,2,-2,4,0,-2,0,0,76.8,25.2,51.6,4,4,0,1
14782,13431,290,280,3,1,2,3,6,2,0,1,22,16,1,6,0,0,1,0,0,1,0,0,1351,10,2,-1,4,0,6,-5,0,14,63,-49,3,4,-1,1
15489,15324,259,274,5,4,4,5,9,5,0,1,39,95,3,4,0,1,0,1,0,1,0,0,165,-15,1,-1,4,0,-56,-1,-1,84.2,35.2,49,5,4,1,1
15294,14330,228,243,9,4,4,9,2,4,0,0,16,14,1,2,2,1,1,0,0,0,0,0,964,-15,5,-5,-2,0,2,-1,1,10.2,18.4,-8.2,4,4,0,1
15131,15830,274,248,5,8,8,5,4,10,0,0,20,15,6,6,0,0,1,0,0,0,0,0,-699,26,-3,3,-6,0,5,0,0,50.8,31.8,19,4,5,-1,1
13116,14965,281,297,0,4,4,0,0,7,1,0,16,15,0,4,0,0,0,1,1,0,0,0,-1849,-16,-4,4,-7,0,1,-4,0,27.6,77.4,-49.8,4,5,-1,0
16019,15161,242,280,8,4,4,8,11,5,0,0,15,18,2,2,0,1,1,0,0,0,0,0,858,-38,4,-4,6,0,-3,0,-1,29,27.4,1.6,5,4,1,0
16503,13376,285,241,7,2,2,7,5,1,0,0,17,15,2,3,2,0,1,0,0,0,0,0,3127,44,5,-5,4,0,2,-1,2,93.6,53,40.6,5,4,1,1
14237,14468,242,241,5,5,5,5,4,6,0,0,13,16,5,2,0,1,0,1,0,0,0,0,-231,1,0,0,-2,0,-3,3,-1,32.8,19.8,13,3,4,-1,0
16620,13988,276,273,8,2,2,8,8,2,0,0,20,18,4,1,1,0,1,0,0,0,0,0,2632,3,6,-6,6,0,2,3,1,106,16.2,89.8,5,5,0,1
15234,16504,271,285,4,8,8,4,8,7,0,0,14,22,4,4,0,0,0,1,0,0,0,0,-1270,-14,-4,4,1,0,-8,0,0,20.8,32.4,-11.6,2,4,-2,1
15472,16524,257,210,5,11,11,5,6,12,0,0,13,13,1,2,0,0,0,1,0,0,0,0,-1052,47,-6,6,-6,0,0,-1,0,89,7.4,81.6,4,3,1,1
15413,17616,249,270,6,10,10,6,6,14,1,0,12,112,2,3,2,0,0,1,1,0,0,0,-2203,-21,-4,4,-8,0,-100,-1,2,35.8,70.4,-34.6,4,3,1,0
16847,16246,242,230,11,9,9,11,8,12,0,0,23,25,2,5,1,0,1,0,0,0,0,0,601,12,2,-2,-4,0,-2,-3,1,75.2,68,7.2,5,5,0,1
16709,16755,231,227,10,10,10,10,11,15,0,0,20,37,3,2,2,1,1,0,0,0,0,0,-46,4,0,0,-4,0,-17,1,1,17,11.4,5.6,3,3,0,1
14852,14909,302,294,3,4,4,3,4,5,0,1,18,20,7,2,0,1,0,1,0,1,0,0,-57,8,-1,1,-1,0,-2,5,-1,13.8,41.6,-27.8,4,5,-1,0
17266,13603,283,237,9,3,3,9,16,2,1,0,16,108,7,1,2,0,1,0,1,0,0,0,3663,46,6,-6,14,0,-92,6,2,56,25.2,30.8,4,3,1,1
13822,16076,248,244,2,8,8,2,3,10,0,0,17,22,4,2,1,1,0,1,0,0,0,0,-2254,4,-6,6,-7,0,-5,2,0,10.8,7.6,3.2,3,3,0,0
16211,17589,246,237,7,12,12,7,8,14,0,0,27,34,5,6,1,2,0,1,0,0,0,0,-1378,9,-5,5,-6,0,-7,-1,-1,16.8,22.8,-6,4,4,0,0
17997,15403,268,250,12,6,6,12,11,5,1,0,20,20,4,3,0,0,1,0,1,0,0,0,2594,18,6,-6,6,0,0,1,0,117,47.2,69.8,5,4,1,1
14828,13608,284,268,3,1,1,3,5,0,0,1,19,107,4,4,0,0,1,0,0,1,0,0,1220,16,2,-2,5,0,-88,0,0,64,27.4,36.6,4,4,0,1
14143,15552,252,260,3,5,5,3,3,5,0,0,15,18,0,6,3,1,0,1,0,0,0,0,-1409,-8,-2,2,-2,0,-3,-6,2,56.4,114.6,-58.2,5,5,0,0
15278,14861,262,267,6,3,4,6,3,3,0,0,17,14,0,5,0,0,0,1,0,0,0,0,417,-5,3,-2,0,0,3,-5,0,34.6,15.4,19.2,5,4,1,0
13610,19024,218,274,4,17,17,4,3,16,0,1,13,15,3,0,0,2,0,1,0,1,0,0,-5414,-56,-13,13,-13,0,-2,3,-2,40.8,14.8,26,5,4,1,0
16536,16523,256,260,11,8,8,11,6,8,0,1,11,10,4,2,1,0,1,0,0,1,0,0,13,-4,3,-3,-2,0,1,2,1,32.6,8.6,24,4,3,1,0
15262,15782,260,281,6,6,7,6,5,7,0,0,34,17,5,1,0,1,0,1,0,0,0,0,-520,-21,0,1,-2,0,17,4,-1,10.8,52.8,-42,5,4,1,1
14057,14974,256,291,3,4,4,3,5,6,0,0,16,362,4,2,0,0,0,1,0,0,0,0,-917,-35,-1,1,-1,0,-346,2,0,17.6,24.6,-7,4,4,0,1
15142,15454,254,276,6,5,5,6,5,7,0,0,18,42,1,2,0,1,0,1,0,0,0,0,-312,-22,1,-1,-2,0,-24,-1,-1,57.6,31.6,26,5,4,1,1
13960,15123,229,272,4,5,5,4,4,8,0,0,16,15,2,4,0,1,0,1,0,0,0,0,-1163,-43,-1,1,-4,0,1,-2,-1,38.2,18.2,20,4,3,1,1
14758,14943,265,251,5,5,5,6,4,7,0,0,15,15,2,0,1,1,0,1,0,0,0,0,-185,14,0,-1,-3,0,0,2,0,18.2,33.8,-15.6,5,4,1,0
15050,13524,266,280,5,1,1,5,5,1,0,0,51,17,4,3,0,0,1,0,0,0,0,0,1526,-14,4,-4,4,0,34,1,0,15.2,25,-9.8,4,5,-1,1
14301,15480,250,260,4,5,5,4,3,11,0,1,14,14,2,4,0,0,0,1,0,1,0,0,-1179,-10,-1,1,-8,0,0,-2,0,6.2,11,-4.8,1,3,-2,0
14200,15069,261,256,3,4,4,3,2,5,0,0,17,15,5,3,1,0,0,1,0,0,0,0,-869,5,-1,1,-3,0,2,2,1,59,55.6,3.4,3,4,-1,0
14598,14710,291,276,4,3,3,4,2,4,0,0,15,18,2,2,1,1,1,0,0,0,0,0,-112,15,1,-1,-2,0,-3,0,0,6.6,79.8,-73.2,2,2,0,0
15570,16228,261,264,5,9,9,5,5,5,0,0,16,36,3,5,2,1,1,0,0,0,0,0,-658,-3,-4,4,0,0,-20,-2,1,107.6,20.2,87.4,5,5,0,1
16776,13869,272,241,9,4,4,9,9,1,1,0,14,22,3,1,0,0,0,1,1,0,0,0,2907,31,5,-5,8,0,-8,2,0,14,41.8,-27.8,4,4,0,1
15419,14598,277,280,4,3,3,4,3,1,0,0,103,17,5,2,2,1,1,0,0,0,0,0,821,-3,1,-1,2,0,86,3,1,43,29.6,13.4,3,4,-1,0
14545,15734,260,265,4,6,7,4,3,5,0,0,18,14,1,3,0,1,1,0,0,0,0,0,-1189,-5,-2,3,-2,0,4,-2,-1,50.2,70.4,-20.2,4,5,-1,0
14967,12327,306,212,3,2,2,3,2,2,0,1,13,35,3,2,1,0,1,0,0,1,0,0,2640,94,1,-1,0,0,-22,1,1,9,7.8,1.2,2,2,0,1
15289,16374,240,267,7,7,7,7,5,9,0,0,16,16,2,1,0,0,1,0,0,0,0,0,-1085,-27,0,0,-4,0,0,1,0,26.2,42.4,-16.2,3,4,-1,0
16347,16417,206,224,10,11,11,10,16,16,0,0,17,16,1,5,0,0,1,0,0,0,0,0,-70,-18,-1,1,0,0,1,-4,0,21.8,46.4,-24.6,4,5,-1,1
14573,17541,216,259,5,9,9,5,8,13,1,0,15,19,1,4,0,2,1,0,1,0,0,0,-2968,-43,-4,4,-5,0,-4,-3,-2,67.2,43.2,24,5,4,1,0
15371,15813,265,287,6,5,5,6,5,5,0,1,17,14,2,2,0,2,1,0,0,1,0,0,-442,-22,1,-1,0,0,3,0,-2,54.8,35.4,19.4,4,2,2,0
13913,14785,279,260,1,4,4,1,1,8,0,0,31,16,3,5,1,1,0,1,0,0,0,0,-872,19,-3,3,-7,0,15,-2,0,48.2,64.6,-16.4,3,3,0,1
14532,16651,249,252,4,9,9,4,4,7,0,0,15,18,3,0,0,2,1,0,0,0,0,0,-2119,-3,-5,5,-3,0,-3,3,-2,11.8,27.4,-15.6,3,5,-2,0
13579,15237,260,285,2,4,4,2,5,8,0,0,31,18,3,5,0,1,0,1,0,0,0,0,-1658,-25,-2,2,-3,0,13,-2,-1,57.8,20,37.8,4,4,0,1
13067,16477,255,294,0,7,7,0,0,17,0,1,10,46,6,1,1,0,0,1,0,1,0,0,-3410,-39,-7,7,-17,0,-36,5,1,38.8,9.6,29.2,4,3,1,0
15339,13400,258,267,7,2,3,7,3,0,0,1,13,14,1,2,0,0,0,1,0,1,0,0,1939,-9,5,-4,3,0,-1,-1,0,8,14.6,-6.6,2,4,-2,0
15611,20421,220,267,6,18,18,6,4,30,0,1,11,38,2,2,0,3,0,1,0,1,0,0,-4810,-47,-12,12,-26,0,-27,0,-3,33.2,103.6,-70.4,4,4,0,0
14256,13600,272,251,3,2,2,3,4,3,0,0,18,38,1,5,0,0,1,0,0,0,0,0,656,21,1,-1,1,0,-20,-4,0,43,11.4,31.6,3,4,-1,0
15351,16683,260,249,6,10,10,6,11,14,0,0,14,14,4,2,0,0,1,0,0,0,0,0,-1332,11,-4,4,-3,0,0,2,0,41.8,56.2,-14.4,4,5,-1,1
14458,13707,270,280,3,1,1,3,4,2,0,0,16,19,5,7,0,0,1,0,0,0,0,0,751,-10,2,-2,2,0,-3,-2,0,16,24,-8,4,3,1,1
15433,16730,237,276,8,9,9,8,4,4,0,0,19,18,2,5,1,0,0,1,0,0,0,0,-1297,-39,-1,1,0,0,1,-3,1,42.8,14.4,28.4,4,3,1,0
14243,14515,273,273,2,4,4,2,3,1,0,1,22,24,3,5,1,1,0,1,0,1,0,0,-272,0,-2,2,2,0,-2,-2,0,8.8,46.2,-37.4,3,4,-1,1
15901,15794,256,236,7,7,7,7,7,15,0,0,39,34,6,7,2,1,0,1,0,0,0,0,107,20,0,0,-8,0,5,-1,1,11.6,75,-63.4,4,4,0,1
16846,13465,263,283,10,1,2,10,10,2,0,1,12,208,4,2,1,0,1,0,0,1,0,0,3381,-20,9,-8,8,0,-196,2,1,55.8,40,15.8,4,4,0,1
13815,14925,268,274,2,3,3,2,1,3,0,1,19,17,4,5,2,3,0,1,0,1,0,0,-1110,-6,-1,1,-2,0,2,-1,-1,11.8,27.6,-15.8,3,5,-2,0
14409,15400,230,250,5,6,6,5,10,10,0,0,17,17,1,3,0,0,1,0,0,0,0,0,-991,-20,-1,1,0,0,0,-2,0,41.4,15.4,26,4,2,2,0
15884,14662,251,295,7,1,1,7,10,1,0,0,28,14,5,3,0,2,1,0,0,0,0,0,1222,-44,6,-6,9,0,14,2,-2,24,11.6,12.4,5,2,3,0
15072,16117,252,275,5,6,6,5,5,10,0,1,38,44,5,3,0,1,0,1,0,1,0,0,-1045,-23,-1,1,-5,0,-6,2,-1,10.4,86.6,-76.2,3,5,-2,0
15780,15258,264,293,6,5,5,6,9,2,0,1,18,11,2,4,1,1,0,1,0,1,0,0,522,-29,1,-1,7,0,7,-2,0,16.4,99.6,-83.2,1,4,-3,1
15592,15405,262,280,6,5,5,6,7,4,0,0,111,16,3,2,0,0,1,0,0,0,0,0,187,-18,1,-1,3,0,95,1,0,74,18.4,55.6,5,5,0,1
13843,16305,288,265,2,10,10,2,1,6,0,1,12,58,0,2,0,0,1,0,0,1,0,0,-2462,23,-8,8,-5,0,-46,-2,0,13.8,11,2.8,4,3,1,0
14989,13165,304,264,3,1,1,3,3,1,0,0,11,12,3,1,1,0,1,0,0,0,0,0,1824,40,2,-2,2,0,-1,2,1,9,41.4,-32.4,2,4,-2,1
14205,19936,206,269,6,16,16,7,4,20,0,0,22,16,7,6,0,0,1,0,0,0,0,0,-5731,-63,-10,9,-16,0,6,1,0,10.6,85,-74.4,2,5,-3,0
18472,15337,268,214,14,7,7,14,14,8,0,0,12,8,2,2,1,1,1,0,0,0,0,0,3135,54,7,-7,6,0,4,0,0,21,35.6,-14.6,5,3,2,1
16396,14721,285,261,8,4,4,8,10,5,0,0,16,17,4,3,0,0,0,1,0,0,0,0,1675,24,4,-4,5,0,-1,1,0,38.2,47.8,-9.6,4,3,1,1
15597,14496,299,292,4,2,2,4,6,2,1,0,19,14,4,3,2,2,0,1,1,0,0,0,1101,7,2,-2,4,0,5,1,0,13.8,24,-10.2,3,3,0,0
16426,15385,216,241,10,5,5,10,16,7,1,0,18,15,4,2,3,0,1,0,1,0,0,0,1041,-25,5,-5,9,0,3,2,3,19.4,69.4,-50,5,3,2,0
15662,15503,261,254,7,6,6,7,7,8,0,0,17,16,6,3,1,0,1,0,0,0,0,0,159,7,1,-1,-1,0,1,3,1,42,10.4,31.6,3,2,1,0
15122,16178,267,263,4,8,8,4,5,5,0,0,11,16,3,2,1,0,0,1,0,0,0,0,-1056,4,-4,4,0,0,-5,1,1,37,8.4,28.6,4,4,0,0
15332,15463,276,243,5,6,6,5,4,10,0,1,10,15,2,0,2,0,1,0,0,1,0,0,-131,33,-1,1,-6,0,-5,2,2,37.4,14,23.4,3,4,-1,0
15750,12755,281,237,5,1,1,5,4,0,1,0,39,19,4,1,1,0,0,1,1,0,0,0,2995,44,4,-4,4,0,20,3,1,74.8,48.6,26.2,5,3,2,1
14979,13463,235,237,6,2,2,6,9,3,1,0,20,17,3,2,0,0,1,0,1,0,0,0,1516,-2,4,-4,6,0,3,1,0,19,1.8,17.2,3,0,3,1
14893,13238,272,264,3,1,1,3,6,2,0,1,14,24,6,0,1,0,1,0,0,1,0,0,1655,8,2,-2,4,0,-10,6,1,46.6,33.2,13.4,4,3,1,1
14590,13850,237,258,5,2,2,6,5,2,0,1,13,18,2,2,1,1,1,0,0,1,0,0,740,-21,3,-4,3,0,-5,0,0,82.4,10.6,71.8,5,4,1,1
14253,15916,271,229,2,8,8,2,2,15,1,0,13,38,6,1,2,0,0,1,1,0,0,0,-1663,42,-6,6,-13,0,-25,5,2,34.8,97.4,-62.6,4,5,-1,0
17141,13518,283,252,9,2,2,9,11,2,0,0,15,19,3,5,0,0,1,0,0,0,0,0,3623,31,7,-7,9,0,-4,-2,0,16,55.6,-39.6,5,4,1,1
13676,16012,243,284,3,6,6,4,3,7,0,0,14,16,3,5,0,0,0,1,0,0,0,0,-2336,-41,-3,2,-4,0,-2,-2,0,15.4,84.8,-69.4,3,4,-1,0
14262,15458,256,286,3,4,4,3,6,3,0,0,38,30,2,5,1,2,0,1,0,0,0,0,-1196,-30,-1,1,3,0,8,-3,-1,49.8,21.6,28.2,4,4,0,1
17504,13417,313,272,8,1,1,8,13,2,0,0,16,17,3,0,1,0,1,0,0,0,0,0,4087,41,7,-7,11,0,-1,3,1,28,56.2,-28.2,4,4,0,1
16945,14988,309,248,7,7,7,7,8,6,0,0,18,18,7,1,0,0,0,1,0,0,0,0,1957,61,0,0,2,0,0,6,0,13.2,36.4,-23.2,2,5,-3,1
11764,19074,215,276,0,15,15,0,0,17,0,0,14,25,3,3,0,1,0,1,0,0,0,0,-7310,-61,-15,15,-17,0,-11,0,-1,24.6,12.8,11.8,5,4,1,0
15468,13783,282,248,4,3,3,4,4,6,0,0,19,18,1,5,0,0,0,1,0,0,0,0,1685,34,1,-1,-2,0,1,-4,0,35.8,60.2,-24.4,4,4,0,1
18129,14854,282,232,12,6,6,12,12,6,0,1,10,17,4,1,2,0,1,0,0,1,0,0,3275,50,6,-6,6,0,-7,3,2,19.6,71,-51.4,3,5,-2,0
15078,15616,243,250,6,8,8,6,9,8,0,0,15,13,3,4,0,0,0,1,0,0,0,0,-538,-7,-2,2,1,0,2,-1,0,11.2,8.8,2.4,3,4,-1,0
14068,16090,238,267,4,9,9,4,4,7,0,1,14,16,2,3,0,0,1,0,0,1,0,0,-2022,-29,-5,5,-3,0,-2,-1,0,3,9.6,-6.6,0,2,-2,0
16502,15615,265,265,8,6,6,9,9,6,0,0,17,15,4,4,3,0,0,1,0,0,0,0,887,0,2,-3,3,0,2,0,3,57,65.8,-8.8,4,2,2,1
15784,15407,251,259,7,6,6,7,8,5,0,0,16,21,1,4,0,0,0,1,0,0,0,0,377,-8,1,-1,3,0,-5,-3,0,59.2,35.6,23.6,4,4,0,1
14464,15886,249,262,5,6,6,5,3,5,0,1,31,39,4,3,0,3,1,0,0,1,0,0,-1422,-13,-1,1,-2,0,-8,1,-3,32.4,11.2,21.2,3,4,-1,0
17417,16472,298,246,9,9,9,9,17,18,0,1,20,16,1,4,0,0,1,0,0,1,0,0,945,52,0,0,-1,0,4,-3,0,25.4,16.4,9,4,2,2,0
15522,15287,266,250,5,6,6,5,4,6,0,0,20,12,1,3,1,0,0,1,0,0,0,0,235,16,-1,1,-2,0,8,-2,1,43.2,27.2,16,4,4,0,1
13953,13461,296,261,0,1,1,0,0,1,0,1,15,40,5,5,1,0,0,1,0,1,0,0,492,35,-1,1,-1,0,-25,0,1,20,10.4,9.6,4,4,0,1
17936,16576,279,275,9,7,7,9,9,10,0,1,13,36,0,3,1,1,0,1,0,1,0,0,1360,4,2,-2,-1,0,-23,-3,0,53.8,44,9.8,4,4,0,1
14616,15937,229,240,6,8,8,6,9,8,0,1,19,17,4,3,0,0,0,1,0,1,0,0,-1321,-11,-2,2,1,0,2,1,0,40.6,51.8,-11.2,3,4,-1,0
17292,16104,251,252,10,7,7,10,16,13,0,1,17,45,6,5,0,1,0,1,0,1,0,0,1188,-1,3,-3,3,0,-28,1,-1,52.8,59.2,-6.4,4,3,1,1
16817,14114,275,246,9,4,4,9,4,5,1,0,13,12,1,1,3,0,1,0,1,0,0,0,2703,29,5,-5,-1,0,1,0,3,11.6,6.8,4.8,2,1,1,0
16358,16128,234,274,8,6,6,8,10,6,0,0,16,26,3,2,1,0,0,1,0,0,0,0,230,-40,2,-2,4,0,-10,1,1,14.6,89.2,-74.6,4,3,1,1
13359,15056,240,239,2,7,7,2,0,4,0,0,37,21,5,4,0,0,0,1,0,0,0,0,-1697,1,-5,5,-4,0,16,1,0,18.8,48.8,-30,4,5,-1,0
15095,15452,263,277,5,6,6,5,9,4,0,0,17,35,2,2,0,1,1,0,0,0,0,0,-357,-14,-1,1,5,0,-18,0,-1,17,11.8,5.2,5,2,3,0
14986,14319,255,250,5,4,4,5,8,5,0,0,19,36,2,3,1,2,1,0,0,0,0,0,667,5,1,-1,3,0,-17,-1,-1,11,60.8,-49.8,4,4,0,1
15638,14860,218,239,8,5,5,8,11,6,0,0,18,37,5,5,1,0,1,0,0,0,0,0,778,-21,3,-3,5,0,-19,0,1,36.2,7,29.2,5,2,3,1
16317,16504,258,267,8,8,8,8,8,7,0,1,53,17,1,4,1,2,0,1,0,1,0,0,-187,-9,0,0,1,0,36,-3,-1,6.2,9.4,-3.2,2,5,-3,0
15813,16322,288,287,5,7,7,5,5,7,0,1,15,39,8,5,1,1,0,1,0,1,0,0,-509,1,-2,2,-2,0,-24,3,0,27,26.4,0.6,3,5,-2,1
16621,16758,244,195,7,13,13,7,11,11,0,1,32,35,5,4,1,0,0,1,0,1,0,0,-137,49,-6,6,0,0,-3,1,1,16.4,107.6,-91.2,3,4,-1,1
15800,14124,237,279,7,3,3,7,9,1,0,0,144,186,4,4,0,0,1,0,0,0,0,0,1676,-42,4,-4,8,0,-42,0,0,16.4,42.2,-25.8,4,3,1,0
14703,15748,268,255,4,7,7,4,3,5,0,1,25,20,4,6,0,1,0,1,0,1,0,0,-1045,13,-3,3,-2,0,5,-2,-1,154.2,48.2,106,4,4,0,1
17105,14717,264,249,11,3,3,11,17,5,1,0,113,17,6,1,1,1,1,0,1,0,0,0,2388,15,8,-8,12,0,96,5,0,27.4,21.4,6,5,3,2,1
14145,15454,272,268,2,5,5,2,1,8,0,0,18,17,6,5,3,2,1,0,0,0,0,0,-1309,4,-3,3,-7,0,1,1,1,48,9.2,38.8,4,3,1,0
14534,16368,263,290,4,8,8,4,1,7,0,1,36,15,3,7,0,1,0,1,0,1,0,0,-1834,-27,-4,4,-6,0,21,-4,-1,14.2,19.2,-5,3,5,-2,0
14718,15385,258,263,4,5,5,4,6,3,0,0,35,105,4,2,0,3,1,0,0,0,0,0,-667,-5,-1,1,3,0,-70,2,-3,101.6,44.8,56.8,3,5,-2,1
14586,16642,259,285,4,9,9,4,4,6,0,0,17,27,2,3,0,2,0,1,0,0,0,0,-2056,-26,-5,5,-2,0,-10,-1,-2,12,18.2,-6.2,2,3,-1,1
15374,15276,244,271,7,6,6,7,7,2,0,0,31,16,3,3,1,0,0,1,0,0,0,0,98,-27,1,-1,5,0,15,0,1,11.4,47.2,-35.8,4,3,1,0
14511,16063,283,301,3,5,5,4,4,5,0,0,37,17,5,2,0,1,0,1,0,0,0,0,-1552,-18,-2,1,-1,0,20,3,-1,37,51.4,-14.4,5,4,1,0
15344,17883,273,287,5,11,12,5,3,10,0,0,11,26,3,2,0,0,1,0,0,0,0,0,-2539,-14,-6,7,-7,0,-15,1,0,37.2,121,-83.8,3,4,-1,0
14967,13907,283,281,4,2,2,4,7,2,0,0,14,17,4,1,0,0,0,1,0,0,0,0,1060,2,2,-2,5,0,-3,3,0,19,19.4,-0.4,4,4,0,0
15792,15127,264,252,6,7,7,6,8,7,0,1,17,15,2,3,0,0,1,0,0,1,0,0,665,12,-1,1,1,0,2,-1,0,16,74.2,-58.2,3,5,-2,1
15839,14238,252,265,7,3,3,7,9,4,0,0,42,19,7,6,1,0,0,1,0,0,0,0,1601,-13,4,-4,5,0,23,1,1,83,49,34,3,5,-2,0
16548,14532,272,287,7,2,2,7,8,4,0,1,40,15,6,4,0,0,1,0,0,1,0,0,2016,-15,5,-5,4,0,25,2,0,16.6,20.8,-4.2,5,2,3,1
15824,14142,216,209,8,4,4,8,13,7,0,0,15,17,1,3,3,1,0,1,0,0,0,0,1682,7,4,-4,6,0,-2,-2,2,22.2,9.4,12.8,3,2,1,1
13313,15734,249,254,2,7,7,2,2,6,1,0,15,17,3,3,1,0,1,0,1,0,0,0,-2421,-5,-5,5,-4,0,-2,0,1,34.2,104.6,-70.4,3,4,-1,0
17092,13988,276,215,8,4,4,8,10,6,1,0,15,13,1,4,2,0,1,0,1,0,0,0,3104,61,4,-4,4,0,2,-3,2,17.2,49.4,-32.2,4,4,0,1
16094,13823,279,273,8,1,1,8,9,2,1,0,19,36,5,4,1,0,1,0,1,0,0,0,2271,6,7,-7,7,0,-17,1,1,16.2,13,3.2,4,4,0,1
15518,16404,255,265,7,7,7,7,6,7,0,0,16,16,3,2,0,0,1,0,0,0,0,0,-886,-10,0,0,-1,0,0,1,0,76.4,16.6,59.8,4,2,2,1
16303,12909,249,266,9,0,0,9,10,0,0,0,14,20,1,0,2,1,1,0,0,0,0,0,3394,-17,9,-9,10,0,-6,1,1,106.2,9.6,96.6,4,3,1,1
17472,14411,301,267,8,4,4,8,11,1,1,0,34,16,6,3,0,1,0,1,1,0,0,0,3061,34,4,-4,10,0,18,3,-1,48.6,83,-34.4,4,4,0,1
15715,15894,245,274,7,6,6,7,8,12,0,0,18,19,4,4,0,0,0,1,0,0,0,0,-179,-29,1,-1,-4,0,-1,0,0,61.8,22,39.8,5,5,0,0
16433,16467,241,224,9,10,10,9,7,5,0,0,33,15,1,4,1,1,0,1,0,0,0,0,-34,17,-1,1,2,0,18,-3,0,7.2,75,-67.8,3,4,-1,0
15909,14811,239,240,7,5,5,7,7,7,0,0,48,16,4,1,1,1,0,1,0,0,0,0,1098,-1,2,-2,0,0,32,3,0,167.2,96.4,70.8,5,3,2,0
14834,14491,280,276,4,4,4,4,6,6,0,0,14,15,3,3,1,0,0,1,0,0,0,0,343,4,0,0,0,0,-1,0,1,10.2,7.4,2.8,3,2,1,1
13552,15301,235,248,3,6,6,3,5,9,1,0,11,15,3,5,0,1,1,0,1,0,0,0,-1749,-13,-3,3,-4,0,-4,-2,-1,108,24.2,83.8,5,2,3,0
16705,14846,221,207,10,5,5,10,10,6,0,0,35,12,1,4,0,1,0,1,0,0,0,0,1859,14,5,-5,4,0,23,-3,-1,31.6,5.8,25.8,3,2,1,1
17214,14360,239,212,12,6,6,12,6,4,0,0,36,39,10,1,3,1,1,0,0,0,0,0,2854,27,6,-6,2,0,-3,9,2,53,10.6,42.4,5,4,1,1
16266,14687,252,247,8,4,4,8,8,6,0,0,15,10,2,4,2,0,1,0,0,0,0,0,1579,5,4,-4,2,0,5,-2,2,30,37.6,-7.6,3,5,-2,1
15057,15765,288,269,4,6,6,4,4,5,1,0,17,16,2,4,0,0,0,1,1,0,0,0,-708,19,-2,2,-1,0,1,-2,0,12,35.8,-23.8,3,3,0,1
15322,17622,249,234,6,13,13,6,7,9,0,0,12,19,3,2,2,0,1,0,0,0,0,0,-2300,15,-7,7,-2,0,-7,1,2,10,31.2,-21.2,3,3,0,1
14303,14561,257,265,3,4,4,3,9,1,0,1,14,24,1,3,1,1,0,1,0,1,0,0,-258,-8,-1,1,8,0,-10,-2,0,14.6,71.8,-57.2,4,5,-1,0
16357,18130,238,233,9,13,13,9,9,16,0,0,13,39,4,2,0,3,0,1,0,0,0,0,-1773,5,-4,4,-7,0,-26,2,-3,5,14.6,-9.6,1,3,-2,0
16047,14175,220,253,9,4,4,9,15,1,0,0,17,11,4,4,2,1,1,0,0,0,0,0,1872,-33,5,-5,14,0,6,0,1,90.8,6.2,84.6,4,3,1,0
14006,15302,255,249,3,6,6,3,6,5,0,0,16,17,3,2,0,1,0,1,0,0,0,0,-1296,6,-3,3,1,0,-1,1,-1,46.6,57.2,-10.6,3,4,-1,1
16094,15926,276,228,8,8,9,8,4,13,0,0,18,15,2,5,1,1,0,1,0,0,0,0,168,48,0,1,-9,0,3,-3,0,36.6,42.2,-5.6,4,4,0,1
15381,15345,266,278,6,6,6,7,5,1,0,1,16,14,3,2,0,0,0,1,0,1,0,0,36,-12,0,-1,4,0,2,1,0,103.2,120.6,-17.4,4,3,1,0
15700,15809,212,253,9,7,7,9,6,10,0,0,18,58,3,3,1,0,1,0,0,0,0,0,-109,-41,2,-2,-4,0,-40,0,1,46.2,16,30.2,4,4,0,0
14697,15536,262,287,4,6,6,4,5,4,0,1,19,14,4,3,0,0,0,1,0,1,0,0,-839,-25,-2,2,1,0,5,1,0,43.4,40.2,3.2,4,5,-1,0
14951,15693,255,236,5,7,7,5,7,20,0,1,19,16,2,0,0,0,1,0,0,1,0,0,-742,19,-2,2,-13,0,3,2,0,9.8,85.8,-76,3,2,1,1
15083,15307,223,252,5,6,6,5,6,9,0,1,11,15,2,1,0,1,1,0,0,1,0,0,-224,-29,-1,1,-3,0,-4,1,-1,19.2,39,-19.8,4,3,1,0
15850,17169,246,246,8,11,11,8,7,11,0,1,27,21,5,4,0,1,0,1,0,1,0,0,-1319,0,-3,3,-4,0,6,1,-1,35.4,83.4,-48,3,4,-1,0
16489,15186,306,278,7,4,5,7,6,4,0,0,16,114,4,2,1,0,1,0,0,0,0,0,1303,28,3,-2,2,0,-98,2,1,21.6,23,-1.4,4,3,1,1
15891,15974,276,240,5,9,10,5,8,10,1,0,15,18,3,1,0,0,0,1,1,0,0,0,-83,36,-4,5,-2,0,-3,2,0,19.4,38.8,-19.4,5,3,2,1
15655,15664,241,252,7,7,7,7,10,7,0,0,48,27,4,5,2,0,1,0,0,0,0,0,-9,-11,0,0,3,0,21,-1,2,64.8,81.6,-16.8,4,4,0,0
13668,15766,275,303,1,4,4,1,1,3,1,0,17,14,2,4,0,1,1,0,1,0,0,0,-2098,-28,-3,3,-2,0,3,-2,-1,9.6,47,-37.4,4,3,1,0
14900,15566,260,254,4,6,6,4,9,5,0,0,32,14,2,2,1,0,1,0,0,0,0,0,-666,6,-2,2,4,0,18,0,1,12.6,37.8,-25.2,4,4,0,0
15389,16275,274,290,5,8,8,5,4,6,0,0,15,17,1,3,1,1,0,1,0,0,0,0,-886,-16,-3,3,-2,0,-2,-2,0,12.2,38.8,-26.6,4,4,0,0
16839,14917,253,225,11,5,5,11,9,7,0,0,18,19,2,1,0,1,1,0,0,0,0,0,1922,28,6,-6,2,0,-1,1,-1,43.4,32.2,11.2,4,3,1,1
15663,13810,279,243,5,3,3,5,7,6,0,0,15,22,4,6,1,0,0,1,0,0,0,0,1853,36,2,-2,1,0,-7,-2,1,14.4,11.8,2.6,4,3,1,1
14533,15983,270,280,3,6,6,3,2,10,0,1,17,13,1,3,1,0,1,0,0,1,0,0,-1450,-10,-3,3,-8,0,4,-2,1,37.6,39.4,-1.8,4,4,0,1
15643,14459,270,275,6,3,3,6,4,2,0,0,19,150,8,5,1,0,1,0,0,0,0,0,1184,-5,3,-3,2,0,-131,3,1,15.4,85.8,-70.4,5,5,0,1
16187,14460,312,267,5,3,3,5,7,3,1,0,18,48,5,3,1,0,1,0,1,0,0,0,1727,45,2,-2,4,0,-30,2,1,63.6,15.8,47.8,4,2,2,0
14877,15893,245,272,6,6,6,6,5,6,0,1,35,16,2,2,0,3,0,1,0,1,0,0,-1016,-27,0,0,-1,0,19,0,-3,22.6,45.2,-22.6,4,5,-1,0
14263,15583,266,249,3,7,7,3,3,7,0,0,11,14,3,1,0,2,1,0,0,0,0,0,-1320,17,-4,4,-4,0,-3,2,-2,14,32.4,-18.4,3,4,-1,1
17418,13744,311,244,8,2,2,8,8,3,1,0,17,27,2,0,3,1,1,0,1,0,0,0,3674,67,6,-6,5,0,-10,2,2,79,27.4,51.6,4,2,2,1
16059,15219,254,278,8,5,5,8,9,3,0,0,16,12,2,3,0,0,1,0,0,0,0,0,840,-24,3,-3,6,0,4,-1,0,23.6,70.2,-46.6,5,5,0,0
14833,13937,271,262,4,3,3,4,3,3,0,0,29,13,3,0,1,0,0,1,0,0,0,0,896,9,1,-1,0,0,16,3,1,70,43.8,26.2,4,4,0,1
15498,14397,260,267,7,2,2,7,5,2,0,1,16,13,3,5,0,1,0,1,0,1,0,0,1101,-7,5,-5,3,0,3,-2,-1,77.8,50,27.8,5,3,2,1
15678,16127,263,260,5,9,9,5,4,11,0,0,27,14,2,2,0,0,0,1,0,0,0,0,-449,3,-4,4,-7,0,13,0,0,91.2,10.2,81,4,3,1,0
15324,16168,277,302,5,5,5,5,6,6,0,1,18,25,2,4,0,0,1,0,0,1,0,0,-844,-25,0,0,0,0,-7,-2,0,11.8,17.8,-6,4,4,0,0
15188,14964,258,261,6,5,5,6,6,4,0,0,45,17,3,6,0,0,1,0,0,0,0,0,224,-3,1,-1,2,0,28,-3,0,78.4,66.4,12,5,3,2,0
17038,13166,303,268,9,0,0,9,8,0,0,1,22,17,5,2,0,0,1,0,0,1,0,0,3872,35,9,-9,8,0,5,3,0,21.4,19,2.4,3,5,-2,0
15517,14875,234,238,7,6,6,7,13,7,0,0,19,19,1,4,0,1,0,1,0,0,0,0,642,-4,1,-1,6,0,0,-3,-1,15,46.8,-31.8,4,3,1,0
14981,16346,257,253,4,8,8,4,4,8,1,0,15,19,0,1,0,2,1,0,1,0,0,0,-1365,4,-4,4,-4,0,-4,-1,-2,21.2,7.8,13.4,5,3,2,0
15153,16313,255,274,6,8,8,6,5,6,0,0,15,108,5,2,0,0,0,1,0,0,0,0,-1160,-19,-2,2,-1,0,-93,3,0,14.4,34,-19.6,3,5,-2,0
15386,17160,266,274,5,9,9,5,5,14,0,1,18,20,3,2,1,0,1,0,0,1,0,0,-1774,-8,-4,4,-9,0,-2,1,1,5.8,23.4,-17.6,2,5,-3,0
16444,13340,273,247,7,2,2,7,10,2,0,0,16,118,3,2,1,1,1,0,0,0,0,0,3104,26,5,-5,8,0,-102,1,0,26.8,26.4,0.4,3,4,-1,1
13674,15235,276,265,2,5,5,2,1,8,1,0,19,16,4,3,0,0,0,1,1,0,0,0,-1561,11,-3,3,-7,0,3,1,0,7.2,53.6,-46.4,2,4,-2,1
18299,14984,260,260,12,4,4,12,13,4,0,0,18,18,4,3,0,0,0,1,0,0,0,0,3315,0,8,-8,9,0,0,1,0,33.8,49.6,-15.8,5,5,0,1
15344,15160,306,258,4,6,6,4,5,5,1,0,14,51,4,2,0,0,1,0,1,0,0,0,184,48,-2,2,0,0,-37,2,0,15,33.8,-18.8,2,4,-2,1
14474,15354,243,252,4,6,6,4,7,12,0,1,18,100,6,3,0,1,0,1,0,1,0,0,-880,-9,-2,2,-5,0,-82,3,-1,18.6,21.4,-2.8,4,4,0,1
15237,15810,243,263,6,7,7,6,5,9,0,1,14,19,5,2,0,0,0,1,0,1,0,0,-573,-20,-1,1,-4,0,-5,3,0,28,26,2,4,3,1,1
15036,14193,290,252,3,3,3,3,8,2,1,0,17,18,4,1,1,0,0,1,1,0,0,0,843,38,0,0,6,0,-1,3,1,16.4,12.6,3.8,4,4,0,1
16014,15347,278,275,6,5,5,6,10,9,0,0,18,18,3,3,1,0,1,0,0,0,0,0,667,3,1,-1,1,0,0,0,1,23.4,25.2,-1.8,3,3,0,0
14999,17193,233,263,5,10,10,5,7,13,0,0,16,38,6,3,0,1,0,1,0,0,0,0,-2194,-30,-5,5,-6,0,-22,3,-1,15,9.6,5.4,4,4,0,0
14867,15431,258,255,4,6,6,4,8,5,0,0,25,19,5,5,0,1,0,1,0,0,0,0,-564,3,-2,2,3,0,6,0,-1,32,12.6,19.4,5,3,2,1
14610,14139,301,283,2,2,2,2,2,4,0,1,18,18,2,6,0,0,0,1,0,1,0,0,471,18,0,0,-2,0,0,-4,0,13,16.2,-3.2,3,4,-1,1
14688,12719,277,264,3,0,0,3,4,0,0,1,16,16,0,3,1,0,1,0,0,1,0,0,1969,13,3,-3,4,0,0,-3,1,74.6,15.8,58.8,3,4,-1,1
14579,13288,274,251,3,2,2,3,3,3,0,1,15,13,3,2,0,0,1,0,0,1,0,0,1291,23,1,-1,0,0,2,1,0,48.2,25.4,22.8,4,3,1,1
14408,14360,304,315,1,1,1,1,2,1,0,0,14,16,2,3,0,1,1,0,0,0,0,0,48,-11,0,0,1,0,-2,-1,-1,26.2,18.2,8,5,2,3,1
17455,18103,281,281,9,11,11,9,10,10,0,0,107,13,6,3,1,2,0,1,0,0,0,0,-648,0,-2,2,0,0,94,3,-1,27.6,32.6,-5,5,5,0,0
16208,15196,280,273,7,5,5,7,6,3,0,1,13,16,6,4,0,0,1,0,0,1,0,0,1012,7,2,-2,3,0,-3,2,0,91.6,57,34.6,5,5,0,1
14507,15942,263,267,4,6,6,4,3,9,0,0,16,28,4,4,0,2,0,1,0,0,0,0,-1435,-4,-2,2,-6,0,-12,0,-2,20,10.8,9.2,3,4,-1,1
15182,15284,294,296,3,3,3,3,4,5,0,0,19,16,0,2,1,0,0,1,0,0,0,0,-102,-2,0,0,-1,0,3,-2,1,47.8,67.6,-19.8,3,4,-1,0
16030,13568,256,233,9,3,3,9,8,2,0,0,42,13,1,3,0,0,1,0,0,0,0,0,2462,23,6,-6,6,0,29,-2,0,30.8,15.8,15,5,5,0,1
16731,16236,266,268,9,7,7,9,13,10,0,0,17,15,2,3,0,0,1,0,0,0,0,0,495,-2,2,-2,3,0,2,-1,0,74,17.4,56.6,4,3,1,0
14936,15523,286,280,4,5,5,4,5,7,0,0,15,16,4,2,1,1,1,0,0,0,0,0,-587,6,-1,1,-2,0,-1,2,0,16.2,20.4,-4.2,4,5,-1,0
14512,15173,259,277,4,4,4,4,2,4,0,0,18,70,2,2,0,3,1,0,0,0,0,0,-661,-18,0,0,-2,0,-52,0,-3,82,9.6,72.4,4,4,0,1
16066,13818,286,238,6,3,3,6,11,4,1,0,19,43,5,1,1,0,0,1,1,0,0,0,2248,48,3,-3,7,0,-24,4,1,7.4,61.8,-54.4,3,5,-2,1
14644,14962,250,260,5,6,6,5,5,3,0,0,17,16,1,2,0,0,0,1,0,0,0,0,-318,-10,-1,1,2,0,1,-1,0,21.8,12.2,9.6,2,3,-1,0
16572,16838,257,252,8,11,11,8,10,15,0,1,14,16,3,0,0,0,0,1,0,1,0,0,-266,5,-3,3,-5,0,-2,3,0,22.6,11.4,11.2,2,3,-1,0
15820,14153,298,284,5,2,2,5,5,2,1,0,16,17,4,2,1,0,0,1,1,0,0,0,1667,14,3,-3,3,0,-1,2,1,12.2,24.2,-12,4,4,0,1
15018,16086,275,295,5,6,6,5,4,3,0,0,14,16,1,2,0,2,1,0,0,0,0,0,-1068,-20,-1,1,1,0,-2,-1,-2,23.6,19,4.6,3,4,-1,1
17194,15554,230,249,13,7,7,13,18,6,0,0,33,18,5,2,0,0,1,0,0,0,0,0,1640,-19,6,-6,12,0,15,3,0,43.4,12.2,31.2,5,4,1,1
13952,14305,246,265,3,3,4,3,2,2,0,0,17,16,3,2,0,1,1,0,0,0,0,0,-353,-19,0,1,0,0,1,1,-1,110.4,59.8,50.6,4,4,0,1
14051,14532,250,248,4,4,4,4,4,4,0,0,16,28,4,3,0,1,0,1,0,0,0,0,-481,2,0,0,0,0,-12,1,-1,13.6,41.8,-28.2,4,5,-1,1
13514,15663,251,260,3,5,5,3,3,11,1,0,16,17,3,4,0,1,0,1,1,0,0,0,-2149,-9,-2,2,-8,0,-1,-1,-1,17,74.8,-57.8,2,3,-1,0
17082,13315,270,260,10,1,1,10,17,0,0,0,14,10,2,3,0,0,1,0,0,0,0,0,3767,10,9,-9,17,0,4,-1,0,14.8,29.4,-14.6,3,4,-1,1
15129,13971,258,242,6,3,3,6,6,3,1,0,36,29,1,3,1,0,0,1,1,0,0,0,1158,16,3,-3,3,0,7,-2,1,32.4,47.6,-15.2,4,5,-1,1
15750,17972,246,234,7,13,13,7,7,13,0,0,17,35,2,4,0,2,0,1,0,0,0,0,-2222,12,-6,6,-6,0,-18,-2,-2,28.2,46.4,-18.2,4,4,0,0
15858,14681,273,265,6,4,4,6,6,4,0,1,17,15,2,4,0,0,1,0,0,1,0,0,1177,8,2,-2,2,0,2,-2,0,36.2,37.8,-1.6,5,5,0,1
15377,15769,261,246,6,6,6,6,10,10,0,0,13,17,0,4,0,2,1,0,0,0,0,0,-392,15,0,0,0,0,-4,-4,-2,23.2,163.8,-140.6,5,4,1,1
16537,12908,268,250,10,1,1,10,9,2,0,1,15,33,5,2,0,0,1,0,0,1,0,0,3629,18,9,-9,7,0,-18,3,0,22,74.8,-52.8,5,3,2,1
14954,13826,259,282,5,1,1,5,6,0,0,0,16,24,4,3,0,4,1,0,0,0,0,0,1128,-23,4,-4,6,0,-8,1,-4,47.8,61,-13.2,2,4,-2,0
14943,15531,299,262,3,6,6,3,3,6,0,0,14,18,3,2,0,1,0,1,0,0,0,0,-588,37,-3,3,-3,0,-4,1,-1,32.2,13,19.2,5,4,1,1
15052,17328,255,271,5,12,12,5,6,8,0,0,12,16,6,1,0,1,0,1,0,0,0,0,-2276,-16,-7,7,-2,0,-4,5,-1,101.6,27,74.6,5,3,2,0
14077,15229,242,278,5,5,5,5,5,4,0,0,14,34,3,0,0,1,1,0,0,0,0,0,-1152,-36,0,0,1,0,-20,3,-1,37.4,52.8,-15.4,4,3,1,1
17078,15649,271,247,10,7,7,10,14,8,0,1,19,14,6,3,1,0,1,0,0,1,0,0,1429,24,3,-3,6,0,5,3,1,31.8,24.6,7.2,4,5,-1,0
13915,15583,254,270,2,6,6,2,3,5,1,0,15,15,4,1,0,1,0,1,1,0,0,0,-1668,-16,-4,4,-2,0,0,3,-1,49,60,-11,3,5,-2,0
16046,15129,299,277,5,3,3,5,9,4,0,1,116,19,2,2,2,2,0,1,0,1,0,0,917,22,2,-2,5,0,97,0,0,105.6,32.6,73,4,4,0,0
15781,17494,281,292,7,10,10,7,6,9,0,0,14,16,3,3,2,0,0,1,0,0,0,0,-1713,-11,-3,3,-3,0,-2,0,2,12.8,25.2,-12.4,5,5,0,0
16305,14655,234,239,9,4,4,10,17,5,1,0,14,16,4,1,0,2,1,0,1,0,0,0,1650,-5,5,-6,12,0,-2,3,-2,43.4,12.2,31.2,4,4,0,1
14030,16120,264,281,2,6,6,2,3,10,0,0,16,16,5,0,1,1,1,0,0,0,0,0,-2090,-17,-4,4,-7,0,0,5,0,107.6,29,78.6,4,3,1,0
13392,14469,261,298,1,2,2,1,2,2,0,0,34,16,5,3,1,2,0,1,0,0,0,0,-1077,-37,-1,1,0,0,18,2,-1,22.8,67.4,-44.6,5,5,0,1
13914,14246,298,291,1,2,2,1,0,3,0,1,13,17,3,0,1,1,0,1,0,1,0,0,-332,7,-1,1,-3,0,-4,3,0,74,23.6,50.4,4,3,1,0
14852,13801,218,240,8,2,2,9,7,2,0,0,19,19,4,5,0,0,1,0,0,0,0,0,1051,-22,6,-7,5,0,0,-1,0,92,42.2,49.8,5,2,3,1
14689,14891,278,284,4,3,3,4,3,3,0,0,16,15,2,1,0,0,0,1,0,0,0,0,-202,-6,1,-1,0,0,1,1,0,13.2,50.8,-37.6,5,4,1,1
13933,15872,273,274,2,5,5,2,1,8,0,0,17,11,1,6,1,3,0,1,0,0,0,0,-1939,-1,-3,3,-7,0,6,-5,-2,34.6,26.2,8.4,5,5,0,0
15189,15256,254,274,6,5,5,6,6,6,0,0,16,34,2,4,0,0,0,1,0,0,0,0,-67,-20,1,-1,0,0,-18,-2,0,21.2,49,-27.8,2,4,-2,1
16306,16344,275,262,7,7,7,7,12,13,0,1,15,23,5,2,0,1,1,0,0,1,0,0,-38,13,0,0,-1,0,-8,3,-1,39.4,40.4,-1,4,4,0,0
16078,14355,282,258,8,3,3,8,5,3,0,0,16,17,1,2,0,0,1,0,0,0,0,0,1723,24,5,-5,2,0,-1,-1,0,46.2,63,-16.8,3,5,-2,0
14459,15966,257,242,4,8,8,4,4,8,1,0,15,14,4,3,0,2,1,0,1,0,0,0,-1507,15,-4,4,-4,0,1,1,-2,90.8,35.4,55.4,5,5,0,0
13643,17035,232,241,4,12,12,4,2,14,0,1,10,15,4,2,0,0,1,0,0,1,0,0,-3392,-9,-8,8,-12,0,-5,2,0,10.4,45.2,-34.8,4,4,0,0
14364,16014,267,289,4,6,6,4,5,6,0,0,19,17,0,1,0,1,0,1,0,0,0,0,-1650,-22,-2,2,-1,0,2,-1,-1,51.4,22,29.4,5,4,1,1
15237,16065,250,277,5,6,6,5,6,8,0,1,17,21,2,0,0,2,0,1,0,1,0,0,-828,-27,-1,1,-2,0,-4,2,-2,44.8,31.6,13.2,3,4,-1,0
16770,15610,268,243,9,6,6,9,6,6,0,0,18,21,4,2,1,1,1,0,0,0,0,0,1160,25,3,-3,0,0,-3,2,0,11.4,18.8,-7.4,2,5,-3,1
14459,15834,259,264,4,7,7,4,7,11,1,0,26,14,1,5,1,0,0,1,1,0,0,0,-1375,-5,-3,3,-4,0,12,-4,1,27.4,36,-8.6,3,5,-2,0
16069,15656,287,266,6,6,6,6,5,7,0,1,45,14,4,6,1,1,1,0,0,1,0,0,413,21,0,0,-2,0,31,-2,0,9.2,16.4,-7.2,4,5,-1,0
13665,14938,275,267,1,4,4,1,1,5,0,1,18,38,3,4,1,0,0,1,0,1,0,0,-1273,8,-3,3,-4,0,-20,-1,1,13.6,36.4,-22.8,4,5,-1,0
16592,15305,280,257,8,6,6,8,9,8,0,0,91,29,2,6,0,1,0,1,0,0,0,0,1287,23,2,-2,1,0,62,-4,-1,14.4,53.8,-39.4,4,2,2,1
13653,16245,253,267,2,8,8,2,3,13,0,1,15,20,3,2,0,1,1,0,0,1,0,0,-2592,-14,-6,6,-10,0,-5,1,-1,13.6,18.4,-4.8,4,3,1,0
13810,16587,269,284,2,9,9,2,3,11,0,1,13,15,5,4,0,1,0,1,0,1,0,0,-2777,-15,-7,7,-8,0,-2,1,-1,106,62.2,43.8,3,4,-1,0
15923,15165,278,280,5,4,5,5,8,6,0,0,16,17,5,6,3,0,1,0,0,0,0,0,758,-2,1,0,2,0,-1,-1,3,31.6,27,4.6,4,4,0,1
14406,16054,265,287,3,7,7,3,3,6,0,0,14,36,4,5,0,0,1,0,0,0,0,0,-1648,-22,-4,4,-3,0,-22,-1,0,20.2,21.2,-1,4,5,-1,0
15544,14879,239,261,6,4,4,6,8,6,0,0,19,22,3,2,1,2,1,0,0,0,0,0,665,-22,2,-2,2,0,-3,1,-1,62.2,12.4,49.8,4,4,0,0
18052,14802,275,251,12,5,5,12,12,5,0,0,41,12,2,5,2,1,0,1,0,0,0,0,3250,24,7,-7,7,0,29,-3,1,25.2,13.8,11.4,4,2,2,1
15675,14896,291,281,5,4,4,5,3,4,0,1,33,20,8,3,0,1,1,0,0,1,0,0,779,10,1,-1,-1,0,13,5,-1,27.6,15.4,12.2,4,5,-1,1
16570,14406,292,256,7,5,5,7,7,1,0,0,19,19,3,1,1,0,0,1,0,0,0,0,2164,36,2,-2,6,0,0,2,1,22.6,37.8,-15.2,5,5,0,1
14524,15860,248,247,3,8,8,3,3,10,0,0,36,41,7,6,0,0,0,1,0,0,0,0,-1336,1,-5,5,-7,0,-5,1,0,70.8,41.2,29.6,5,5,0,0
15572,14128,286,266,5,2,2,5,4,2,0,0,16,73,4,3,1,0,1,0,0,0,0,0,1444,20,3,-3,2,0,-57,1,1,34.2,14.8,19.4,5,2,3,1
13910,17005,256,309,2,8,8,2,2,6,0,0,18,16,4,3,0,1,0,1,0,0,0,0,-3095,-53,-6,6,-4,0,2,1,-1,26.2,76.8,-50.6,3,5,-2,0
15883,17089,277,265,5,10,10,5,8,13,0,1,15,21,4,3,0,1,0,1,0,1,0,0,-1206,12,-5,5,-5,0,-6,1,-1,14.8,9.2,5.6,3,3,0,1
13234,16159,248,280,1,6,6,2,2,7,0,0,9,28,1,2,0,2,1,0,0,0,0,0,-2925,-32,-5,4,-5,0,-19,-1,-2,52.6,15.2,37.4,5,4,1,0
14791,16556,264,285,5,7,7,5,5,7,0,0,16,70,1,4,0,0,1,0,0,0,0,0,-1765,-21,-2,2,-2,0,-54,-3,0,8.4,12.8,-4.4,3,2,1,1
14362,13473,289,283,2,1,1,2,1,1,0,1,22,107,3,6,0,0,1,0,0,1,0,0,889,6,1,-1,0,0,-85,-3,0,10.2,62.6,-52.4,3,5,-2,1
17122,14370,261,245,9,4,4,9,15,3,0,0,57,34,5,4,0,1,1,0,0,0,0,0,2752,16,5,-5,12,0,23,1,-1,56.4,16.2,40.2,5,2,3,1
13948,15355,272,276,2,5,5,2,1,6,0,1,19,40,4,5,0,1,1,0,0,1,0,0,-1407,-4,-3,3,-5,0,-21,-1,-1,75,23.6,51.4,4,5,-1,0
18161,14933,250,247,13,5,5,14,18,7,0,1,20,18,1,5,1,0,1,0,0,1,0,0,3228,3,8,-9,11,0,2,-4,1,14,15,-1,3,4,-1,1
14078,14978,298,300,1,3,3,1,0,6,0,0,16,14,1,5,0,1,0,1,0,0,0,0,-900,-2,-2,2,-6,0,2,-4,-1,46.2,20.2,26,3,5,-2,1
15395,15644,224,252,7,6,6,7,10,10,0,0,17,34,4,5,0,1,0,1,0,0,0,0,-249,-28,1,-1,0,0,-17,-1,-1,15,36.4,-21.4,3,5,-2,0
14033,17041,261,263,2,11,11,2,1,10,0,0,34,32,5,3,0,1,0,1,0,0,0,0,-3008,-2,-9,9,-9,0,2,2,-1,20.4,36.8,-16.4,3,5,-2,0
14790,15246,263,260,4,5,5,4,3,6,0,0,17,20,2,4,1,0,0,1,0,0,0,0,-456,3,-1,1,-3,0,-3,-2,1,24.4,54,-29.6,4,5,-1,0
15520,15149,279,296,6,4,4,7,3,3,0,0,23,12,2,3,1,0,0,1,0,0,0,0,371,-17,2,-3,0,0,11,-1,1,13.6,11.4,2.2,3,4,-1,1
17134,14777,273,281,9,3,3,9,10,1,0,1,16,13,2,2,1,0,1,0,0,1,0,0,2357,-8,6,-6,9,0,3,0,1,39.4,105.4,-66,5,4,1,1
15380,14878,266,267,5,3,3,5,7,4,0,0,16,113,5,4,0,1,0,1,0,0,0,0,502,-1,2,-2,3,0,-97,1,-1,46,12.6,33.4,4,4,0,1
15006,15782,254,277,6,7,7,6,5,6,0,0,18,14,2,6,0,1,1,0,0,0,0,0,-776,-23,-1,1,-1,0,4,-4,-1,22.2,23.6,-1.4,4,5,-1,1
13879,16128,279,280,1,7,7,1,2,8,0,0,17,12,4,2,0,1,0,1,0,0,0,0,-2249,-1,-6,6,-6,0,5,2,-1,16,15.2,0.8,4,5,-1,0
15315,14802,291,267,4,4,4,4,6,7,0,1,29,18,0,5,1,0,1,0,0,1,0,0,513,24,0,0,-1,0,11,-5,1,35.4,21.2,14.2,4,4,0,0
17188,13930,280,248,9,3,3,9,10,2,0,0,16,18,4,2,0,0,0,1,0,0,0,0,3258,32,6,-6,8,0,-2,2,0,29.2,9,20.2,5,2,3,1
15227,15367,249,255,6,6,6,6,8,13,0,1,16,15,5,3,0,1,0,1,0,1,0,0,-140,-6,0,0,-5,0,1,2,-1,6.8,13,-6.2,3,3,0,0
13936,16020,280,295,2,5,5,2,1,7,0,0,15,18,5,5,0,0,0,1,0,0,0,0,-2084,-15,-3,3,-6,0,-3,0,0,19.8,19.6,0.2,5,3,2,0
15789,15949,271,269,6,7,7,6,7,8,0,1,34,20,2,3,0,0,0,1,0,1,0,0,-160,2,-1,1,-1,0,14,-1,0,20,16,4,5,4,1,1
16081,13998,274,242,7,4,4,7,10,4,0,0,34,16,4,2,1,0,1,0,0,0,0,0,2083,32,3,-3,6,0,18,2,1,22.8,19.2,3.6,5,4,1,1
15413,15922,240,274,8,7,7,8,4,6,0,0,15,15,2,2,0,0,0,1,0,0,0,0,-509,-34,1,-1,-2,0,0,0,0,16.8,5,11.8,3,1,2,0
15458,14586,270,297,6,3,4,6,8,1,0,1,87,14,3,4,0,1,0,1,0,1,0,0,872,-27,3,-2,7,0,73,-1,-1,7.2,29.2,-22,2,5,-3,1
17727,15499,271,211,10,7,7,10,14,8,0,0,18,16,3,1,1,0,1,0,0,0,0,0,2228,60,3,-3,6,0,2,2,1,30.8,15.8,15,3,5,-2,1
17141,13040,301,264,7,0,0,7,13,0,1,0,20,40,6,6,2,0,1,0,1,0,0,0,4101,37,7,-7,13,0,-20,0,2,18.4,23,-4.6,3,4,-1,1
15239,17132,278,244,5,11,11,6,4,17,0,1,15,18,3,2,0,0,0,1,0,1,0,0,-1893,34,-6,5,-13,0,-3,1,0,11,41.6,-30.6,4,4,0,0
14393,15108,290,317,2,2,2,2,4,2,0,0,37,121,5,5,0,2,1,0,0,0,0,0,-715,-27,0,0,2,0,-84,0,-2,25.4,36.8,-11.4,5,5,0,0
17358,15389,260,250,9,8,8,9,10,3,0,0,21,40,3,0,0,1,1,0,0,0,0,0,1969,10,1,-1,7,0,-19,3,-1,20.2,40.2,-20,4,4,0,0
16348,15406,284,230,7,6,6,7,6,8,0,1,15,18,2,3,0,0,0,1,0,1,0,0,942,54,1,-1,-2,0,-3,-1,0,11.8,18.2,-6.4,3,3,0,0
13517,14266,277,260,1,3,3,1,0,4,0,1,22,40,4,2,0,1,1,0,0,1,0,0,-749,17,-2,2,-4,0,-18,2,-1,10,41.8,-31.8,2,5,-3,1
16202,13656,250,245,8,3,3,9,9,2,0,0,19,17,4,3,0,0,1,0,0,0,0,0,2546,5,5,-6,7,0,2,1,0,16.2,38.2,-22,4,5,-1,1
15082,15923,227,267,8,6,7,8,9,8,0,1,21,16,1,4,0,2,0,1,0,1,0,0,-841,-40,2,-1,1,0,5,-3,-2,120.8,22.8,98,4,4,0,1
15663,15137,257,279,6,4,4,6,11,7,0,0,18,17,1,6,0,1,0,1,0,0,0,0,526,-22,2,-2,4,0,1,-5,-1,131,52.4,78.6,5,4,1,1
16766,15178,265,229,9,6,6,9,6,7,0,0,22,19,6,1,2,0,1,0,0,0,0,0,1588,36,3,-3,-1,0,3,5,2,14.2,66.8,-52.6,2,4,-2,1
15723,16874,282,289,5,8,8,5,4,8,0,1,17,15,3,0,0,1,0,1,0,1,0,0,-1151,-7,-3,3,-4,0,2,3,-1,40.4,23.4,17,2,4,-2,0
16194,17076,270,241,8,11,12,8,8,9,0,0,17,14,2,3,0,0,0,1,0,0,0,0,-882,29,-3,4,-1,0,3,-1,0,14.2,18.2,-4,3,4,-1,0
14921,14474,256,265,4,3,3,4,5,4,0,0,27,12,1,5,3,0,1,0,0,0,0,0,447,-9,1,-1,1,0,15,-4,3,17,26,-9,5,3,2,1
15977,13976,286,284,9,2,2,9,11,1,0,0,107,10,1,4,0,1,0,1,0,0,0,0,2001,2,7,-7,10,0,97,-3,-1,60,70,-10,4,4,0,1
16334,14876,269,239,7,5,5,7,15,8,0,0,13,14,2,1,0,1,1,0,0,0,0,0,1458,30,2,-2,7,0,-1,1,-1,39.6,24.4,15.2,4,4,0,0
16655,14615,253,281,9,3,3,9,14,2,0,1,16,35,0,1,0,1,1,0,0,1,0,0,2040,-28,6,-6,12,0,-19,-1,-1,17.2,61.8,-44.6,3,5,-2,1
15078,14220,255,246,5,4,4,5,7,3,0,0,29,17,3,4,1,0,1,0,0,0,0,0,858,9,1,-1,4,0,12,-1,1,84,23.6,60.4,4,5,-1,1
18895,14053,294,288,12,1,1,12,17,0,0,0,13,15,3,2,1,1,1,0,0,0,0,0,4842,6,11,-11,17,0,-2,1,0,53,46.4,6.6,4,5,-1,1
14248,15150,274,261,2,5,5,2,3,6,0,1,59,15,3,6,0,2,0,1,0,1,0,0,-902,13,-3,3,-3,0,44,-3,-2,106.2,79.2,27,4,3,1,0
17371,13324,305,256,8,2,2,8,10,2,1,0,14,45,4,2,2,0,1,0,1,0,0,0,4047,49,6,-6,8,0,-31,2,2,28.8,48.2,-19.4,4,2,2,1
12977,16101,248,276,1,7,7,1,1,5,0,0,31,16,1,5,0,0,0,1,0,0,0,0,-3124,-28,-6,6,-4,0,15,-4,0,25.2,28.4,-3.2,3,4,-1,0
17081,14758,259,229,9,5,5,9,17,9,0,0,18,16,1,1,0,0,1,0,0,0,0,0,2323,30,4,-4,8,0,2,0,0,40.6,32.8,7.8,4,4,0,0
16098,16614,260,266,7,8,8,7,12,13,0,0,105,42,5,3,1,1,0,1,0,0,0,0,-516,-6,-1,1,-1,0,63,2,0,23.6,53.4,-29.8,5,3,2,1
15825,17829,243,258,7,13,13,7,9,21,0,0,10,39,5,2,1,2,0,1,0,0,0,0,-2004,-15,-6,6,-12,0,-29,3,-1,42,22.4,19.6,3,4,-1,0
16860,13339,264,269,9,1,1,9,11,0,0,0,39,17,0,2,1,2,1,0,0,0,0,0,3521,-5,8,-8,11,0,22,-2,-1,42,52,-10,4,4,0,1
17792,13771,261,226,11,5,5,11,10,3,0,0,18,35,2,2,3,0,0,1,0,0,0,0,4021,35,6,-6,7,0,-17,0,3,39.6,71.8,-32.2,3,5,-2,1
16355,17319,230,261,9,10,10,10,10,11,0,0,17,12,1,3,0,1,0,1,0,0,0,0,-964,-31,-1,0,-1,0,5,-2,-1,35.2,50.8,-15.6,5,5,0,0
15327,14150,256,240,6,5,5,6,5,3,0,1,25,121,0,2,0,0,1,0,0,1,0,0,1177,16,1,-1,2,0,-96,-2,0,35.8,31.2,4.6,4,4,0,0
16101,14726,282,263,6,4,4,6,6,4,0,0,33,25,3,1,1,0,1,0,0,0,0,0,1375,19,2,-2,2,0,8,2,1,19.8,74.2,-54.4,4,4,0,0
15969,14477,271,263,7,4,4,7,7,4,0,1,14,31,2,2,0,0,1,0,0,1,0,0,1492,8,3,-3,3,0,-17,0,0,56,49,7,4,3,1,1
14374,15943,239,268,4,7,7,4,3,5,0,0,12,19,2,2,0,1,0,1,0,0,0,0,-1569,-29,-3,3,-2,0,-7,0,-1,101.4,35.4,66,4,4,0,1
14472,17873,232,240,5,13,13,5,3,15,0,1,17,15,5,6,1,0,1,0,0,1,0,0,-3401,-8,-8,8,-12,0,2,-1,1,9.4,10.2,-0.8,2,3,-1,0
15418,16016,290,293,4,5,5,4,7,4,0,0,33,16,1,3,0,1,1,0,0,0,0,0,-598,-3,-1,1,3,0,17,-2,-1,39.6,35.4,4.2,4,4,0,0
16036,14161,263,221,6,4,4,6,10,6,1,0,20,14,2,2,4,0,0,1,1,0,0,0,1875,42,2,-2,4,0,6,0,4,12.2,52.6,-40.4,4,5,-1,1
17545,14127,315,274,8,2,2,8,4,3,0,0,17,38,5,2,2,0,1,0,0,0,0,0,3418,41,6,-6,1,0,-21,3,2,44.2,22,22.2,5,3,2,1
13910,14688,261,272,2,4,4,2,2,7,0,0,15,24,2,5,0,0,0,1,0,0,0,0,-778,-11,-2,2,-5,0,-9,-3,0,33,40.8,-7.8,4,5,-1,1
15787,14980,236,242,8,6,6,8,6,7,0,0,12,32,3,0,1,0,1,0,0,0,0,0,807,-6,2,-2,-1,0,-20,3,1,18.8,5.6,13.2,3,1,2,1
15271,15125,231,260,6,4,4,6,8,7,0,0,14,31,3,0,1,0,1,0,0,0,0,0,146,-29,2,-2,1,0,-17,3,1,14.6,80.8,-66.2,4,3,1,1
16466,13562,263,193,10,4,4,10,10,4,1,0,12,15,2,1,0,0,1,0,1,0,0,0,2904,70,6,-6,6,0,-3,1,0,28.4,5,23.4,3,1,2,1
14573,14029,273,261,4,3,3,4,3,2,1,0,17,16,3,1,0,0,1,0,1,0,0,0,544,12,1,-1,1,0,1,2,0,13,28.6,-15.6,3,4,-1,0
14422,15653,281,273,3,5,5,3,2,6,0,0,37,41,7,3,0,1,1,0,0,0,0,0,-1231,8,-2,2,-4,0,-4,4,-1,29,70.8,-41.8,5,4,1,0
16016,15323,275,286,7,5,5,7,10,4,0,0,16,14,5,3,0,0,0,1,0,0,0,0,693,-11,2,-2,6,0,2,2,0,36.2,40.4,-4.2,4,4,0,1
14801,17883,265,279,4,10,10,4,5,9,0,0,33,18,6,4,0,0,1,0,0,0,0,0,-3082,-14,-6,6,-4,0,15,2,0,28,116.8,-88.8,4,5,-1,0
14605,14122,300,267,2,3,3,2,3,3,0,1,13,14,2,3,1,0,0,1,0,1,0,0,483,33,-1,1,0,0,-1,-1,1,43,36.4,6.6,5,4,1,0
15329,14972,254,260,6,4,4,6,11,7,0,0,20,16,4,3,1,0,1,0,0,0,0,0,357,-6,2,-2,4,0,4,1,1,21,31.8,-10.8,3,4,-1,1
17516,14038,284,230,11,3,3,11,10,2,0,1,15,12,2,2,0,0,1,0,0,1,0,0,3478,54,8,-8,8,0,3,0,0,9,101.2,-92.2,3,3,0,1
14889,14427,253,263,6,4,4,6,2,5,0,1,21,19,2,6,1,0,1,0,0,1,0,0,462,-10,2,-2,-3,0,2,-4,1,30.8,14.6,16.2,4,3,1,1
15190,16613,252,251,5,9,9,5,7,8,0,0,12,16,5,0,1,2,0,1,0,0,0,0,-1423,1,-4,4,-1,0,-4,5,-1,46.6,28.2,18.4,3,4,-1,0
15387,14757,267,283,5,3,3,5,4,3,0,1,19,44,5,6,0,0,1,0,0,1,0,0,630,-16,2,-2,1,0,-25,-1,0,60.2,82.2,-22,5,5,0,1
15344,16414,272,242,5,10,11,5,5,8,0,0,18,28,5,3,0,0,1,0,0,0,0,0,-1070,30,-5,6,-3,0,-10,2,0,4,13,-9,1,4,-3,0
14038,14809,294,274,1,4,4,1,1,7,0,0,15,18,6,0,0,0,0,1,0,0,0,0,-771,20,-3,3,-6,0,-3,6,0,14,49.2,-35.2,3,5,-2,0
14220,13943,255,248,4,3,3,4,5,2,1,0,17,17,1,3,0,1,0,1,1,0,0,0,277,7,1,-1,3,0,0,-2,-1,36.8,13.2,23.6,3,5,-2,1
14244,15100,255,238,4,6,6,4,5,5,0,0,15,18,4,5,0,1,0,1,0,0,0,0,-856,17,-2,2,0,0,-3,-1,-1,56.4,8.8,47.6,3,2,1,0
14601,15199,239,275,4,6,6,4,8,5,0,1,11,74,5,1,0,0,0,1,0,1,0,0,-598,-36,-2,2,3,0,-63,4,0,22.4,7.2,15.2,4,3,1,0
14100,14924,265,266,4,5,5,4,0,2,0,0,40,148,1,3,1,2,1,0,0,0,0,0,-824,-1,-1,1,-2,0,-108,-2,-1,61.6,21,40.6,3,4,-1,0
16936,17259,255,283,10,10,10,10,8,10,1,0,15,17,2,3,1,0,0,1,1,0,0,0,-323,-28,0,0,-2,0,-2,-1,1,28.6,107,-78.4,4,5,-1,1
14957,15593,277,277,5,5,5,5,1,5,0,0,18,15,3,7,0,0,1,0,0,0,0,0,-636,0,0,0,-4,0,3,-4,0,20,19.6,0.4,4,5,-1,1
14013,13376,305,296,1,0,0,1,0,0,0,0,37,19,4,2,0,0,1,0,0,0,0,0,637,9,1,-1,0,0,18,2,0,270.2,103,167.2,5,3,2,1
14457,16044,277,230,3,9,9,3,2,12,1,0,16,22,2,1,1,1,1,0,1,0,0,0,-1587,47,-6,6,-10,0,-6,1,0,25.8,38.6,-12.8,5,3,2,1
16385,14672,269,290,8,3,3,8,11,2,1,0,35,17,2,3,0,0,1,0,1,0,0,0,1713,-21,5,-5,9,0,18,-1,0,139,23.8,115.2,5,4,1,1
15558,14228,289,267,6,3,3,7,4,2,1,0,17,18,2,3,2,0,0,1,1,0,0,0,1330,22,3,-4,2,0,-1,-1,2,69.8,24.2,45.6,4,4,0,1
14949,15031,256,236,6,6,6,6,3,8,0,0,18,27,2,0,0,0,1,0,0,0,0,0,-82,20,0,0,-5,0,-9,2,0,103,21,82,3,4,-1,0
14711,14460,288,281,3,2,2,3,3,2,0,0,15,14,3,3,0,2,0,1,0,0,0,0,251,7,1,-1,1,0,1,0,-2,23.8,78.6,-54.8,5,4,1,0
18240,14338,239,229,14,6,6,14,14,2,0,1,17,44,4,3,2,0,0,1,0,1,0,0,3902,10,8,-8,12,0,-27,1,2,30.6,32.2,-1.6,4,3,1,1
14076,14644,240,282,3,3,3,3,4,3,0,0,16,16,3,2,0,0,0,1,0,0,0,0,-568,-42,0,0,1,0,0,1,0,83.4,45.2,38.2,3,5,-2,0
15496,13384,297,261,4,2,2,4,1,0,0,1,17,40,2,6,3,0,0,1,0,1,0,0,2112,36,2,-2,1,0,-23,-4,3,51.2,43.4,7.8,5,3,2,1
15978,14677,268,257,7,4,5,7,7,4,0,0,12,16,3,1,1,1,1,0,0,0,0,0,1301,11,3,-2,3,0,-4,2,0,24,39.2,-15.2,4,5,-1,0
15808,15137,266,272,5,3,3,5,9,6,0,0,16,20,6,1,1,0,1,0,0,0,0,0,671,-6,2,-2,3,0,-4,5,1,53.2,36.2,17,4,4,0,0
14188,16332,229,272,5,7,7,5,4,6,0,0,13,55,2,1,0,3,1,0,0,0,0,0,-2144,-43,-2,2,-2,0,-42,1,-3,11.2,189.2,-178,3,3,0,1
15225,15716,263,246,6,6,6,6,8,7,0,0,12,26,3,3,0,1,1,0,0,0,0,0,-491,17,0,0,1,0,-14,0,-1,16.2,29.6,-13.4,2,4,-2,1
7097,8204,104,140,0,1,1,0,0,0,0,0,6,6,0,0,0,0,0,1,0,0,0,0,-1107,-36,-1,1,0,0,0,0,0,25,22.8,2.2,4,4,0,0
14196,15071,246,220,4,7,7,4,5,9,1,0,15,14,1,1,1,2,0,1,1,0,0,0,-875,26,-3,3,-4,0,1,0,-1,20.8,28.2,-7.4,4,4,0,1
14673,15877,233,253,4,7,7,4,7,10,0,0,16,16,4,5,2,1,0,1,0,0,0,0,-1204,-20,-3,3,-3,0,0,-1,1,42.8,40.4,2.4,3,2,1,0
14581,15086,237,249,5,5,5,5,7,9,0,1,37,15,1,3,1,1,1,0,0,1,0,0,-505,-12,0,0,-2,0,22,-2,0,10.6,9.8,0.8,2,3,-1,0
14554,16262,240,266,5,8,8,5,4,15,0,1,12,19,6,4,0,1,0,1,0,1,0,0,-1708,-26,-3,3,-11,0,-7,2,-1,28.6,18.8,9.8,4,3,1,0
14580,15375,278,265,3,5,5,3,4,8,0,0,29,14,1,6,0,1,1,0,0,0,0,0,-795,13,-2,2,-4,0,15,-5,-1,42.4,29.4,13,3,5,-2,1
16383,17534,245,236,8,12,12,8,7,10,0,0,13,15,0,2,2,1,1,0,0,0,0,0,-1151,9,-4,4,-3,0,-2,-2,1,21.4,12,9.4,3,2,1,0
16288,16149,271,232,7,9,9,7,8,10,0,0,20,36,4,2,2,0,0,1,0,0,0,0,139,39,-2,2,-2,0,-16,2,2,15.4,66.2,-50.8,4,4,0,1
14962,13461,223,246,7,2,3,7,2,2,0,0,33,38,4,3,1,0,1,0,0,0,0,0,1501,-23,5,-4,0,0,-5,1,1,72.2,13.8,58.4,5,3,2,1
16918,15264,236,246,12,7,7,12,17,4,1,0,13,32,1,2,3,1,1,0,1,0,0,0,1654,-10,5,-5,13,0,-19,-1,2,16.4,43.8,-27.4,4,4,0,1
15182,16375,266,264,6,9,9,6,2,10,0,0,18,15,3,2,0,0,0,1,0,0,0,0,-1193,2,-3,3,-8,0,3,1,0,26,51.2,-25.2,3,5,-2,0
14020,14336,246,274,4,2,2,5,3,2,0,0,17,31,2,1,0,3,1,0,0,0,0,0,-316,-28,2,-3,1,0,-14,1,-3,17,19.8,-2.8,4,3,1,1
14607,16690,240,207,5,11,11,5,6,18,0,0,42,18,1,8,0,0,0,1,0,0,0,0,-2083,33,-6,6,-12,0,24,-7,0,68,13,55,2,3,-1,0
14278,14703,261,275,3,4,4,3,2,2,0,0,17,33,2,2,1,0,0,1,0,0,0,0,-425,-14,-1,1,0,0,-16,0,1,24.6,14.2,10.4,2,5,-3,0
13656,14251,290,283,1,2,2,1,0,1,1,0,15,16,4,3,0,1,0,1,1,0,0,0,-595,7,-1,1,-1,0,-1,1,-1,70.6,11,59.6,4,4,0,0
14676,13202,282,239,3,2,2,3,2,3,0,0,14,13,3,1,1,0,0,1,0,0,0,0,1474,43,1,-1,-1,0,1,2,1,26,26.8,-0.8,5,4,1,1
16915,16559,242,252,11,8,8,11,12,8,0,0,14,18,5,3,0,2,1,0,0,0,0,0,356,-10,3,-3,4,0,-4,2,-2,32.2,111.2,-79,2,4,-2,0
17139,17085,242,235,10,10,10,10,13,13,0,0,19,14,2,4,1,1,1,0,0,0,0,0,54,7,0,0,0,0,5,-2,0,20.2,11,9.2,5,3,2,0
13283,16750,242,268,2,10,10,2,1,12,1,0,15,37,3,4,0,0,0,1,1,0,0,0,-3467,-26,-8,8,-11,0,-22,-1,0,14.2,15.4,-1.2,4,5,-1,0
15844,13969,254,260,6,2,2,6,9,3,1,0,19,17,3,2,2,1,1,0,1,0,0,0,1875,-6,4,-4,6,0,2,1,1,92.2,8.6,83.6,4,2,2,1
16139,14881,295,272,6,4,4,7,6,2,0,0,14,13,5,3,0,0,1,0,0,0,0,0,1258,23,2,-3,4,0,1,2,0,10.8,23.4,-12.6,3,4,-1,1
14970,16312,291,259,3,8,8,3,2,12,0,0,72,19,3,5,2,3,0,1,0,0,0,0,-1342,32,-5,5,-10,0,53,-2,-1,19.6,19.8,-0.2,4,2,2,0
14859,15515,263,278,6,6,6,6,2,5,0,0,15,12,1,0,0,1,1,0,0,0,0,0,-656,-15,0,0,-3,0,3,1,-1,28.8,59.8,-31,3,5,-2,0
16599,13078,291,240,7,1,1,7,8,2,0,0,40,16,3,3,1,0,1,0,0,0,0,0,3521,51,6,-6,6,0,24,0,1,7.8,20.2,-12.4,2,4,-2,1
13156,17084,232,267,2,10,10,2,1,16,0,0,11,39,2,2,1,3,0,1,0,0,0,0,-3928,-35,-8,8,-15,0,-28,0,-2,8.4,37.6,-29.2,3,5,-2,0
16571,12938,291,243,8,1,1,8,4,2,0,0,13,15,4,1,1,0,1,0,0,0,0,0,3633,48,7,-7,2,0,-2,3,1,15.2,65.8,-50.6,5,4,1,1
15998,13452,294,251,5,2,2,5,5,1,0,1,16,29,4,5,2,1,1,0,0,1,0,0,2546,43,3,-3,4,0,-13,-1,1,23.2,77.8,-54.6,1,5,-4,1
15602,16270,275,295,5,6,6,5,4,9,0,0,18,14,2,2,0,1,1,0,0,0,0,0,-668,-20,-1,1,-5,0,4,0,-1,31.2,20,11.2,3,4,-1,0
14153,13874,296,263,2,2,2,2,1,2,1,0,19,14,1,1,1,0,0,1,1,0,0,0,279,33,0,0,-1,0,5,0,1,26,139.2,-113.2,4,4,0,1
15609,15697,286,276,5,6,6,5,5,4,0,0,12,18,4,0,1,0,1,0,0,0,0,0,-88,10,-1,1,1,0,-6,4,1,78,41.6,36.4,5,5,0,0
15194,14605,278,251,4,5,5,4,5,3,0,1,33,18,2,1,2,2,1,0,0,1,0,0,589,27,-1,1,2,0,15,1,0,17.2,17.4,-0.2,4,4,0,0
13787,14844,247,266,3,3,3,3,4,8,0,0,31,20,4,3,0,1,1,0,0,0,0,0,-1057,-19,0,0,-4,0,11,1,-1,26.2,28.6,-2.4,5,4,1,1
16352,14748,287,253,7,4,4,7,7,5,0,1,17,22,5,0,1,0,1,0,0,1,0,0,1604,34,3,-3,2,0,-5,5,1,7.2,30.8,-23.6,2,5,-3,0
16067,13590,247,223,10,3,3,10,9,5,0,0,15,12,1,1,1,0,1,0,0,0,0,0,2477,24,7,-7,4,0,3,0,1,41.8,42.4,-0.6,4,4,0,1
17101,13807,271,215,10,5,5,11,5,5,0,0,17,12,1,4,1,0,1,0,0,0,0,0,3294,56,5,-6,0,0,5,-3,1,138.8,16.4,122.4,5,4,1,1
15059,14712,268,271,5,3,3,5,5,4,0,1,30,17,2,1,0,1,1,0,0,1,0,0,347,-3,2,-2,1,0,13,1,-1,26.8,87.4,-60.6,5,4,1,0
16465,14584,275,274,8,2,2,8,11,2,0,0,15,17,2,3,1,1,1,0,0,0,0,0,1881,1,6,-6,9,0,-2,-1,0,187.4,27.4,160,5,3,2,1
14462,16340,261,249,4,8,8,4,2,9,0,0,34,17,3,4,0,1,1,0,0,0,0,0,-1878,12,-4,4,-7,0,17,-1,-1,6.6,21.2,-14.6,2,3,-1,0
15408,13667,257,245,7,3,3,7,5,5,0,0,33,16,0,2,0,0,1,0,0,0,0,0,1741,12,4,-4,0,0,17,-2,0,17.4,30.6,-13.2,4,4,0,1
16534,14532,299,239,6,4,4,6,8,8,0,0,16,11,1,5,0,0,1,0,0,0,0,0,2002,60,2,-2,0,0,5,-4,0,9.8,25.4,-15.6,3,4,-1,1
15496,13840,254,247,6,3,3,6,13,5,0,0,15,13,4,4,1,0,1,0,0,0,0,0,1656,7,3,-3,8,0,2,0,1,69,19.2,49.8,4,5,-1,1
15120,15913,263,280,5,6,6,5,6,9,0,1,43,18,4,3,1,0,0,1,0,1,0,0,-793,-17,-1,1,-3,0,25,1,1,47,84.6,-37.6,4,3,1,0
13831,17014,270,250,1,11,11,1,2,18,0,1,9,26,3,3,0,1,0,1,0,1,0,0,-3183,20,-10,10,-16,0,-17,0,-1,16,43.4,-27.4,4,5,-1,0
14411,16025,292,258,2,7,7,2,2,6,0,1,17,18,5,3,0,3,0,1,0,1,0,0,-1614,34,-5,5,-4,0,-1,2,-3,23.6,27.2,-3.6,4,2,2,0
15320,16224,239,242,7,9,9,8,9,11,0,0,15,13,3,3,0,1,0,1,0,0,0,0,-904,-3,-2,1,-2,0,2,0,-1,66.8,10.2,56.6,4,4,0,1
16344,14103,291,273,7,2,2,7,5,4,0,0,13,16,6,4,1,0,1,0,0,0,0,0,2241,18,5,-5,1,0,-3,2,1,68.4,45.6,22.8,5,5,0,1
17766,15870,256,250,14,7,8,14,9,9,0,0,36,16,2,2,1,0,1,0,0,0,0,0,1896,6,7,-6,0,0,20,0,1,65.2,24.8,40.4,5,5,0,1
13982,14562,296,296,1,2,2,1,0,2,0,0,109,14,2,4,0,0,1,0,0,0,0,0,-580,0,-1,1,-2,0,95,-2,0,44.8,51.4,-6.6,5,3,2,0
14033,18018,232,265,4,14,14,4,6,19,0,0,18,16,3,6,1,1,1,0,0,0,0,0,-3985,-33,-10,10,-13,0,2,-3,0,14.2,19.6,-5.4,3,4,-1,0
14174,15865,278,302,3,5,5,3,3,11,0,0,19,23,5,5,0,1,0,1,0,0,0,0,-1691,-24,-2,2,-8,0,-4,0,-1,47.6,41.4,6.2,5,5,0,0
13468,15515,262,313,1,3,3,1,2,3,0,0,12,17,5,4,1,1,0,1,0,0,0,0,-2047,-51,-2,2,-1,0,-5,1,0,16.8,16,0.8,4,4,0,0
14950,14361,300,278,3,3,3,3,0,3,0,1,12,17,5,3,0,0,0,1,0,1,0,0,589,22,0,0,-3,0,-5,2,0,36.2,8.4,27.8,4,2,2,1
14969,18213,230,257,5,12,12,5,4,12,0,0,18,17,3,3,0,2,0,1,0,0,0,0,-3244,-27,-7,7,-8,0,1,0,-2,9.8,12.4,-2.6,2,4,-2,0
15561,14305,243,227,7,4,4,7,11,5,0,0,36,13,2,2,1,0,0,1,0,0,0,0,1256,16,3,-3,6,0,23,0,1,23.8,52.6,-28.8,4,3,1,0
14715,14907,249,255,5,5,5,5,6,8,0,0,13,22,6,1,0,0,1,0,0,0,0,0,-192,-6,0,0,-2,0,-9,5,0,10.2,145.2,-135,4,5,-1,0
14349,15280,284,274,3,5,5,3,1,4,0,0,17,13,4,4,1,0,0,1,0,0,0,0,-931,10,-2,2,-3,0,4,0,1,27.6,34.8,-7.2,5,4,1,0
14332,13797,279,296,3,1,1,3,7,0,0,0,17,17,5,3,0,0,1,0,0,0,0,0,535,-17,2,-2,7,0,0,2,0,58.8,24.8,34,4,4,0,0
15595,14634,255,244,6,5,5,6,10,7,0,1,27,17,3,8,1,1,0,1,0,1,0,0,961,11,1,-1,3,0,10,-5,0,68,14,54,4,4,0,0
14177,18630,267,268,3,13,13,3,3,12,0,0,20,14,2,3,0,3,0,1,0,0,0,0,-4453,-1,-10,10,-9,0,6,-1,-3,62.8,26.2,36.6,4,4,0,0
15060,16586,260,273,4,7,7,4,7,10,0,0,18,19,1,4,0,2,0,1,0,0,0,0,-1526,-13,-3,3,-3,0,-1,-3,-2,24.8,29.4,-4.6,5,2,3,0
17548,14101,283,257,9,2,2,9,8,2,0,0,19,16,4,0,3,0,1,0,0,0,0,0,3447,26,7,-7,6,0,3,4,3,16.2,23.6,-7.4,4,4,0,1
14107,13975,285,276,2,2,2,2,0,2,1,0,227,16,3,1,1,0,0,1,1,0,0,0,132,9,0,0,-2,0,211,2,1,29,55.6,-26.6,3,4,-1,1
16504,14087,254,236,9,4,5,9,6,2,0,0,33,21,4,2,2,0,1,0,0,0,0,0,2417,18,5,-4,4,0,12,2,2,21,24,-3,5,3,2,1
15610,15561,255,252,6,6,6,6,7,6,0,0,20,19,3,6,0,0,0,1,0,0,0,0,49,3,0,0,1,0,1,-3,0,183.2,114.2,69,4,4,0,0
15718,15040,267,255,6,5,5,6,6,6,0,0,18,16,4,3,0,2,1,0,0,0,0,0,678,12,1,-1,0,0,2,1,-2,26,59.8,-33.8,5,5,0,1
15646,15185,251,242,7,7,7,7,9,11,1,0,15,14,2,4,1,0,1,0,1,0,0,0,461,9,0,0,-2,0,1,-2,1,66.6,32.8,33.8,3,3,0,0
14846,15276,280,264,4,6,6,5,2,5,0,1,29,17,1,4,1,1,1,0,0,1,0,0,-430,16,-2,1,-3,0,12,-3,0,18.8,41.2,-22.4,4,5,-1,0
14785,13501,288,273,5,1,1,5,1,0,1,0,17,123,3,3,0,0,1,0,1,0,0,0,1284,15,4,-4,1,0,-106,0,0,17,25.6,-8.6,3,3,0,0
15304,14235,290,265,4,3,3,4,5,4,0,1,70,155,5,3,0,1,0,1,0,1,0,0,1069,25,1,-1,1,0,-85,2,-1,10,29.2,-19.2,4,4,0,0
14880,15067,264,258,4,5,5,4,3,5,0,0,16,15,1,4,1,0,0,1,0,0,0,0,-187,6,-1,1,-2,0,1,-3,1,53.2,12.2,41,5,3,2,1
14621,15408,243,283,5,5,5,5,8,4,0,0,36,15,2,7,0,2,0,1,0,0,0,0,-787,-40,0,0,4,0,21,-5,-2,24.6,11.8,12.8,3,4,-1,1
14448,15805,255,292,4,5,5,4,2,5,0,0,12,14,0,1,1,0,0,1,0,0,0,0,-1357,-37,-1,1,-3,0,-2,-1,1,11.4,28.4,-17,3,5,-2,0
13996,16414,277,264,2,8,8,2,1,8,0,1,14,17,2,0,2,0,1,0,0,1,0,0,-2418,13,-6,6,-7,0,-3,2,2,21.2,9.4,11.8,4,4,0,0
15468,16281,285,288,4,6,6,4,3,4,0,0,17,21,3,5,1,2,1,0,0,0,0,0,-813,-3,-2,2,-1,0,-4,-2,-1,180.6,11.8,168.8,5,4,1,0
14520,14742,258,246,3,5,5,3,3,5,0,0,15,20,8,0,1,1,0,1,0,0,0,0,-222,12,-2,2,-2,0,-5,8,0,49.2,16,33.2,4,4,0,1
15530,15717,260,264,7,7,7,7,6,5,0,1,25,13,3,3,0,0,1,0,0,1,0,0,-187,-4,0,0,1,0,12,0,0,32.6,7.6,25,4,3,1,1
18719,14526,286,241,11,4,4,11,12,6,0,0,37,19,5,4,3,1,0,1,0,0,0,0,4193,45,7,-7,6,0,18,1,2,204.6,30.4,174.2,5,2,3,1
14321,14695,237,262,5,4,4,5,4,2,0,1,17,18,3,6,0,0,1,0,0,1,0,0,-374,-25,1,-1,2,0,-1,-3,0,24.6,19.8,4.8,5,5,0,0
15741,16847,254,270,7,9,9,7,9,13,0,1,22,18,4,4,2,0,0,1,0,1,0,0,-1106,-16,-2,2,-4,0,4,0,2,13,40.4,-27.4,2,4,-2,0
15239,16255,252,251,6,7,7,6,7,12,0,0,17,16,2,4,0,0,0,1,0,0,0,0,-1016,1,-1,1,-5,0,1,-2,0,28.8,14,14.8,4,4,0,1
16405,15827,259,257,8,7,7,8,10,7,0,0,20,39,6,1,0,1,0,1,0,0,0,0,578,2,1,-1,3,0,-19,5,-1,8.4,13.8,-5.4,4,3,1,1
14845,15378,289,288,4,4,4,4,2,7,1,0,18,113,5,3,1,1,0,1,1,0,0,0,-533,1,0,0,-5,0,-95,2,0,16.4,20,-3.6,5,2,3,1
15055,16261,256,269,5,7,7,5,4,9,0,0,14,90,0,3,1,1,1,0,0,0,0,0,-1206,-13,-2,2,-5,0,-76,-3,0,52.8,22.2,30.6,4,3,1,1
16295,17309,260,250,6,13,13,6,9,10,0,0,34,19,4,3,0,0,0,1,0,0,0,0,-1014,10,-7,7,-1,0,15,1,0,51.4,34.8,16.6,4,3,1,0
14825,15778,276,276,4,6,6,4,2,7,0,1,15,19,2,2,1,1,0,1,0,1,0,0,-953,0,-2,2,-5,0,-4,0,0,24.8,26,-1.2,3,5,-2,0
14255,16584,229,269,4,8,8,4,5,13,0,0,18,146,4,4,1,0,0,1,0,0,0,0,-2329,-40,-4,4,-8,0,-128,0,1,58.6,38.8,19.8,5,4,1,0
15196,17741,255,273,5,11,11,5,4,15,1,0,113,18,2,1,0,1,1,0,1,0,0,0,-2545,-18,-6,6,-11,0,95,1,-1,56.6,21,35.6,5,3,2,0
15802,14990,264,263,6,5,8,6,7,3,0,0,19,55,2,1,3,1,0,1,0,0,0,0,812,1,1,2,4,0,-36,1,2,48,11,37,4,2,2,0
18113,15338,290,258,10,4,4,10,9,5,0,0,34,14,4,3,3,1,0,1,0,0,0,0,2775,32,6,-6,4,0,20,1,2,20,20.4,-0.4,5,3,2,1
14781,14963,267,271,4,4,4,4,3,5,0,0,15,18,6,4,0,2,0,1,0,0,0,0,-182,-4,0,0,-2,0,-3,2,-2,23.6,43.2,-19.6,3,5,-2,0
15717,14864,255,264,7,5,5,7,10,8,0,1,17,15,2,1,0,1,1,0,0,1,0,0,853,-9,2,-2,2,0,2,1,-1,20.6,74.2,-53.6,3,4,-1,0
13978,15113,267,273,3,4,4,3,1,5,0,0,18,14,3,2,0,0,0,1,0,0,0,0,-1135,-6,-1,1,-4,0,4,1,0,19.6,90.2,-70.6,5,4,1,0
15344,14115,285,259,5,3,3,5,4,4,0,0,11,25,2,2,2,0,1,0,0,0,0,0,1229,26,2,-2,0,0,-14,0,2,13.2,16.2,-3,4,4,0,1
15896,16439,237,281,8,6,6,8,7,11,0,0,16,17,4,4,0,0,1,0,0,0,0,0,-543,-44,2,-2,-4,0,-1,0,0,42.4,9.2,33.2,4,4,0,0
14336,18004,257,292,3,9,9,3,7,12,0,0,14,19,5,3,1,3,0,1,0,0,0,0,-3668,-35,-6,6,-5,0,-5,2,-2,21,20,1,4,4,0,1
15801,15267,261,237,6,6,6,6,7,4,0,0,126,14,4,4,2,0,0,1,0,0,0,0,534,24,0,0,3,0,112,0,2,48.2,11,37.2,3,3,0,1
14991,14564,269,270,4,4,4,4,2,9,0,1,17,90,3,1,1,0,0,1,0,1,0,0,427,-1,0,0,-7,0,-73,2,1,15.2,110,-94.8,4,4,0,1
13719,14531,292,300,1,2,2,1,1,1,0,0,14,14,4,2,0,0,1,0,0,0,0,0,-812,-8,-1,1,0,0,0,2,0,11.8,81.8,-70,5,4,1,0
13639,16172,287,309,1,6,6,1,1,4,0,0,16,15,5,5,0,1,1,0,0,0,0,0,-2533,-22,-5,5,-3,0,1,0,-1,45,20.6,24.4,4,4,0,0
15726,14820,287,310,5,3,3,5,6,1,0,1,14,15,3,3,0,0,0,1,0,1,0,0,906,-23,2,-2,5,0,-1,0,0,11.2,11.2,0,4,4,0,1
17330,12726,276,217,11,2,2,11,6,1,1,0,15,12,3,3,2,0,1,0,1,0,0,0,4604,59,9,-9,5,0,3,0,2,58.4,27.2,31.2,5,4,1,1
14254,15535,270,270,3,7,7,3,1,11,0,1,16,17,1,3,0,0,1,0,0,1,0,0,-1281,0,-4,4,-10,0,-1,-2,0,19.8,16.4,3.4,4,4,0,0
14661,14851,238,271,6,4,5,6,3,5,0,0,15,16,2,5,0,0,1,0,0,0,0,0,-190,-33,2,-1,-2,0,-1,-3,0,49.4,50.6,-1.2,4,3,1,0
16897,13844,281,265,10,2,2,10,6,3,0,1,18,24,2,5,0,0,1,0,0,1,0,0,3053,16,8,-8,3,0,-6,-3,0,25,20.2,4.8,4,5,-1,1
14516,14928,273,276,3,4,4,3,2,3,0,0,15,36,2,3,0,2,0,1,0,0,0,0,-412,-3,-1,1,-1,0,-21,-1,-2,32.6,13.2,19.4,3,4,-1,0
13777,16646,256,270,3,8,8,3,3,10,0,0,16,23,1,6,0,1,1,0,0,0,0,0,-2869,-14,-5,5,-7,0,-7,-5,-1,20.4,15,5.4,4,4,0,1
17479,17722,259,270,10,12,12,10,15,15,0,0,19,13,2,4,0,0,0,1,0,0,0,0,-243,-11,-2,2,0,0,6,-2,0,19,15.8,3.2,4,4,0,1
14385,14974,252,248,4,5,5,4,3,8,0,0,48,16,2,4,0,1,0,1,0,0,0,0,-589,4,-1,1,-5,0,32,-2,-1,13.6,25,-11.4,5,5,0,1
15009,14853,250,232,5,6,6,5,4,7,0,0,18,15,1,3,0,0,0,1,0,0,0,0,156,18,-1,1,-3,0,3,-2,0,28,87,-59,3,5,-2,0
13670,17365,280,292,1,8,8,1,1,11,0,0,113,22,5,2,0,2,0,1,0,0,0,0,-3695,-12,-7,7,-10,0,91,3,-2,35.2,18,17.2,5,4,1,0
15325,13356,277,249,6,2,2,6,3,1,1,0,17,24,5,2,1,0,1,0,1,0,0,0,1969,28,4,-4,2,0,-7,3,1,19,18.4,0.6,5,3,2,1
15443,15572,263,270,5,5,6,5,4,6,0,1,15,17,3,3,2,2,1,0,0,1,0,0,-129,-7,0,1,-2,0,-2,0,0,30.8,40.4,-9.6,4,5,-1,0
14856,17653,253,264,4,11,11,4,7,12,0,0,17,16,2,3,2,2,1,0,0,0,0,0,-2797,-11,-7,7,-5,0,1,-1,0,16.6,72.4,-55.8,3,5,-2,0
15273,15271,246,264,5,6,6,5,6,7,0,0,118,16,3,4,1,1,1,0,0,0,0,0,2,-18,-1,1,-1,0,102,-1,0,12.4,29.8,-17.4,4,4,0,1
14279,13738,282,263,2,2,2,2,2,1,0,0,15,21,3,2,0,1,0,1,0,0,0,0,541,19,0,0,1,0,-6,1,-1,16.8,19.6,-2.8,4,5,-1,1
15077,14707,282,269,4,4,4,4,6,5,0,0,19,16,3,3,1,0,0,1,0,0,0,0,370,13,0,0,1,0,3,0,1,33,20,13,4,4,0,0
14914,13956,260,270,5,3,3,5,3,3,0,1,16,15,3,6,0,0,0,1,0,1,0,0,958,-10,2,-2,0,0,1,-3,0,74.8,28.2,46.6,4,4,0,1
15582,15252,240,217,8,7,7,8,5,10,0,0,28,17,3,3,1,0,1,0,0,0,0,0,330,23,1,-1,-5,0,11,0,1,40.6,9.4,31.2,5,4,1,1
17497,15521,262,255,9,7,7,9,16,8,0,0,14,28,1,2,1,0,1,0,0,0,0,0,1976,7,2,-2,8,0,-14,-1,1,31.4,11,20.4,4,3,1,1
13121,16149,237,269,1,8,8,1,1,4,1,0,14,39,0,3,1,2,0,1,1,0,0,0,-3028,-32,-7,7,-3,0,-25,-3,-1,164.8,52.4,112.4,4,4,0,0
16438,14487,251,233,10,4,4,10,8,4,0,0,32,15,1,2,2,0,1,0,0,0,0,0,1951,18,6,-6,4,0,17,-1,2,35.8,18,17.8,3,4,-1,0
15249,13943,245,220,7,5,5,7,3,5,0,1,13,11,1,1,0,0,1,0,0,1,0,0,1306,25,2,-2,-2,0,2,0,0,9,13.2,-4.2,3,4,-1,1
14643,14373,244,248,6,5,5,6,4,1,0,0,14,17,1,3,0,1,0,1,0,0,0,0,270,-4,1,-1,3,0,-3,-2,-1,46.6,102.6,-56,3,4,-1,0
15412,13441,299,267,3,1,2,3,2,1,0,0,35,17,5,1,3,0,1,0,0,0,0,0,1971,32,2,-1,1,0,18,4,3,27.6,21.4,6.2,5,3,2,0
13914,15700,280,271,2,6,6,2,1,9,0,1,16,32,1,1,0,0,1,0,0,1,0,0,-1786,9,-4,4,-8,0,-16,0,0,122.8,19.2,103.6,5,5,0,1
15175,16123,261,254,5,9,9,5,6,6,0,1,9,9,1,1,1,1,1,0,0,1,0,0,-948,7,-4,4,0,0,0,0,0,3.8,18.4,-14.6,0,4,-4,1
13332,15267,260,259,1,6,6,1,1,6,0,0,12,12,1,1,2,1,0,1,0,0,0,0,-1935,1,-5,5,-5,0,0,0,1,7.4,9,-1.6,2,3,-1,0
16314,16530,259,263,9,9,9,9,9,7,0,0,15,34,5,4,0,1,0,1,0,0,0,0,-216,-4,0,0,2,0,-19,1,-1,22.6,43.6,-21,4,5,-1,0
14641,14403,225,244,7,5,5,7,4,5,0,1,15,10,1,2,1,0,0,1,0,1,0,0,238,-19,2,-2,-1,0,5,-1,1,19,35.8,-16.8,3,3,0,1
16920,16368,267,271,9,8,8,9,9,12,0,1,23,39,5,4,1,1,0,1,0,1,0,0,552,-4,1,-1,-3,0,-16,1,0,114.2,52.4,61.8,5,5,0,1
16772,14900,265,256,9,6,6,9,14,1,1,0,17,18,3,1,0,0,0,1,1,0,0,0,1872,9,3,-3,13,0,-1,2,0,51.8,79.2,-27.4,4,3,1,1
13898,15404,254,290,3,6,6,3,6,4,0,0,15,30,1,2,0,0,0,1,0,0,0,0,-1506,-36,-3,3,2,0,-15,-1,0,12.4,33.4,-21,2,4,-2,0
14292,14072,282,247,3,4,5,3,2,3,0,0,17,38,5,2,0,0,0,1,0,0,0,0,220,35,-1,2,-1,0,-21,3,0,103.8,41,62.8,4,2,2,1
14752,15961,283,276,4,7,7,4,1,10,0,0,15,18,1,0,0,0,0,1,0,0,0,0,-1209,7,-3,3,-9,0,-3,1,0,18.6,30.4,-11.8,4,4,0,1
15959,16719,247,254,7,8,8,7,6,9,0,0,16,13,1,4,0,0,0,1,0,0,0,0,-760,-7,-1,1,-3,0,3,-3,0,48.6,24.2,24.4,3,5,-2,1
14345,14438,230,237,4,5,5,4,3,6,0,0,12,32,4,2,1,1,0,1,0,0,0,0,-93,-7,-1,1,-3,0,-20,2,0,107.6,80.2,27.4,3,3,0,0
13244,14164,289,314,0,1,1,0,0,1,0,1,15,70,2,3,0,0,0,1,0,1,0,0,-920,-25,-1,1,-1,0,-55,-1,0,81.8,83.8,-2,2,5,-3,0
17048,15349,270,223,11,7,7,11,4,7,1,0,17,12,1,4,1,0,1,0,1,0,0,0,1699,47,4,-4,-3,0,5,-3,1,38.2,78.4,-40.2,3,4,-1,1
14711,17962,207,270,6,10,10,6,6,9,0,0,18,14,1,7,0,0,1,0,0,0,0,0,-3251,-63,-4,4,-3,0,4,-6,0,62.6,62.8,-0.2,4,3,1,0
16458,15744,289,258,8,8,8,8,4,10,0,1,17,18,4,4,0,0,1,0,0,1,0,0,714,31,0,0,-6,0,-1,0,0,17.2,28.2,-11,4,5,-1,1
13977,15140,264,287,2,4,4,2,2,2,0,1,30,14,1,2,0,0,0,1,0,1,0,0,-1163,-23,-2,2,0,0,16,-1,0,12,36.8,-24.8,4,4,0,0
14792,14511,291,234,3,5,5,3,3,7,0,0,12,15,5,2,0,0,1,0,0,0,0,0,281,57,-2,2,-4,0,-3,3,0,13.6,33.4,-19.8,3,4,-1,0
17016,14951,275,294,8,3,3,8,11,4,0,0,23,17,4,5,0,0,1,0,0,0,0,0,2065,-19,5,-5,7,0,6,-1,0,50.8,37.2,13.6,4,5,-1,1
16067,15529,277,261,7,5,5,7,6,6,0,0,29,18,4,4,0,1,1,0,0,0,0,0,538,16,2,-2,0,0,11,0,-1,61,9.8,51.2,5,3,2,1
16369,14476,256,250,8,4,4,8,12,3,0,0,20,36,1,4,2,0,0,1,0,0,0,0,1893,6,4,-4,9,0,-16,-3,2,12.4,34.6,-22.2,5,2,3,1
16151,14225,252,271,8,3,3,8,10,2,0,0,19,67,2,5,0,0,0,1,0,0,0,0,1926,-19,5,-5,8,0,-48,-3,0,17,8.4,8.6,4,2,2,1
13766,15606,255,289,3,5,5,3,4,3,0,1,22,14,0,6,0,0,1,0,0,1,0,0,-1840,-34,-2,2,1,0,8,-6,0,13.4,9.6,3.8,3,2,1,0
15418,15849,262,217,5,8,8,5,7,12,0,1,43,22,3,3,4,0,1,0,0,1,0,0,-431,45,-3,3,-5,0,21,0,4,22.8,40.4,-17.6,4,4,0,0
15253,13999,286,277,4,2,2,4,6,1,0,0,17,17,5,1,0,0,1,0,0,0,0,0,1254,9,2,-2,5,0,0,4,0,37,101.4,-64.4,4,5,-1,1
13646,15270,278,253,1,6,7,1,1,4,0,1,37,17,2,3,1,1,0,1,0,1,0,0,-1624,25,-5,6,-3,0,20,-1,0,30.2,27,3.2,4,4,0,0
15004,15070,308,297,3,3,3,3,2,1,0,0,12,14,4,1,0,0,0,1,0,0,0,0,-66,11,0,0,1,0,-2,3,0,132.6,42.2,90.4,4,5,-1,0
14692,17516,250,278,4,8,8,4,3,9,0,0,29,20,2,1,0,3,0,1,0,0,0,0,-2824,-28,-4,4,-6,0,9,1,-3,13.4,28.4,-15,2,5,-3,0
13709,16260,263,292,2,6,6,2,2,8,0,1,49,67,1,2,0,0,0,1,0,1,0,0,-2551,-29,-4,4,-6,0,-18,-1,0,68,8.4,59.6,3,4,-1,0
14784,14865,239,268,5,5,5,5,7,3,0,0,20,14,2,5,1,0,0,1,0,0,0,0,-81,-29,0,0,4,0,6,-3,1,21,34.4,-13.4,3,4,-1,1
14854,13689,288,258,3,3,3,3,5,2,1,0,22,164,3,1,1,0,1,0,1,0,0,0,1165,30,0,0,3,0,-142,2,1,9.8,22.2,-12.4,2,2,0,1
16748,15075,273,225,9,7,7,9,7,4,0,0,14,17,5,2,0,0,1,0,0,0,0,0,1673,48,2,-2,3,0,-3,3,0,22.8,27.6,-4.8,4,4,0,1
17652,15628,221,225,13,8,9,13,13,10,0,0,16,26,3,2,1,1,0,1,0,0,0,0,2024,-4,5,-4,3,0,-10,1,0,34.2,38.4,-4.2,5,4,1,1
13870,15180,245,249,2,6,6,2,3,9,0,1,13,44,2,2,1,0,0,1,0,1,0,0,-1310,-4,-4,4,-6,0,-31,0,1,18.4,41.2,-22.8,3,3,0,0
13246,14775,235,255,2,5,5,2,3,5,0,0,14,16,4,1,0,0,1,0,0,0,0,0,-1529,-20,-3,3,-2,0,-2,3,0,38.8,18.2,20.6,4,5,-1,0
17442,15696,250,229,11,9,9,12,13,9,0,1,39,14,5,1,1,0,1,0,0,1,0,0,1746,21,2,-3,4,0,25,4,1,253,59.6,193.4,5,5,0,0
14945,16159,291,246,3,6,6,4,3,9,0,0,19,28,1,5,2,2,0,1,0,0,0,0,-1214,45,-3,2,-6,0,-9,-4,0,20.2,45.6,-25.4,4,3,1,0
13001,16216,265,250,0,6,6,0,0,7,0,1,12,11,3,0,1,4,0,1,0,1,0,1,-3215,15,-6,6,-7,0,1,3,-3,9,65,-56,2,5,-3,0
13852,16405,261,276,2,7,7,2,2,12,0,1,11,15,3,1,0,1,0,1,0,1,0,0,-2553,-15,-5,5,-10,0,-4,2,-1,23.4,100.4,-77,4,5,-1,0
15510,14313,284,274,5,3,3,5,4,2,0,1,16,43,2,4,2,0,1,0,0,1,0,0,1197,10,2,-2,2,0,-27,-2,2,28.8,47.2,-18.4,5,3,2,1
14702,15612,253,249,5,6,6,5,2,9,0,0,19,18,1,8,0,1,0,1,0,0,0,0,-910,4,-1,1,-7,0,1,-7,-1,23.8,38.6,-14.8,4,4,0,0
13491,14640,271,279,1,3,3,1,2,5,0,1,11,21,6,0,1,2,0,1,0,1,0,0,-1149,-8,-2,2,-3,0,-10,6,-1,21,19.2,1.8,4,3,1,1
16548,14846,304,257,7,5,5,7,7,2,0,0,21,38,7,2,0,1,1,0,0,0,0,0,1702,47,2,-2,5,0,-17,5,-1,42.8,56.6,-13.8,3,3,0,1
17637,15605,276,264,10,6,6,10,11,6,0,0,24,18,2,2,0,0,0,1,0,0,0,0,2032,12,4,-4,5,0,6,0,0,62.8,102.6,-39.8,5,4,1,1
15783,15803,294,285,6,7,7,6,3,3,1,0,16,17,6,6,0,1,0,1,1,0,0,0,-20,9,-1,1,0,0,-1,0,-1,65.2,13.8,51.4,4,4,0,1
15561,14521,273,281,5,3,3,5,6,2,0,0,13,18,4,2,1,1,0,1,0,0,0,0,1040,-8,2,-2,4,0,-5,2,0,26.4,21.4,5,5,4,1,0
15525,16947,280,271,6,9,9,6,3,14,0,1,14,18,7,3,1,1,0,1,0,1,0,0,-1422,9,-3,3,-11,0,-4,4,0,81.4,25,56.4,4,5,-1,0
17264,14830,281,234,9,6,6,9,13,5,0,0,21,15,3,3,2,0,1,0,0,0,0,0,2434,47,3,-3,8,0,6,0,2,17.4,56.4,-39,5,2,3,1
16568,14278,284,247,6,5,5,6,6,3,0,1,37,28,2,1,1,0,0,1,0,1,0,0,2290,37,1,-1,3,0,9,1,1,8.2,16.4,-8.2,2,4,-2,0
16203,16319,229,248,9,7,7,9,10,9,0,0,22,18,1,7,1,0,0,1,0,0,0,0,-116,-19,2,-2,1,0,4,-6,1,15,22.6,-7.6,5,5,0,0
15083,15514,303,283,3,5,5,3,5,8,0,1,15,18,5,2,0,0,0,1,0,1,0,0,-431,20,-2,2,-3,0,-3,3,0,42,3.4,38.6,4,0,4,1
16737,14772,245,284,12,3,3,12,9,2,0,1,18,110,2,4,1,1,1,0,0,1,0,0,1965,-39,9,-9,7,0,-92,-2,0,54.8,52,2.8,4,5,-1,1
14195,17954,257,259,4,11,11,4,2,10,0,0,12,14,1,5,0,3,1,0,0,0,0,0,-3759,-2,-7,7,-8,0,-2,-4,-3,8.8,107.4,-98.6,3,3,0,0
13576,17169,251,276,2,9,9,2,3,14,0,0,17,18,3,2,0,0,0,1,0,0,0,0,-3593,-25,-7,7,-11,0,-1,1,0,25.8,70.2,-44.4,3,3,0,0
13927,14086,287,289,1,1,1,1,1,1,0,1,20,19,2,2,0,0,0,1,0,1,0,0,-159,-2,0,0,0,0,1,0,0,20.4,6,14.4,4,2,2,0
15792,13222,293,286,6,1,1,6,5,0,0,0,19,15,1,2,1,0,1,0,0,0,0,0,2570,7,5,-5,5,0,4,-1,1,13.8,100.4,-86.6,3,4,-1,1
14077,15714,251,275,3,6,6,3,3,6,0,0,16,17,4,2,0,1,1,0,0,0,0,0,-1637,-24,-3,3,-3,0,-1,2,-1,28.2,27.2,1,4,4,0,0
15990,14000,258,284,7,2,2,7,9,1,0,1,59,14,3,0,0,1,1,0,0,1,0,0,1990,-26,5,-5,8,0,45,3,-1,60.4,19.2,41.2,3,4,-1,1
15170,14156,304,267,4,3,3,4,4,4,0,1,36,38,4,4,1,0,1,0,0,1,0,0,1014,37,1,-1,0,0,-2,0,1,30.4,59,-28.6,5,4,1,0
12768,14770,261,264,0,5,5,0,0,4,0,0,15,28,2,3,0,0,0,1,0,0,0,0,-2002,-3,-5,5,-4,0,-13,-1,0,35.2,26.2,9,4,3,1,1
15018,14455,276,262,5,3,3,5,5,5,1,0,14,16,3,5,0,0,1,0,1,0,0,0,563,14,2,-2,0,0,-2,-2,0,25.6,112.4,-86.8,4,5,-1,1
14705,16286,232,252,5,8,8,5,8,8,0,0,13,15,4,2,0,0,1,0,0,0,0,0,-1581,-20,-3,3,0,0,-2,2,0,115.2,36.8,78.4,4,4,0,0
14515,15062,242,238,4,6,6,4,2,6,0,0,18,10,2,6,1,0,0,1,0,0,0,0,-547,4,-2,2,-4,0,8,-4,1,33.2,35.8,-2.6,4,4,0,0
13604,16969,240,254,3,10,10,3,3,11,0,0,19,32,4,2,0,0,1,0,0,0,0,0,-3365,-14,-7,7,-8,0,-13,2,0,20.6,40.2,-19.6,3,5,-2,0
14445,14603,267,283,3,2,2,3,3,1,0,0,13,17,3,2,0,1,0,1,0,0,0,0,-158,-16,1,-1,2,0,-4,1,-1,25.4,39,-13.6,5,3,2,0
15382,16275,224,259,6,9,10,6,7,13,0,0,19,11,4,4,0,0,1,0,0,0,0,0,-893,-35,-3,4,-6,0,8,0,0,60,26.6,33.4,3,3,0,0
14427,14487,252,264,4,4,4,4,5,1,1,0,14,18,3,3,1,2,0,1,1,0,0,0,-60,-12,0,0,4,0,-4,0,-1,8.4,91.2,-82.8,3,5,-2,1
14603,15672,294,303,2,4,4,2,4,7,0,0,15,72,4,7,1,2,0,1,0,0,0,0,-1069,-9,-2,2,-3,0,-57,-3,-1,69.4,50.2,19.2,5,4,1,0
17062,15832,278,299,8,5,5,8,8,8,1,0,11,16,4,3,2,0,1,0,1,0,0,0,1230,-21,3,-3,0,0,-5,1,2,15,15,0,3,3,0,0
17527,14209,291,226,9,3,3,9,8,3,1,0,14,13,3,6,3,1,1,0,1,0,0,0,3318,65,6,-6,5,0,1,-3,2,16.4,28.2,-11.8,5,4,1,1
15182,14874,276,280,5,3,3,5,5,2,0,1,16,12,1,2,1,1,1,0,0,1,0,0,308,-4,2,-2,3,0,4,-1,0,31.8,93,-61.2,3,5,-2,1
17122,17672,228,260,10,11,11,10,17,10,0,0,43,34,5,3,1,2,0,1,0,0,0,0,-550,-32,-1,1,7,0,9,2,-1,14.2,73.2,-59,4,4,0,0
13149,15922,267,297,1,5,5,1,0,5,1,0,16,15,0,4,0,1,0,1,1,0,0,0,-2773,-30,-4,4,-5,0,1,-4,-1,63.6,28.2,35.4,5,2,3,0
15671,14786,280,266,6,4,4,6,5,4,0,0,34,17,4,5,1,0,1,0,0,0,0,0,885,14,2,-2,1,0,17,-1,1,57,27.2,29.8,3,3,0,0
15676,14645,231,235,9,5,5,9,8,2,0,0,15,16,1,3,0,2,0,1,0,0,0,0,1031,-4,4,-4,6,0,-1,-2,-2,27.2,15.8,11.4,5,4,1,1
15476,16076,246,283,7,7,7,7,6,5,0,1,13,18,5,3,0,1,1,0,0,1,0,0,-600,-37,0,0,1,0,-5,2,-1,20.8,9.8,11,4,3,1,0
15166,14472,290,277,5,3,3,5,1,4,0,0,16,15,3,3,0,0,1,0,0,0,0,0,694,13,2,-2,-3,0,1,0,0,48.8,26,22.8,4,4,0,1
16603,15158,274,267,8,7,7,8,8,3,0,0,40,21,6,5,0,0,0,1,0,0,0,0,1445,7,1,-1,5,0,19,1,0,28.2,32.2,-4,4,2,2,1
15292,15749,237,235,6,7,8,6,8,6,0,0,15,23,4,3,1,0,0,1,0,0,0,0,-457,2,-1,2,2,0,-8,1,1,23.4,26.2,-2.8,5,4,1,0
16966,14693,264,240,9,5,5,9,15,8,0,0,16,30,3,2,1,0,1,0,0,0,0,0,2273,24,4,-4,7,0,-14,1,1,22.8,175.2,-152.4,4,5,-1,1
14026,13810,266,272,2,3,3,2,1,1,0,0,17,38,7,4,1,0,1,0,0,0,0,0,216,-6,-1,1,0,0,-21,3,1,35.6,28,7.6,4,5,-1,0
15063,13934,310,264,2,3,3,2,2,4,0,1,15,15,2,2,2,1,0,1,0,1,0,0,1129,46,-1,1,-2,0,0,0,1,41,22.6,18.4,4,4,0,0
14013,13768,288,270,1,2,2,1,2,1,1,0,40,16,3,2,0,1,1,0,1,0,0,0,245,18,-1,1,1,0,24,1,-1,13.6,15.2,-1.6,2,3,-1,1
15944,14835,279,243,6,6,6,6,13,6,0,1,25,14,2,2,3,0,1,0,0,1,0,0,1109,36,0,0,7,0,11,0,3,30,16.8,13.2,4,4,0,0
15593,14958,262,276,7,3,3,7,6,4,0,0,17,19,3,4,0,1,1,0,0,0,0,0,635,-14,4,-4,2,0,-2,-1,-1,42.6,18.6,24,5,3,2,0
16286,15127,238,232,9,5,6,9,12,4,0,0,22,99,3,3,1,0,1,0,0,0,0,0,1159,6,4,-3,8,0,-77,0,1,21,44.4,-23.4,4,4,0,1
15280,17801,249,291,5,10,10,5,5,11,0,1,14,14,2,3,0,1,1,0,0,1,0,0,-2521,-42,-5,5,-6,0,0,-1,-1,43.8,14.2,29.6,5,3,2,0
14652,14072,285,277,3,2,2,3,7,3,0,1,15,14,2,5,0,1,0,1,0,1,0,0,580,8,1,-1,4,0,1,-3,-1,11.4,11.8,-0.4,3,3,0,0
12835,15747,259,294,0,6,6,0,0,4,0,0,20,14,3,5,1,1,0,1,0,0,0,0,-2912,-35,-6,6,-4,0,6,-2,0,32.4,19,13.4,5,3,2,0
16559,14356,262,256,9,4,4,9,11,2,0,1,19,12,0,5,0,0,0,1,0,1,0,0,2203,6,5,-5,9,0,7,-5,0,27.8,11.2,16.6,3,3,0,1
15064,14885,292,302,4,2,2,4,3,3,0,1,18,16,4,4,1,0,0,1,0,1,0,0,179,-10,2,-2,0,0,2,0,1,61.8,23,38.8,5,5,0,1
15915,18999,245,269,6,13,13,6,11,22,0,0,15,20,1,2,2,2,0,1,0,0,0,0,-3084,-24,-7,7,-11,0,-5,-1,0,39.2,16.2,23,4,4,0,0
14588,15730,274,279,3,5,5,3,7,9,1,0,18,32,1,4,1,0,1,0,1,0,0,0,-1142,-5,-2,2,-2,0,-14,-3,1,19.2,11.4,7.8,3,3,0,0
16496,15435,226,208,10,9,9,10,10,13,0,0,12,24,3,2,1,1,1,0,0,0,0,0,1061,18,1,-1,-3,0,-12,1,0,15.6,29,-13.4,3,4,-1,1
13713,14618,268,248,1,5,5,1,2,6,0,0,13,102,3,2,1,1,0,1,0,0,0,0,-905,20,-4,4,-4,0,-89,1,0,15,41.2,-26.2,4,3,1,1
17583,14444,223,217,13,5,5,13,15,6,0,0,15,17,4,2,0,0,1,0,0,0,0,0,3139,6,8,-8,9,0,-2,2,0,177.6,11.8,165.8,5,4,1,1
16245,15677,248,247,8,9,9,8,8,13,0,1,15,17,2,0,2,0,0,1,0,1,0,0,568,1,-1,1,-5,0,-2,2,2,13.6,35,-21.4,3,4,-1,0
17187,15974,250,250,10,8,8,10,19,8,0,0,20,37,6,4,1,2,1,0,0,0,0,0,1213,0,2,-2,11,0,-17,2,-1,19.4,72.8,-53.4,4,3,1,1
14937,13193,281,247,5,1,1,5,2,0,0,1,17,16,1,3,0,2,1,0,0,1,0,0,1744,34,4,-4,2,0,1,-2,-2,75.6,99.2,-23.6,4,3,1,0
15340,15301,252,259,6,7,7,6,6,5,0,0,37,18,6,4,0,0,0,1,0,0,0,0,39,-7,-1,1,1,0,19,2,0,16.8,27.8,-11,5,4,1,0
17051,13164,272,230,10,2,3,10,8,0,0,0,18,10,1,2,1,0,1,0,0,0,0,0,3887,42,8,-7,8,0,8,-1,1,91,29.6,61.4,4,3,1,1
14297,15798,258,299,4,4,4,4,4,4,0,0,14,13,1,2,1,1,1,0,0,0,0,0,-1501,-41,0,0,0,0,1,-1,0,29.2,14.6,14.6,4,3,1,0
16475,15152,247,297,9,4,4,9,18,4,1,0,21,16,1,2,0,1,0,1,1,0,0,0,1323,-50,5,-5,14,0,5,-1,-1,39.8,19.8,20,3,5,-2,1
15216,16322,275,282,5,6,6,5,8,8,1,0,18,16,6,3,0,1,1,0,1,0,0,0,-1106,-7,-1,1,0,0,2,3,-1,44,32.2,11.8,4,4,0,1
14988,13803,264,246,4,2,2,4,8,3,0,0,14,17,2,5,1,0,1,0,0,0,0,0,1185,18,2,-2,5,0,-3,-3,1,184,22.8,161.2,4,4,0,1
17712,15241,269,233,11,6,6,11,17,6,0,0,18,33,8,3,2,0,1,0,0,0,0,0,2471,36,5,-5,11,0,-15,5,2,63.2,64.2,-1,4,5,-1,0
16194,15217,283,272,6,5,5,6,9,6,0,0,29,20,5,3,1,1,0,1,0,0,0,0,977,11,1,-1,3,0,9,2,0,30.4,29.8,0.6,5,5,0,0
14470,14470,257,274,4,3,3,5,5,3,0,0,17,31,2,4,0,1,0,1,0,0,0,0,0,-17,1,-2,2,0,-14,-2,-1,34.2,8.8,25.4,3,3,0,1
15741,14815,260,255,7,4,4,7,4,4,0,0,36,18,2,2,1,0,1,0,0,0,0,0,926,5,3,-3,0,0,18,0,1,10.4,48.8,-38.4,4,4,0,0
13293,13780,271,275,1,1,1,1,1,1,0,0,59,17,3,3,0,1,1,0,0,0,0,0,-487,-4,0,0,0,0,42,0,-1,13.4,28,-14.6,2,3,-1,1
16160,18267,198,235,11,13,14,11,19,17,0,1,21,19,3,5,0,1,0,1,0,1,0,0,-2107,-37,-2,3,2,0,2,-2,-1,21.6,15,6.6,5,4,1,0
15344,14496,240,254,6,4,4,6,7,3,0,1,31,13,0,3,1,1,1,0,0,1,0,0,848,-14,2,-2,4,0,18,-3,0,28.6,54.2,-25.6,5,3,2,0
14322,14896,262,269,3,4,4,3,7,4,0,1,16,13,5,1,0,2,0,1,0,1,0,0,-574,-7,-1,1,3,0,3,4,-2,63.6,39.2,24.4,4,5,-1,1
12707,16332,237,264,1,8,8,1,1,13,0,0,17,39,4,6,0,0,0,1,0,0,0,0,-3625,-27,-7,7,-12,0,-22,-2,0,74.4,54.2,20.2,4,4,0,0
14150,14045,296,281,1,1,2,1,1,1,0,1,21,20,2,4,0,0,1,0,0,1,0,0,105,15,0,1,0,0,1,-2,0,58.2,45.8,12.4,3,4,-1,1
16239,14570,300,307,6,3,3,6,6,1,0,0,50,12,6,8,0,0,0,1,0,0,0,0,1669,-7,3,-3,5,0,38,-2,0,55,9.6,45.4,3,5,-2,1
13723,13653,279,278,2,1,1,2,1,3,0,0,15,39,2,1,0,0,1,0,0,0,0,0,70,1,1,-1,-2,0,-24,1,0,14.6,21.8,-7.2,5,5,0,1
16032,13881,273,249,7,3,3,7,8,2,1,0,17,14,2,4,0,0,0,1,1,0,0,0,2151,24,4,-4,6,0,3,-2,0,23,11.8,11.2,5,3,2,1
17468,15673,282,297,8,4,4,8,14,10,0,0,31,19,4,4,0,0,1,0,0,0,0,0,1795,-15,4,-4,4,0,12,0,0,64.8,63.2,1.6,4,5,-1,0
13337,14719,241,277,2,4,4,2,2,4,0,0,12,17,3,1,0,0,0,1,0,0,0,0,-1382,-36,-2,2,-2,0,-5,2,0,36.6,39.8,-3.2,3,3,0,0
15698,15623,260,250,6,7,7,6,8,6,0,0,14,24,6,2,0,0,1,0,0,0,0,0,75,10,-1,1,2,0,-10,4,0,11.8,14.8,-3,3,4,-1,1
15423,12799,276,258,4,0,0,4,8,0,0,0,18,17,4,1,1,0,1,0,0,0,0,0,2624,18,4,-4,8,0,1,3,1,18.8,58.8,-40,3,4,-1,1
13808,16032,287,289,2,6,6,3,0,10,0,1,18,16,4,4,0,1,0,1,0,1,0,0,-2224,-2,-4,3,-10,0,2,0,-1,8.4,83.8,-75.4,2,5,-3,0
14366,14674,271,266,3,5,5,3,4,7,0,0,18,45,2,3,0,0,1,0,0,0,0,0,-308,5,-2,2,-3,0,-27,-1,0,24.2,23,1.2,5,5,0,0
15216,15074,227,254,7,5,5,7,8,7,0,1,39,17,4,3,0,1,1,0,0,1,0,0,142,-27,2,-2,1,0,22,1,-1,63,22,41,5,4,1,1
13336,17420,218,269,2,10,10,2,2,9,0,0,17,18,2,4,0,2,0,1,0,0,0,0,-4084,-51,-8,8,-7,0,-1,-2,-2,37.6,44.2,-6.6,3,4,-1,0
16596,14125,282,275,7,3,3,7,5,3,0,1,14,13,4,2,2,1,0,1,0,1,0,0,2471,7,4,-4,2,0,1,2,1,111.2,14.8,96.4,5,4,1,0
15286,16281,250,264,6,7,7,6,5,5,1,0,14,21,4,2,0,2,0,1,1,0,0,0,-995,-14,-1,1,0,0,-7,2,-2,11.4,17.8,-6.4,5,4,1,0
16155,13790,278,256,6,3,3,6,7,2,0,0,36,19,4,2,0,0,0,1,0,0,0,0,2365,22,3,-3,5,0,17,2,0,53.6,57.6,-4,5,4,1,1
15896,16819,250,241,9,9,9,9,7,11,0,0,16,13,2,6,0,2,0,1,0,0,0,0,-923,9,0,0,-4,0,3,-4,-2,27.4,22.2,5.2,4,3,1,0
13644,16897,216,267,3,10,10,3,4,11,0,0,130,27,0,3,0,0,0,1,0,0,0,0,-3253,-51,-7,7,-7,0,103,-3,0,33,13,20,5,4,1,0
14764,15353,267,261,5,5,5,5,5,6,0,0,15,15,3,5,0,0,1,0,0,0,0,0,-589,6,0,0,-1,0,0,-2,0,12.2,39.8,-27.6,2,5,-3,0
13238,15656,244,278,2,6,6,2,1,7,1,0,18,34,2,1,0,0,0,1,1,0,0,0,-2418,-34,-4,4,-6,0,-16,1,0,43.4,22,21.4,4,4,0,0
14448,15674,255,270,4,7,7,4,3,8,0,1,37,16,2,4,1,0,1,0,0,1,0,0,-1226,-15,-3,3,-5,0,21,-2,1,19.4,16.2,3.2,5,4,1,0
14256,14676,250,272,3,3,3,3,3,3,0,0,20,19,5,2,0,1,1,0,0,0,0,0,-420,-22,0,0,0,0,1,3,-1,61,11.6,49.4,3,3,0,1
14872,14708,254,273,4,4,4,4,6,2,0,1,16,15,2,1,0,2,1,0,0,1,0,0,164,-19,0,0,4,0,1,1,-2,51,158.6,-107.6,4,5,-1,1
14706,16682,287,291,3,8,8,3,6,7,0,0,34,17,3,4,0,0,0,1,0,0,0,0,-1976,-4,-5,5,-1,0,17,-1,0,9.8,13.8,-4,4,4,0,1
14369,14186,270,259,3,4,5,3,2,3,0,1,13,19,5,2,0,1,1,0,0,1,0,0,183,11,-1,2,-1,0,-6,3,-1,20,42.8,-22.8,4,3,1,0
14874,14391,307,267,3,3,3,3,2,5,1,0,15,38,6,0,0,0,1,0,1,0,0,0,483,40,0,0,-3,0,-23,6,0,14.6,18.8,-4.2,4,4,0,0
14623,16976,270,262,3,10,10,3,3,13,0,0,16,15,3,3,0,2,1,0,0,0,0,0,-2353,8,-7,7,-10,0,1,0,-2,22.4,25.8,-3.4,3,4,-1,1
15906,15671,267,252,8,7,7,8,4,9,0,0,14,14,1,4,1,0,0,1,0,0,0,0,235,15,1,-1,-5,0,0,-3,1,15.6,14.2,1.4,4,3,1,1
14866,15720,252,271,5,7,7,5,4,7,0,1,16,18,1,4,0,1,0,1,0,1,0,0,-854,-19,-2,2,-3,0,-2,-3,-1,17.4,5.8,11.6,4,2,2,1
15159,15489,298,269,4,6,6,4,3,6,0,1,22,27,5,2,0,0,0,1,0,1,0,0,-330,29,-2,2,-3,0,-5,3,0,16,14.4,1.6,4,3,1,0
15187,14577,271,261,5,4,5,5,6,5,1,0,29,18,3,2,0,0,1,0,1,0,0,0,610,10,1,0,1,0,11,1,0,31.4,45.4,-14,4,4,0,0
13493,16876,234,279,3,8,8,3,2,9,0,1,14,125,5,1,0,2,0,1,0,1,0,0,-3383,-45,-5,5,-7,0,-111,4,-2,17.8,45.6,-27.8,4,5,-1,0
14339,17069,269,286,3,10,10,3,4,9,0,0,23,21,8,5,0,0,0,1,0,0,0,0,-2730,-17,-7,7,-5,0,2,3,0,65.4,26.8,38.6,4,4,0,0
14086,15926,260,275,4,7,7,4,3,6,1,0,33,21,3,1,0,0,1,0,1,0,0,0,-1840,-15,-3,3,-3,0,12,2,0,158.6,22.8,135.8,5,4,1,0
17188,15335,289,274,8,5,5,8,9,5,1,0,39,13,1,4,2,2,1,0,1,0,0,0,1853,15,3,-3,4,0,26,-3,0,19,14.6,4.4,4,2,2,0
13499,15436,241,281,2,6,6,2,1,7,0,1,16,18,1,1,0,0,0,1,0,1,0,0,-1937,-40,-4,4,-6,0,-2,0,0,20.2,16.6,3.6,4,4,0,1
14634,15543,274,276,4,5,5,4,3,5,0,0,13,15,1,1,0,1,1,0,0,0,0,0,-909,-2,-1,1,-2,0,-2,0,-1,29.2,7.8,21.4,5,2,3,1
17098,15105,250,250,10,6,6,10,11,6,0,0,18,17,4,5,0,0,0,1,0,0,0,0,1993,0,4,-4,5,0,1,-1,0,19.2,13.6,5.6,4,4,0,1
14917,15581,263,257,4,6,6,4,7,5,0,0,37,36,7,4,2,0,1,0,0,0,0,0,-664,6,-2,2,2,0,1,3,2,15.4,14.6,0.8,5,5,0,0
14304,14952,292,286,2,4,4,2,0,7,0,0,17,38,4,3,0,0,0,1,0,0,0,0,-648,6,-2,2,-7,0,-21,1,0,11.6,14.8,-3.2,3,5,-2,0
14962,14582,241,273,5,4,4,5,8,3,1,0,17,17,4,4,0,0,1,0,1,0,0,0,380,-32,1,-1,5,0,0,0,0,39,25.8,13.2,5,4,1,1
14421,14464,283,261,2,3,3,2,5,4,1,0,18,17,1,2,2,1,0,1,1,0,0,0,-43,22,-1,1,1,0,1,-1,1,23.2,14,9.2,4,5,-1,1
16694,13511,295,246,7,2,2,7,9,4,0,0,18,33,2,2,1,0,1,0,0,0,0,0,3183,49,5,-5,5,0,-15,0,1,37.6,58.2,-20.6,4,5,-1,1
15302,15126,258,292,5,5,5,5,11,2,1,0,10,17,6,1,2,1,1,0,1,0,0,0,176,-34,0,0,9,0,-7,5,1,27.4,43.8,-16.4,4,5,-1,0
17584,14419,290,235,9,4,4,9,15,8,0,1,86,36,3,1,0,0,0,1,0,1,0,0,3165,55,5,-5,7,0,50,2,0,7.6,26,-18.4,3,4,-1,1
16629,13695,282,263,7,2,2,7,7,2,0,0,141,112,1,2,0,0,1,0,0,0,0,0,2934,19,5,-5,5,0,29,-1,0,26.6,37.6,-11,2,4,-2,1
14613,16921,250,248,6,9,9,6,3,13,0,0,31,15,6,3,0,0,1,0,0,0,0,0,-2308,2,-3,3,-10,0,16,3,0,56,33.6,22.4,4,4,0,1
16133,12070,255,223,7,0,1,7,9,0,0,0,36,39,3,2,1,0,1,0,0,0,0,0,4063,32,7,-6,9,0,-3,1,1,10.2,7.8,2.4,3,2,1,1
15925,15343,267,274,7,5,5,7,5,6,0,0,16,17,3,4,1,0,0,1,0,0,0,0,582,-7,2,-2,-1,0,-1,-1,1,12.2,9.8,2.4,4,3,1,1
14600,14257,281,278,3,3,3,3,4,2,0,1,17,17,3,4,0,0,0,1,0,1,0,0,343,3,0,0,2,0,0,-1,0,9.4,18.4,-9,3,4,-1,0
14175,17253,222,246,4,11,11,5,5,14,0,0,17,87,0,4,1,2,0,1,0,0,0,0,-3078,-24,-7,6,-9,0,-70,-4,-1,16.6,37.8,-21.2,4,3,1,0
15448,14538,266,220,7,5,5,7,6,6,0,0,17,13,4,2,0,0,0,1,0,0,0,0,910,46,2,-2,0,0,4,2,0,11.4,24.6,-13.2,4,5,-1,1
13772,14839,267,318,2,2,2,2,2,2,0,0,23,13,1,5,0,1,0,1,0,0,0,0,-1067,-51,0,0,0,0,10,-4,-1,6.2,10.2,-4,3,4,-1,0
14908,17225,269,286,4,10,10,4,3,8,0,0,15,21,4,1,0,0,0,1,0,0,0,0,-2317,-17,-6,6,-5,0,-6,3,0,18,11.8,6.2,5,4,1,0
15342,15517,260,270,7,6,6,7,4,11,0,1,14,15,3,4,0,0,1,0,0,1,0,0,-175,-10,1,-1,-7,0,-1,-1,0,15.6,69.6,-54,3,2,1,0
16231,17134,273,271,7,10,10,7,7,7,0,1,16,18,4,1,0,1,0,1,0,1,0,0,-903,2,-3,3,0,0,-2,3,-1,52.8,44,8.8,5,4,1,0
14852,15525,265,295,5,4,4,5,6,4,0,1,15,17,3,3,0,1,1,0,0,1,0,0,-673,-30,1,-1,2,0,-2,0,-1,11.4,27.6,-16.2,3,5,-2,0
16107,14057,278,270,6,1,1,6,8,1,0,0,11,14,2,2,0,2,1,0,0,0,0,0,2050,8,5,-5,7,0,-3,0,-2,47.4,17.6,29.8,4,3,1,1
14272,13448,255,245,4,2,2,5,1,3,0,0,34,15,3,3,1,0,1,0,0,0,0,0,824,10,2,-3,-2,0,19,0,1,20.6,24,-3.4,4,3,1,1
15540,13363,305,268,5,1,1,5,1,1,0,1,16,16,2,6,2,0,1,0,0,1,0,0,2177,37,4,-4,0,0,0,-4,2,13.8,12,1.8,4,4,0,0
12578,15470,230,278,1,6,6,1,1,5,0,1,13,14,3,2,0,2,0,1,0,1,0,0,-2892,-48,-5,5,-4,0,-1,1,-2,22.2,6,16.2,3,2,1,0
15422,15476,299,256,5,5,5,5,4,8,0,1,22,16,0,7,0,2,1,0,0,1,0,0,-54,43,0,0,-4,0,6,-7,-2,17.4,23.2,-5.8,4,5,-1,0
16287,13184,256,228,7,2,2,7,8,3,0,1,57,10,2,5,1,1,1,0,0,1,0,0,3103,28,5,-5,5,0,47,-3,0,17.4,14.4,3,4,3,1,1
16546,12744,271,253,8,0,0,8,13,0,0,1,18,18,3,3,0,0,1,0,0,1,0,0,3802,18,8,-8,13,0,0,0,0,18.6,33.4,-14.8,4,2,2,1
13962,16053,248,221,3,10,10,3,2,13,0,0,17,16,0,3,0,0,1,0,0,0,0,0,-2091,27,-7,7,-11,0,1,-3,0,16.8,114,-97.2,4,5,-1,0
15901,13897,282,256,6,3,3,6,3,2,0,1,12,16,2,2,1,0,1,0,0,1,0,0,2004,26,3,-3,1,0,-4,0,1,117.8,88.2,29.6,4,4,0,1
16715,14224,260,236,9,4,4,9,11,1,0,0,19,26,1,2,0,0,1,0,0,0,0,0,2491,24,5,-5,10,0,-7,-1,0,77.8,28,49.8,5,5,0,1
16414,15975,230,221,10,9,9,10,10,12,1,0,16,14,1,4,1,2,0,1,1,0,0,0,439,9,1,-1,-2,0,2,-3,-1,149.2,48.6,100.6,4,3,1,1
15032,14940,226,244,7,4,4,8,5,7,1,0,12,20,0,3,2,2,1,0,1,0,0,0,92,-18,3,-4,-2,0,-8,-3,0,9.6,99.4,-89.8,4,4,0,0
14249,15367,245,251,4,7,7,4,5,5,1,0,18,18,4,4,0,0,1,0,1,0,0,0,-1118,-6,-3,3,0,0,0,0,0,93,45.8,47.2,3,3,0,0
16862,14019,272,255,9,3,3,9,10,2,1,0,62,16,2,5,0,1,0,1,1,0,0,0,2843,17,6,-6,8,0,46,-3,-1,6.6,120.6,-114,2,3,-1,1
17536,13278,277,229,10,2,2,10,14,6,0,1,24,15,3,8,1,0,1,0,0,1,0,0,4258,48,8,-8,8,0,9,-5,1,54.6,51.2,3.4,3,4,-1,1
15345,13877,266,274,6,2,2,6,8,2,0,0,37,17,3,5,0,0,1,0,0,0,0,0,1468,-8,4,-4,6,0,20,-2,0,11.8,13,-1.2,4,3,1,0
15544,15749,225,230,6,7,7,6,6,10,0,0,25,26,3,2,1,1,1,0,0,0,0,0,-205,-5,-1,1,-4,0,-1,1,0,64,72.4,-8.4,5,3,2,0
19470,15783,271,195,14,9,9,14,15,14,0,0,15,12,3,4,6,0,1,0,0,0,0,0,3687,76,5,-5,1,0,3,-1,6,22,55.2,-33.2,3,4,-1,1
16323,15968,280,263,6,7,7,6,11,12,0,0,16,14,5,5,2,0,0,1,0,0,0,0,355,17,-1,1,-1,0,2,0,2,13,47.8,-34.8,5,5,0,0
16095,16587,254,207,7,12,12,7,8,15,0,0,13,25,3,2,0,1,0,1,0,0,0,0,-492,47,-5,5,-7,0,-12,1,-1,83.2,95.6,-12.4,5,5,0,1
15369,14787,281,263,4,5,5,4,3,5,0,0,14,22,6,5,0,1,0,1,0,0,0,0,582,18,-1,1,-2,0,-8,1,-1,69,62.6,6.4,3,3,0,1
16896,13836,292,262,8,2,2,8,9,3,1,0,15,16,2,1,1,1,1,0,1,0,0,0,3060,30,6,-6,6,0,-1,1,0,31.6,58.2,-26.6,4,5,-1,1
16343,14737,283,280,8,3,3,8,7,5,0,1,39,31,8,4,0,0,1,0,0,1,0,0,1606,3,5,-5,2,0,8,4,0,16,68.2,-52.2,4,5,-1,0
13655,15992,271,282,2,7,7,2,0,7,0,0,18,16,4,6,0,0,0,1,0,0,0,0,-2337,-11,-5,5,-7,0,2,-2,0,22.2,34.6,-12.4,5,4,1,0
15038,14010,292,292,3,1,1,3,7,0,0,1,12,14,2,0,2,0,1,0,0,1,0,0,1028,0,2,-2,7,0,-2,2,2,29.6,32.4,-2.8,3,4,-1,1
15051,15601,301,285,3,5,5,3,2,4,0,0,16,15,3,6,0,1,1,0,0,0,0,0,-550,16,-2,2,-2,0,1,-3,-1,21.6,15.6,6,4,4,0,1
15541,15912,240,250,6,6,6,6,8,6,0,1,43,16,5,14,0,0,1,0,0,1,0,0,-371,-10,0,0,2,0,27,-9,0,101.6,16,85.6,4,3,1,0
17351,13262,289,250,9,1,1,9,11,1,1,0,17,10,2,3,2,0,1,0,1,0,0,0,4089,39,8,-8,10,0,7,-1,2,55.6,28,27.6,4,4,0,1
15912,13965,308,258,5,3,3,5,5,1,0,0,20,17,5,3,0,0,1,0,0,0,0,0,1947,50,2,-2,4,0,3,2,0,19.2,34.8,-15.6,4,5,-1,1
15287,14559,264,229,4,6,6,4,5,8,0,0,15,15,3,3,3,0,1,0,0,0,0,0,728,35,-2,2,-3,0,0,0,3,52.6,52.6,0,3,3,0,0
14533,14382,284,281,3,3,3,3,4,6,1,0,13,15,3,4,1,0,1,0,1,0,0,0,151,3,0,0,-2,0,-2,-1,1,52.8,48.4,4.4,5,3,2,1
15947,15580,262,238,8,7,7,8,6,7,1,0,37,15,2,2,0,0,0,1,1,0,0,0,367,24,1,-1,-1,0,22,0,0,173.8,10.4,163.4,4,4,0,1
14197,13943,311,271,1,2,2,1,1,2,0,0,18,17,5,1,1,0,0,1,0,0,0,0,254,40,-1,1,-1,0,1,4,1,24.6,7.2,17.4,4,3,1,1
17413,13665,266,244,10,3,3,10,17,1,0,1,30,17,6,4,1,0,1,0,0,1,0,0,3748,22,7,-7,16,0,13,2,1,10.4,36,-25.6,3,5,-2,1
15738,16387,258,223,7,10,10,7,5,11,0,1,18,15,3,4,1,2,0,1,0,1,0,0,-649,35,-3,3,-6,0,3,-1,-1,21.6,111.2,-89.6,3,4,-1,0
14775,14250,283,278,3,2,2,3,3,4,0,0,20,50,4,3,0,0,0,1,0,0,0,0,525,5,1,-1,-1,0,-30,1,0,21,131.8,-110.8,3,4,-1,1
15602,16844,232,253,8,9,9,8,9,10,0,0,13,30,3,2,0,0,1,0,0,0,0,0,-1242,-21,-1,1,-1,0,-17,1,0,21.2,9,12.2,4,4,0,0
15664,18247,250,245,6,13,13,6,6,14,0,0,19,14,2,2,0,1,0,1,0,0,0,0,-2583,5,-7,7,-8,0,5,0,-1,84.6,21.6,63,4,1,3,0
15052,18213,249,282,5,12,12,5,6,16,0,0,17,18,3,3,2,0,0,1,0,0,0,0,-3161,-33,-7,7,-10,0,-1,0,2,21,29,-8,4,2,2,0
14042,13994,283,267,2,2,2,2,1,1,0,0,39,17,5,6,0,1,1,0,0,0,0,0,48,16,0,0,0,0,22,-1,-1,28.8,25.4,3.4,4,4,0,1
15415,15592,276,277,5,5,5,5,6,7,0,0,15,28,1,4,1,0,1,0,0,0,0,0,-177,-1,0,0,-1,0,-13,-3,1,52.4,37.8,14.6,5,4,1,0
13111,14259,284,284,0,2,2,0,0,1,1,0,35,14,6,4,0,0,0,1,1,0,0,0,-1148,0,-2,2,-1,0,21,2,0,52.2,65.8,-13.6,2,3,-1,1
14838,15455,270,283,4,4,4,4,10,3,0,0,15,16,5,2,0,1,1,0,0,0,0,0,-617,-13,0,0,7,0,-1,3,-1,28.2,26,2.2,5,4,1,0
14566,15903,259,287,4,6,6,4,4,6,0,0,12,68,4,1,1,0,0,1,0,0,0,0,-1337,-28,-2,2,-2,0,-56,3,1,48.6,26.4,22.2,3,4,-1,0
16003,15138,301,318,5,3,3,5,6,4,0,1,16,26,3,5,0,0,1,0,0,1,0,0,865,-17,2,-2,2,0,-10,-2,0,68.4,31.2,37.2,4,3,1,0
14675,15232,240,278,5,4,4,5,7,3,0,1,15,37,1,1,0,2,0,1,0,1,0,0,-557,-38,1,-1,4,0,-22,0,-2,45.2,21,24.2,5,5,0,1
16701,16841,248,243,9,11,11,9,10,15,0,0,27,19,5,3,1,1,0,1,0,0,0,0,-140,5,-2,2,-5,0,8,2,0,54,13,41,5,4,1,1
14221,15440,232,240,6,7,7,6,2,7,0,0,16,15,3,3,0,2,0,1,0,0,0,0,-1219,-8,-1,1,-5,0,1,0,-2,51.8,6.8,45,3,3,0,0
15377,14835,263,261,5,5,6,5,8,5,0,0,20,15,0,3,0,0,1,0,0,0,0,0,542,2,0,1,3,0,5,-3,0,63.6,10.6,53,5,2,3,1
18138,13039,281,237,11,2,2,11,15,2,0,0,16,19,2,0,1,0,1,0,0,0,0,0,5099,44,9,-9,13,0,-3,2,1,40.2,25.6,14.6,3,3,0,1
14522,14682,277,283,3,3,3,3,4,3,1,0,15,12,2,3,1,1,1,0,1,0,0,0,-160,-6,0,0,1,0,3,-1,0,12,44.6,-32.6,3,5,-2,1
15276,15078,275,276,4,4,4,4,6,6,0,1,20,62,4,6,1,0,0,1,0,1,0,0,198,-1,0,0,0,0,-42,-2,1,28.2,73.6,-45.4,5,5,0,0
17287,15499,266,234,10,7,7,10,13,13,1,0,17,17,6,5,1,0,1,0,1,0,0,0,1788,32,3,-3,0,0,0,1,1,13.4,17.2,-3.8,5,3,2,0
15857,15618,245,251,8,5,5,8,7,7,0,0,195,12,1,3,2,0,0,1,0,0,0,0,239,-6,3,-3,0,0,183,-2,2,20,30,-10,3,5,-2,1
14993,15642,250,276,4,5,5,4,5,3,0,0,21,17,2,1,2,1,1,0,0,0,0,0,-649,-26,-1,1,2,0,4,1,1,52.2,16.4,35.8,4,2,2,1
15820,16356,238,280,8,6,6,8,9,9,0,1,15,15,3,6,0,2,1,0,0,1,0,0,-536,-42,2,-2,0,0,0,-3,-2,12.4,10.8,1.6,3,3,0,0
15638,15508,217,234,8,7,7,8,12,8,0,0,16,42,7,1,1,1,1,0,0,0,0,0,130,-17,1,-1,4,0,-26,6,0,93.8,93.8,0,4,4,0,1
13918,15518,269,286,2,5,5,3,4,7,1,0,36,15,2,4,0,1,1,0,1,0,0,0,-1600,-17,-3,2,-3,0,21,-2,-1,20,12.4,7.6,3,3,0,0
13627,16181,279,265,1,7,7,2,0,8,0,0,15,20,3,2,0,1,0,1,0,0,0,0,-2554,14,-6,5,-8,0,-5,1,-1,45.4,22.8,22.6,4,3,1,1
16161,13238,287,288,7,0,0,7,6,0,1,0,19,17,7,2,0,0,1,0,1,0,0,0,2923,-1,7,-7,6,0,2,5,0,25.4,19.6,5.8,5,3,2,1
16168,13710,242,255,8,2,2,8,5,1,0,0,55,18,4,2,2,0,1,0,0,0,0,0,2458,-13,6,-6,4,0,37,2,2,90.4,17,73.4,4,2,2,1
14197,17269,233,288,4,9,9,4,3,3,0,0,17,23,3,2,0,3,0,1,0,0,0,0,-3072,-55,-5,5,0,0,-6,1,-3,29.2,47.6,-18.4,5,3,2,1
14518,15337,265,256,4,5,5,4,5,5,0,1,12,13,2,4,0,2,0,1,0,1,0,0,-819,9,-1,1,0,0,-1,-2,-2,40,45.8,-5.8,4,4,0,0
15434,14822,269,276,7,4,4,7,4,3,1,0,16,15,2,4,1,0,1,0,1,0,0,0,612,-7,3,-3,1,0,1,-2,1,48.6,31.4,17.2,3,3,0,0
15075,14813,286,286,4,3,3,4,4,4,0,0,18,20,3,4,0,0,0,1,0,0,0,0,262,0,1,-1,0,0,-2,-1,0,28.4,34.8,-6.4,4,3,1,1
16757,14988,277,258,8,5,5,8,8,10,0,1,17,17,3,5,0,0,1,0,0,1,0,0,1769,19,3,-3,-2,0,0,-2,0,30.2,29.6,0.6,3,4,-1,1
15154,18242,228,259,7,11,11,7,4,13,0,0,54,37,6,3,1,0,1,0,0,0,0,0,-3088,-31,-4,4,-9,0,17,3,1,23.4,29.6,-6.2,5,3,2,0
15830,14967,255,260,6,4,4,6,6,7,0,1,16,74,2,2,0,0,1,0,0,1,0,0,863,-5,2,-2,-1,0,-58,0,0,95.8,5.4,90.4,4,2,2,1
14598,15319,266,264,4,5,5,4,7,4,0,0,37,15,2,4,1,0,1,0,0,0,0,0,-721,2,-1,1,3,0,22,-2,1,20.4,42.2,-21.8,2,4,-2,1
15465,14324,252,235,5,5,5,5,6,2,0,1,52,17,2,4,1,1,1,0,0,1,0,0,1141,17,0,0,4,0,35,-2,0,61.2,18.8,42.4,5,5,0,1
14590,13842,272,244,3,2,2,3,2,3,0,1,16,22,3,3,0,0,1,0,0,1,0,0,748,28,1,-1,-1,0,-6,0,0,59.2,16.2,43,3,3,0,0
15213,15595,284,254,4,6,6,4,6,8,0,0,14,16,8,1,1,1,1,0,0,0,0,0,-382,30,-2,2,-2,0,-2,7,0,29,44,-15,4,3,1,1
14834,16839,229,242,6,10,10,6,5,11,0,0,14,18,2,2,0,0,0,1,0,0,0,0,-2005,-13,-4,4,-6,0,-4,0,0,76,21.6,54.4,5,3,2,0
15295,13797,258,271,5,2,2,5,7,1,0,0,17,12,1,5,0,0,0,1,0,0,0,0,1498,-13,3,-3,6,0,5,-4,0,52.8,39.6,13.2,4,3,1,1
15492,15855,245,234,7,9,9,7,8,6,0,1,22,34,6,5,1,1,1,0,0,1,0,0,-363,11,-2,2,2,0,-12,1,0,18.8,18.2,0.6,4,3,1,0
14597,13768,265,258,4,2,2,5,4,2,0,0,31,17,0,3,0,0,1,0,0,0,0,0,829,7,2,-3,2,0,14,-3,0,9.8,9.8,0,2,4,-2,1
14157,13610,285,258,2,2,2,2,2,3,0,0,18,17,3,2,0,1,0,1,0,0,0,0,547,27,0,0,-1,0,1,1,-1,34.6,11.4,23.2,4,4,0,1
15018,15166,268,258,6,6,6,6,1,4,0,0,22,12,2,3,1,0,1,0,0,0,0,0,-148,10,0,0,-3,0,10,-1,1,25.2,51.8,-26.6,4,3,1,0
16663,17580,258,276,8,11,11,8,14,17,0,0,9,29,4,1,1,0,1,0,0,0,0,0,-917,-18,-3,3,-3,0,-20,3,1,21.2,10,11.2,4,3,1,1
15553,14291,292,276,5,2,2,5,7,2,1,0,22,23,5,3,0,1,1,0,1,0,0,0,1262,16,3,-3,5,0,-1,2,-1,25,69.6,-44.6,5,3,2,1
13586,14981,241,278,3,4,4,3,1,2,0,0,14,14,1,4,0,1,0,1,0,0,0,0,-1395,-37,-1,1,-1,0,0,-3,-1,12.8,31,-18.2,4,5,-1,0
14789,15543,198,239,6,8,8,6,5,9,0,0,17,24,3,4,3,1,0,1,0,0,0,0,-754,-41,-2,2,-4,0,-7,-1,2,44.2,58.2,-14,4,5,-1,0
16482,16590,255,298,8,7,7,8,8,4,1,0,26,11,3,3,0,1,0,1,1,0,0,0,-108,-43,1,-1,4,0,15,0,-1,21.8,23.6,-1.8,3,5,-2,0
16839,14171,297,235,7,3,3,7,7,4,0,0,31,11,2,4,2,0,1,0,0,0,0,0,2668,62,4,-4,3,0,20,-2,2,24.8,35.8,-11,5,4,1,1
14912,14923,261,296,5,4,4,5,11,1,0,0,17,40,4,4,0,0,1,0,0,0,0,0,-11,-35,1,-1,10,0,-23,0,0,54.2,107.6,-53.4,4,4,0,0
16624,15991,262,258,7,7,7,7,8,10,0,0,22,15,2,3,0,0,0,1,0,0,0,0,633,4,0,0,-2,0,7,-1,0,11.4,47.8,-36.4,4,4,0,1
15087,17144,266,259,5,9,10,5,4,15,0,0,18,17,3,4,1,2,0,1,0,0,0,0,-2057,7,-4,5,-11,0,1,-1,-1,8,21.4,-13.4,4,5,-1,0
14454,14820,264,235,4,6,6,4,4,6,0,1,31,13,2,2,0,0,1,0,0,1,0,0,-366,29,-2,2,-2,0,18,0,0,34.4,131,-96.6,4,3,1,0
17445,12792,292,249,9,1,1,9,6,1,0,1,18,13,1,2,2,0,1,0,0,1,0,0,4653,43,8,-8,5,0,5,-1,2,17.8,56.6,-38.8,4,4,0,1
16155,13761,249,237,8,3,3,8,7,2,0,0,42,173,0,7,3,1,0,1,0,0,0,0,2394,12,5,-5,5,0,-131,-7,2,210.8,22.2,188.6,4,4,0,0
14973,15158,287,298,3,4,4,3,3,3,0,1,18,14,0,3,0,1,0,1,0,1,0,0,-185,-11,-1,1,0,0,4,-3,-1,99.6,8.2,91.4,3,3,0,0
16125,14068,300,248,6,3,3,6,7,3,0,0,18,14,7,4,0,0,1,0,0,0,0,0,2057,52,3,-3,4,0,4,3,0,78.6,56.8,21.8,5,4,1,1
15920,16120,279,260,6,6,7,6,11,11,1,0,16,15,4,3,2,0,0,1,1,0,0,0,-200,19,0,1,0,0,1,1,2,29.8,20.8,9,4,5,-1,1
16002,15470,239,247,10,7,7,10,11,4,0,0,15,26,4,2,0,0,1,0,0,0,0,0,532,-8,3,-3,7,0,-11,2,0,46.2,62.4,-16.2,5,5,0,0
16999,14685,263,269,10,3,3,10,11,1,0,0,21,20,5,5,0,1,1,0,0,0,0,0,2314,-6,7,-7,10,0,1,0,-1,9,27.2,-18.2,3,4,-1,1
14351,15543,258,275,4,6,6,4,3,6,0,1,21,14,3,5,1,1,0,1,0,1,0,0,-1192,-17,-2,2,-3,0,7,-2,0,17,29,-12,4,5,-1,0
12868,14644,260,294,0,3,3,0,0,2,1,0,15,16,2,4,0,0,0,1,1,0,0,0,-1776,-34,-3,3,-2,0,-1,-2,0,13.4,54.2,-40.8,2,3,-1,0
14622,14913,291,308,1,3,3,1,1,3,0,1,20,39,3,4,1,0,0,1,0,1,0,0,-291,-17,-2,2,-2,0,-19,-1,1,42.2,69.4,-27.2,5,4,1,1
17348,14784,260,219,9,5,6,9,17,9,0,0,13,93,3,3,1,1,1,0,0,0,0,0,2564,41,4,-3,8,0,-80,0,0,33.6,44.6,-11,5,4,1,1
14243,16762,244,265,3,8,8,3,4,8,0,0,43,22,3,2,0,1,0,1,0,0,0,0,-2519,-21,-5,5,-4,0,21,1,-1,9,70.6,-61.6,2,4,-2,1
13713,15027,269,275,1,4,4,1,1,5,0,0,39,19,7,7,0,0,0,1,0,0,0,0,-1314,-6,-3,3,-4,0,20,0,0,61,15.2,45.8,5,3,2,0
15005,15761,253,261,5,7,7,5,7,11,0,0,16,24,1,2,0,0,0,1,0,0,0,0,-756,-8,-2,2,-4,0,-8,-1,0,30,91,-61,4,3,1,0
15148,16115,296,313,4,6,6,4,2,6,0,1,17,21,5,3,0,0,1,0,0,1,0,0,-967,-17,-2,2,-4,0,-4,2,0,21.6,80.6,-59,4,5,-1,1
15614,14643,268,268,6,4,4,6,10,3,0,1,13,17,4,1,1,0,0,1,0,1,0,0,971,0,2,-2,7,0,-4,3,1,18,17,1,2,5,-3,0
14612,16467,277,310,2,7,7,2,3,7,0,1,17,18,2,2,0,1,0,1,0,1,0,0,-1855,-33,-5,5,-4,0,-1,0,-1,51.8,10.4,41.4,4,4,0,0
14360,14552,277,263,2,5,5,2,2,6,0,1,16,15,1,1,1,1,0,1,0,1,0,0,-192,14,-3,3,-4,0,1,0,0,26.8,49,-22.2,3,4,-1,1
17284,16189,278,261,8,7,8,8,11,9,0,0,71,16,6,5,1,1,0,1,0,0,0,0,1095,17,1,0,2,0,55,1,0,54.8,17.4,37.4,3,4,-1,1
14866,15623,225,258,6,7,7,6,13,4,0,1,18,24,1,4,0,2,0,1,0,1,0,0,-757,-33,-1,1,9,0,-6,-3,-2,54,56.4,-2.4,5,4,1,0
16025,15029,266,285,8,4,4,8,7,3,1,0,17,14,1,5,0,2,1,0,1,0,0,0,996,-19,4,-4,4,0,3,-4,-2,96.4,76,20.4,5,4,1,1
15516,14317,268,259,5,2,2,5,6,2,1,0,29,22,5,1,0,3,0,1,1,0,0,0,1199,9,3,-3,4,0,7,4,-3,27.2,25.6,1.6,3,4,-1,0
14298,15981,275,297,2,6,7,2,3,8,0,1,44,15,0,4,1,0,0,1,0,1,0,0,-1683,-22,-4,5,-5,0,29,-4,1,15.6,31.6,-16,3,3,0,0
16141,15166,281,282,6,4,4,6,8,9,1,0,16,30,1,1,1,1,1,0,1,0,0,0,975,-1,2,-2,-1,0,-14,0,0,43.8,47.8,-4,5,5,0,1
15163,14915,313,280,3,5,5,3,2,3,0,1,14,131,6,6,0,0,0,1,0,1,0,0,248,33,-2,2,-1,0,-117,0,0,88.2,72.6,15.6,5,5,0,0
15142,17100,279,303,4,6,6,4,6,16,0,0,18,17,2,5,0,0,0,1,0,0,0,0,-1958,-24,-2,2,-10,0,1,-3,0,44.8,75.8,-31,3,5,-2,0
16446,15573,269,275,9,5,5,9,8,6,0,1,17,16,2,1,0,0,0,1,0,1,0,0,873,-6,4,-4,2,0,1,1,0,15,33.2,-18.2,3,5,-2,1
12733,14550,263,293,0,2,2,0,0,3,1,0,34,19,3,3,0,0,0,1,1,0,0,0,-1817,-30,-2,2,-3,0,15,0,0,134,8.8,125.2,5,3,2,0
16727,13453,294,228,7,3,3,7,9,4,0,1,15,14,3,3,1,0,1,0,0,1,0,0,3274,66,4,-4,5,0,1,0,1,16,8.2,7.8,3,3,0,1
17209,15726,289,267,9,6,6,9,9,6,0,1,36,12,1,3,2,0,1,0,0,1,0,0,1483,22,3,-3,3,0,24,-2,2,52.8,133.2,-80.4,3,5,-2,1
15080,15008,296,269,5,5,5,5,5,4,0,1,13,16,5,1,0,0,1,0,0,1,0,0,72,27,0,0,1,0,-3,4,0,17.4,61.6,-44.2,5,2,3,0
16880,14428,260,229,10,6,6,10,10,3,1,0,18,17,3,4,0,0,0,1,1,0,0,0,2452,31,4,-4,7,0,1,-1,0,31.2,41.6,-10.4,5,5,0,1
13557,15869,246,248,3,7,7,3,1,7,0,0,18,34,3,4,0,1,0,1,0,0,0,0,-2312,-2,-4,4,-6,0,-16,-1,-1,47.6,78.4,-30.8,3,2,1,0
14170,16778,259,271,3,9,9,3,3,10,0,0,16,39,2,4,0,0,0,1,0,0,0,0,-2608,-12,-6,6,-7,0,-23,-2,0,17.2,85.8,-68.6,4,4,0,0
17128,15956,283,259,10,7,7,10,10,7,0,0,14,18,2,2,0,0,1,0,0,0,0,0,1172,24,3,-3,3,0,-4,0,0,21,62.4,-41.4,3,4,-1,0
15426,14491,256,247,6,5,5,6,7,5,0,0,11,14,2,2,1,0,1,0,0,0,0,0,935,9,1,-1,2,0,-3,0,1,51.8,49.4,2.4,5,3,2,0
12508,15344,246,289,1,5,5,1,0,2,0,0,11,113,2,5,0,1,0,1,0,0,0,0,-2836,-43,-4,4,-2,0,-102,-3,-1,45.8,10.8,35,5,4,1,0
16207,14711,299,292,6,2,2,6,6,3,1,0,22,20,6,1,1,0,1,0,1,0,0,0,1496,7,4,-4,3,0,2,5,1,33.2,60.2,-27,5,5,0,1
15909,13162,296,239,5,3,3,5,7,1,0,0,12,13,4,1,1,0,0,1,0,0,0,0,2747,57,2,-2,6,0,-1,3,1,14,42.8,-28.8,3,5,-2,1
15472,14198,272,280,5,2,2,5,11,3,0,1,17,19,4,5,1,0,1,0,0,1,0,0,1274,-8,3,-3,8,0,-2,-1,1,16.6,55,-38.4,4,5,-1,0
14624,15525,270,259,3,6,6,3,2,8,1,0,17,16,3,5,0,0,1,0,1,0,0,0,-901,11,-3,3,-6,0,1,-2,0,28.8,32.6,-3.8,4,3,1,1
16805,14957,272,258,8,4,4,8,11,9,1,0,57,15,5,2,3,0,1,0,1,0,0,0,1848,14,4,-4,2,0,42,3,3,25,35.8,-10.8,4,2,2,1
16093,15828,246,242,8,8,8,8,9,11,0,0,34,16,1,1,0,0,0,1,0,0,0,0,265,4,0,0,-2,0,18,0,0,10.6,10.8,-0.2,3,5,-2,1
15158,15779,273,259,4,6,6,4,5,7,0,0,19,15,8,5,0,2,0,1,0,0,0,0,-621,14,-2,2,-2,0,4,3,-2,18.2,20.6,-2.4,2,4,-2,1
15467,17284,234,260,7,10,10,7,6,12,0,1,13,25,2,4,0,0,1,0,0,1,0,0,-1817,-26,-3,3,-6,0,-12,-2,0,38.4,66.4,-28,2,3,-1,1
13793,14721,251,287,2,3,3,2,3,2,0,0,19,23,1,3,0,1,0,1,0,0,0,0,-928,-36,-1,1,1,0,-4,-2,-1,57.2,79.8,-22.6,4,5,-1,0
14466,15695,266,262,4,6,6,4,2,7,1,0,168,27,5,3,0,1,1,0,1,0,0,0,-1229,4,-2,2,-5,0,141,2,-1,45.4,40.6,4.8,4,5,-1,1
14254,14701,291,294,2,2,2,2,5,5,0,0,15,16,6,4,0,1,0,1,0,0,0,0,-447,-3,0,0,0,0,-1,2,-1,44.8,46.8,-2,4,4,0,0
14966,12220,279,224,4,1,1,5,2,0,0,1,21,15,4,3,1,0,1,0,0,1,0,0,2746,55,3,-4,2,0,6,1,1,63.2,13.6,49.6,5,2,3,1
13940,15556,262,253,3,8,8,3,2,7,0,1,14,20,5,6,0,0,0,1,0,1,0,0,-1616,9,-5,5,-5,0,-6,-1,0,8.6,8.2,0.4,2,3,-1,0
16181,16322,259,291,7,7,7,7,11,8,0,0,21,15,1,7,0,0,0,1,0,0,0,0,-141,-32,0,0,3,0,6,-6,0,69.4,19.8,49.6,4,4,0,0
15921,15948,275,267,6,6,6,6,9,8,1,0,35,17,6,2,2,0,0,1,1,0,0,0,-27,8,0,0,1,0,18,4,2,24.2,14.8,9.4,4,5,-1,1
15137,14794,321,278,3,4,4,3,1,6,0,1,19,11,1,2,0,0,1,0,0,1,0,0,343,43,-1,1,-5,0,8,-1,0,36.6,32.6,4,5,4,1,1
16076,15332,281,266,6,6,6,6,8,8,0,1,13,17,2,2,0,0,0,1,0,1,0,0,744,15,0,0,0,0,-4,0,0,23.6,108.4,-84.8,4,5,-1,1
16302,12857,253,266,8,0,0,8,8,0,0,0,19,14,3,3,2,0,1,0,0,0,0,0,3445,-13,8,-8,8,0,5,0,2,29.8,23.8,6,5,5,0,0
16420,14170,292,293,6,2,2,6,7,3,0,1,23,18,6,2,0,0,0,1,0,1,0,0,2250,-1,4,-4,4,0,5,4,0,30.2,18.6,11.6,4,2,2,1
14549,14429,291,242,3,4,4,3,1,5,0,0,16,19,2,7,0,0,1,0,0,0,0,0,120,49,-1,1,-4,0,-3,-5,0,35,41,-6,3,4,-1,0
15548,17713,238,305,7,10,10,7,11,10,0,1,13,13,2,2,0,2,0,1,0,1,0,0,-2165,-67,-3,3,1,0,0,0,-2,12,6.4,5.6,4,2,2,0
15436,14625,257,277,5,2,2,5,6,3,0,1,19,17,4,2,1,1,1,0,0,1,0,0,811,-20,3,-3,3,0,2,2,0,35.8,60.8,-25,4,4,0,1
14100,14220,274,246,3,3,4,3,2,4,0,1,13,16,4,4,0,0,1,0,0,1,0,0,-120,28,0,1,-2,0,-3,0,0,35.8,39.4,-3.6,5,5,0,0
15095,14870,272,304,5,3,4,5,4,1,0,1,37,14,3,6,1,1,0,1,0,1,0,0,225,-32,2,-1,3,0,23,-3,0,16.2,81.8,-65.6,3,4,-1,1
14491,17312,256,264,5,11,11,5,3,12,1,0,11,14,3,2,1,1,0,1,1,0,0,0,-2821,-8,-6,6,-9,0,-3,1,0,14.2,75.6,-61.4,3,4,-1,0
14646,17043,231,230,4,10,10,4,7,10,0,0,17,16,4,3,2,1,1,0,0,0,0,0,-2397,1,-6,6,-3,0,1,1,1,22.2,19.6,2.6,2,2,0,0
14767,14765,277,270,3,5,5,3,4,3,0,1,14,13,6,5,2,0,1,0,0,1,0,0,2,7,-2,2,1,0,1,1,2,87.2,24.6,62.6,4,3,1,1
15963,15109,237,247,8,5,5,8,6,6,0,0,16,14,2,4,3,1,1,0,0,0,0,0,854,-10,3,-3,0,0,2,-2,2,9.2,66,-56.8,4,4,0,0
15699,13924,253,248,6,4,4,6,12,1,0,0,17,16,1,3,0,1,0,1,0,0,0,0,1775,5,2,-2,11,0,1,-2,-1,10.6,25.8,-15.2,4,4,0,1
16217,18556,239,209,8,15,15,8,14,22,0,0,15,20,1,2,0,1,0,1,0,0,0,0,-2339,30,-7,7,-8,0,-5,-1,-1,13,54.6,-41.6,4,5,-1,0
15951,14531,261,252,8,4,4,8,7,3,1,0,37,17,4,4,0,0,1,0,1,0,0,0,1420,9,4,-4,4,0,20,0,0,10.2,12.8,-2.6,5,3,2,1
14610,14573,279,270,3,4,5,3,4,7,0,1,14,16,7,3,0,1,0,1,0,1,0,0,37,9,-1,2,-3,0,-2,4,-1,15,43.2,-28.2,4,4,0,0
17538,13532,314,266,8,1,1,8,10,1,0,1,16,18,2,2,1,0,1,0,0,1,0,0,4006,48,7,-7,9,0,-2,0,1,18.2,54,-35.8,5,5,0,1
13182,15413,263,306,1,4,4,1,1,2,0,1,14,16,4,4,0,1,0,1,0,1,0,0,-2231,-43,-3,3,-1,0,-2,0,-1,24.4,8.8,15.6,4,3,1,0
14864,14563,267,221,4,5,5,4,3,8,0,0,16,15,2,2,1,1,0,1,0,0,0,0,301,46,-1,1,-5,0,1,0,0,14.2,23.2,-9,3,3,0,1
12979,16074,263,289,1,6,6,1,0,4,0,1,13,19,7,2,0,0,0,1,0,1,0,0,-3095,-26,-5,5,-4,0,-6,5,0,10.8,23.4,-12.6,4,4,0,1
13483,17220,234,266,4,12,12,4,2,11,0,0,12,18,1,2,0,1,0,1,0,0,0,0,-3737,-32,-8,8,-9,0,-6,-1,-1,15.2,51.6,-36.4,3,5,-2,0
16423,15060,276,294,7,3,3,7,15,5,0,1,16,19,1,4,0,1,1,0,0,1,0,0,1363,-18,4,-4,10,0,-3,-3,-1,21.2,11,10.2,4,4,0,1
13226,15259,279,315,0,2,2,0,0,2,0,0,13,22,4,1,0,2,0,1,0,0,0,0,-2033,-36,-2,2,-2,0,-9,3,-2,47.8,12,35.8,4,5,-1,0
14559,16134,268,266,2,7,7,3,3,8,0,1,12,43,5,4,0,1,0,1,0,1,0,0,-1575,2,-5,4,-5,0,-31,1,-1,52.2,45.4,6.8,4,5,-1,0
14439,14258,258,238,5,4,4,5,3,6,1,0,20,15,4,1,0,0,1,0,1,0,0,0,181,20,1,-1,-3,0,5,3,0,17,142.4,-125.4,2,5,-3,1
14138,14628,237,244,4,5,5,5,4,7,0,0,14,17,1,4,1,0,1,0,0,0,0,0,-490,-7,-1,0,-3,0,-3,-3,1,10.2,75.4,-65.2,4,3,1,0
15474,15005,298,290,4,3,3,4,4,3,0,1,14,18,4,4,0,1,1,0,0,1,0,0,469,8,1,-1,1,0,-4,0,-1,12.8,16,-3.2,3,3,0,0
14050,16034,270,289,2,6,6,2,2,7,0,0,110,19,3,5,0,0,0,1,0,0,0,0,-1984,-19,-4,4,-5,0,91,-2,0,28.6,15.6,13,3,5,-2,0
16786,13208,278,221,9,3,3,9,6,3,0,1,19,33,1,5,0,0,1,0,0,1,0,0,3578,57,6,-6,3,0,-14,-4,0,73,26,47,4,3,1,1
14231,15134,240,275,4,5,5,4,4,2,0,0,16,15,3,3,3,2,1,0,0,0,0,0,-903,-35,-1,1,2,0,1,0,1,6.2,18,-11.8,3,2,1,1
14887,17723,277,265,4,10,10,4,3,13,0,0,14,17,2,1,1,3,1,0,0,0,0,0,-2836,12,-6,6,-10,0,-3,1,-2,23.8,34.2,-10.4,4,4,0,0
13911,15403,289,301,1,3,3,1,1,4,0,1,21,17,3,7,0,2,0,1,0,1,0,0,-1492,-12,-2,2,-3,0,4,-4,-2,61.8,36.4,25.4,5,5,0,0
16496,13250,254,261,10,2,3,10,9,0,0,0,14,15,3,2,1,0,1,0,0,0,0,0,3246,-7,8,-7,9,0,-1,1,1,42,29.4,12.6,5,4,1,1
16301,14043,241,225,9,4,4,9,13,5,0,0,36,19,5,3,0,0,1,0,0,0,0,0,2258,16,5,-5,8,0,17,2,0,45.2,14.6,30.6,4,3,1,1
16312,14993,275,264,8,5,5,8,3,2,1,0,16,35,3,3,1,1,0,1,1,0,0,0,1319,11,3,-3,1,0,-19,0,0,58,58.6,-0.6,4,3,1,1
17473,13132,240,228,12,2,2,12,14,3,0,0,16,12,2,1,3,0,1,0,0,0,0,0,4341,12,10,-10,11,0,4,1,3,79.4,7.2,72.2,4,2,2,1
14328,17025,223,269,4,9,10,4,6,11,0,0,21,19,4,0,0,2,0,1,0,0,0,0,-2697,-46,-5,6,-5,0,2,4,-2,58.2,14.4,43.8,4,2,2,0
16510,15176,215,282,10,4,4,10,15,4,0,0,19,15,3,0,0,0,0,1,0,0,0,0,1334,-67,6,-6,11,0,4,3,0,35,79.8,-44.8,4,4,0,1
15995,16662,274,245,6,8,8,6,6,12,0,0,21,20,3,3,0,1,1,0,0,0,0,0,-667,29,-2,2,-6,0,1,0,-1,54.8,23.8,31,4,4,0,0
15736,14150,293,282,5,2,2,5,8,3,0,1,16,15,3,1,0,1,0,1,0,1,0,0,1586,11,3,-3,5,0,1,2,-1,71.8,61,10.8,5,5,0,1
14031,15717,263,278,2,6,6,2,3,6,0,0,15,18,4,4,0,0,1,0,0,0,0,0,-1686,-15,-4,4,-3,0,-3,0,0,5,21.4,-16.4,1,5,-4,0
15433,13862,291,250,4,3,3,4,6,2,0,0,117,13,3,1,3,0,0,1,0,0,0,0,1571,41,1,-1,4,0,104,2,3,21.4,23,-1.6,4,4,0,1
15087,14193,305,262,3,3,3,3,0,4,1,0,16,17,5,3,0,0,0,1,1,0,0,0,894,43,0,0,-4,0,-1,2,0,70.6,16.8,53.8,4,4,0,1
14171,14915,281,276,2,4,4,2,4,6,0,0,13,17,3,0,0,0,1,0,0,0,0,0,-744,5,-2,2,-2,0,-4,3,0,31,44.4,-13.4,4,3,1,1
13789,14301,267,276,4,4,4,4,2,4,0,1,16,13,3,8,0,0,0,1,0,1,0,0,-512,-9,0,0,-2,0,3,-5,0,10.8,12.8,-2,4,2,2,1
15125,13924,272,259,4,2,2,4,4,3,0,1,14,31,2,4,2,0,1,0,0,1,0,0,1201,13,2,-2,1,0,-17,-2,2,77.8,24,53.8,4,5,-1,1
13516,15162,268,299,2,3,3,2,1,3,1,0,13,19,3,0,0,1,0,1,1,0,0,0,-1646,-31,-1,1,-2,0,-6,3,-1,20.4,18.4,2,4,5,-1,0
18120,16148,252,241,12,7,7,12,13,7,0,0,14,35,3,2,1,0,1,0,0,0,0,0,1972,11,5,-5,6,0,-21,1,1,59.4,14,45.4,5,2,3,0
15869,14898,300,288,5,3,3,5,6,6,0,0,39,18,3,1,1,1,1,0,0,0,0,0,971,12,2,-2,0,0,21,2,0,23.6,11.4,12.2,3,2,1,0
17153,15110,261,277,9,5,5,9,14,6,0,0,32,15,3,2,1,1,0,1,0,0,0,0,2043,-16,4,-4,8,0,17,1,0,30,18.2,11.8,5,4,1,1
13361,18145,236,292,2,10,11,2,1,13,0,0,15,15,4,4,0,1,1,0,0,0,0,0,-4784,-56,-8,9,-12,0,0,0,-1,8,78.2,-70.2,3,4,-1,0
16049,14176,291,259,6,3,3,6,4,1,0,1,16,16,6,2,1,0,1,0,0,1,0,0,1873,32,3,-3,3,0,0,4,1,21.4,8,13.4,4,4,0,1
14521,13929,276,256,5,2,2,5,1,3,0,1,23,19,1,1,2,3,1,0,0,1,0,0,592,20,3,-3,-2,0,4,0,-1,27.2,10.8,16.4,4,2,2,0
16475,18011,239,253,9,13,13,9,7,9,0,0,18,14,4,2,0,0,0,1,0,0,0,0,-1536,-14,-4,4,-2,0,4,2,0,13,37.4,-24.4,3,5,-2,1
16131,14706,281,281,7,3,3,7,8,2,0,0,19,30,2,4,0,0,1,0,0,0,0,0,1425,0,4,-4,6,0,-11,-2,0,7.2,5,2.2,1,1,0,1
15665,14369,256,269,6,3,3,6,9,4,0,0,17,16,2,2,0,1,0,1,0,0,0,0,1296,-13,3,-3,5,0,1,0,-1,123.2,10.8,112.4,4,3,1,0
15762,14812,253,255,6,5,5,6,13,11,0,0,16,17,3,1,1,0,1,0,0,0,0,0,950,-2,1,-1,2,0,-1,2,1,43.6,11.8,31.8,2,3,-1,0
14665,12982,285,260,3,0,0,3,4,0,1,0,17,58,5,3,1,1,1,0,1,0,0,0,1683,25,3,-3,4,0,-41,2,0,15.2,19.8,-4.6,4,3,1,1
16539,14279,277,214,8,6,6,8,8,5,1,0,14,27,1,1,2,0,0,1,1,0,0,0,2260,63,2,-2,3,0,-13,0,2,42,50.2,-8.2,3,3,0,1
14523,16204,240,275,4,6,6,4,6,8,0,0,15,17,3,5,0,4,0,1,0,0,0,0,-1681,-35,-2,2,-2,0,-2,-2,-4,49.2,42.8,6.4,3,5,-2,0
15838,18258,263,273,6,11,11,7,5,11,0,0,16,16,2,1,0,0,0,1,0,0,0,0,-2420,-10,-5,4,-6,0,0,1,0,34.4,12.4,22,4,1,3,1
15110,14636,282,287,5,3,3,5,4,3,0,0,14,19,4,3,0,0,1,0,0,0,0,0,474,-5,2,-2,1,0,-5,1,0,18.6,50.6,-32,4,4,0,0
15961,15693,249,258,7,6,6,7,11,10,0,0,18,15,3,6,2,0,1,0,0,0,0,0,268,-9,1,-1,1,0,3,-3,2,51.2,52.6,-1.4,4,5,-1,0
16179,15467,265,275,7,4,4,7,10,5,0,0,18,26,4,4,0,0,1,0,0,0,0,0,712,-10,3,-3,5,0,-8,0,0,47,57,-10,4,4,0,1
15386,18664,228,259,6,15,15,6,7,12,0,1,15,14,1,2,0,3,0,1,0,1,0,0,-3278,-31,-9,9,-5,0,1,-1,-3,39.8,30.4,9.4,3,5,-2,0
14470,15505,191,242,7,6,6,7,7,6,0,1,18,36,3,5,0,2,0,1,0,1,0,0,-1035,-51,1,-1,1,0,-18,-2,-2,8.2,12.4,-4.2,4,4,0,0
13682,17041,228,248,3,9,9,3,3,10,0,0,18,14,1,3,1,0,0,1,0,0,0,0,-3359,-20,-6,6,-7,0,4,-2,1,96.2,75,21.2,5,5,0,0
16260,14176,275,270,8,3,3,8,7,2,1,0,40,12,2,5,0,0,0,1,1,0,0,0,2084,5,5,-5,5,0,28,-3,0,48.8,27.2,21.6,3,3,0,1
13536,15449,270,286,1,3,3,1,2,6,0,0,8,31,3,1,0,5,0,1,0,0,0,0,-1913,-16,-2,2,-4,0,-23,2,-5,14.6,51.4,-36.8,3,5,-2,1
15424,15402,276,264,5,5,5,5,9,8,0,0,19,11,2,2,0,1,0,1,0,0,0,0,22,12,0,0,1,0,8,0,-1,55.2,15.2,40,3,4,-1,1
16418,14194,285,258,8,3,3,8,7,2,0,1,17,35,4,2,1,0,1,0,0,1,0,0,2224,27,5,-5,5,0,-18,2,1,66.2,13.2,53,4,5,-1,1
14517,14865,245,261,5,5,5,5,6,5,0,1,28,14,4,3,0,0,1,0,0,1,0,0,-348,-16,0,0,1,0,14,1,0,52.4,10.2,42.2,4,2,2,1
16732,15468,255,264,9,5,5,9,10,3,0,0,31,14,4,3,1,0,1,0,0,0,0,0,1264,-9,4,-4,7,0,17,1,1,83.4,28,55.4,5,4,1,1
14561,15933,269,256,4,7,7,4,5,8,1,0,18,12,4,0,0,1,1,0,1,0,0,0,-1372,13,-3,3,-3,0,6,4,-1,23,38.8,-15.8,4,3,1,1
17398,17230,265,270,7,11,11,7,12,10,0,0,15,102,6,3,0,1,0,1,0,0,0,0,168,-5,-4,4,2,0,-87,3,-1,11.8,15.6,-3.8,3,3,0,1
15006,14846,262,260,4,5,5,4,4,4,0,0,16,15,4,5,0,0,1,0,0,0,0,0,160,2,-1,1,0,0,1,-1,0,9.4,52.6,-43.2,3,3,0,1
14517,16006,234,254,4,7,7,4,5,7,0,0,17,17,1,2,0,1,0,1,0,0,0,0,-1489,-20,-3,3,-2,0,0,-1,-1,25,39.8,-14.8,1,4,-3,0
15284,14826,276,261,4,4,4,4,7,5,0,1,110,16,3,3,0,1,1,0,0,1,0,0,458,15,0,0,2,0,94,0,-1,16.6,29,-12.4,3,3,0,1
14741,14552,287,292,4,3,3,4,2,1,0,1,15,12,3,3,0,0,1,0,0,1,0,0,189,-5,1,-1,1,0,3,0,0,8.2,31.8,-23.6,2,4,-2,0
14676,18799,216,272,6,12,12,6,5,11,0,0,36,30,1,4,0,4,0,1,0,0,0,0,-4123,-56,-6,6,-6,0,6,-3,-4,73.8,21.8,52,5,3,2,0
15399,17144,264,268,6,8,8,6,9,12,0,1,15,17,4,5,0,0,1,0,0,1,0,0,-1745,-4,-2,2,-3,0,-2,-1,0,20.2,54.4,-34.2,4,5,-1,1
14449,15997,277,303,2,5,5,2,3,8,0,1,15,86,2,2,0,2,0,1,0,1,0,0,-1548,-26,-3,3,-5,0,-71,0,-2,83.8,15.2,68.6,4,5,-1,0
14780,14745,268,285,5,3,3,5,3,4,0,1,39,32,3,4,2,2,1,0,0,1,0,0,35,-17,2,-2,-1,0,7,-1,0,146.2,10.2,136,5,3,2,1
14829,14467,304,264,4,3,3,4,2,5,0,0,17,38,3,5,0,0,0,1,0,0,0,0,362,40,1,-1,-3,0,-21,-2,0,42.6,16.8,25.8,5,3,2,0
18938,15548,268,265,17,5,5,17,16,3,1,0,16,105,2,2,2,0,1,0,1,0,0,0,3390,3,12,-12,13,0,-89,0,2,19.4,19,0.4,3,4,-1,1
14522,15718,245,249,4,7,7,4,3,5,0,1,19,10,3,1,2,1,0,1,0,1,0,0,-1196,-4,-3,3,-2,0,9,2,1,12.6,22,-9.4,1,4,-3,0
15964,15391,247,258,9,6,6,9,7,5,0,0,22,18,5,2,0,1,1,0,0,0,0,0,573,-11,3,-3,2,0,4,3,-1,50.4,57.6,-7.2,5,5,0,0
14118,16676,232,265,4,8,8,4,4,9,0,0,13,19,4,0,0,1,0,1,0,0,0,0,-2558,-33,-4,4,-5,0,-6,4,-1,107.6,51.8,55.8,4,5,-1,0
16572,14870,254,243,8,5,5,8,10,6,0,1,20,41,3,4,1,1,1,0,0,1,0,0,1702,11,3,-3,4,0,-21,-1,0,61,64.2,-3.2,4,4,0,1
15568,13852,247,225,7,3,3,7,10,5,0,0,17,16,5,4,1,1,1,0,0,0,0,0,1716,22,4,-4,5,0,1,1,0,45.6,26.2,19.4,3,1,2,1
16739,17359,240,280,8,9,9,8,11,11,0,0,19,17,5,2,1,1,1,0,0,0,0,0,-620,-40,-1,1,0,0,2,3,0,51.8,76.6,-24.8,4,4,0,0
14607,16163,238,296,4,6,6,4,5,8,0,1,18,16,6,5,1,0,1,0,0,1,0,0,-1556,-58,-2,2,-3,0,2,1,1,69.4,80.2,-10.8,5,5,0,1
13467,16297,251,251,2,8,8,2,2,11,0,1,32,19,5,3,1,0,0,1,0,1,0,0,-2830,0,-6,6,-9,0,13,2,1,20,25.8,-5.8,5,5,0,0
13465,15290,259,266,2,6,6,2,0,6,1,0,20,17,3,7,1,1,0,1,1,0,0,0,-1825,-7,-4,4,-6,0,3,-4,0,72.6,94.2,-21.6,3,4,-1,0
15834,14182,303,270,5,3,3,5,3,4,1,0,16,17,7,2,0,0,1,0,1,0,0,0,1652,33,2,-2,-1,0,-1,5,0,27.8,20.4,7.4,5,5,0,1
13508,19287,247,274,3,13,13,3,9,25,1,0,16,15,2,6,0,2,0,1,1,0,0,0,-5779,-27,-10,10,-16,0,1,-4,-2,30.4,40.6,-10.2,5,4,1,0
15987,13208,254,230,8,2,2,8,7,1,0,0,16,9,3,7,3,0,1,0,0,0,0,0,2779,24,6,-6,6,0,7,-4,3,30.4,17.6,12.8,4,4,0,1
14894,14756,295,251,3,4,4,3,3,5,0,0,38,17,4,1,1,1,1,0,0,0,0,0,138,44,-1,1,-2,0,21,3,0,30.6,13,17.6,5,3,2,0
13506,13678,271,279,1,1,1,1,0,1,0,1,17,17,1,5,1,0,0,1,0,1,0,0,-172,-8,0,0,-1,0,0,-4,1,15,21.4,-6.4,4,4,0,1
13251,16644,252,264,1,9,9,1,1,9,0,0,19,32,4,3,0,2,0,1,0,0,0,0,-3393,-12,-8,8,-8,0,-13,1,-2,13.2,20.8,-7.6,3,4,-1,1
16111,15808,258,254,9,7,7,9,4,12,0,0,12,15,3,3,0,0,1,0,0,0,0,0,303,4,2,-2,-8,0,-3,0,0,26.2,16.4,9.8,4,5,-1,1
16080,14582,271,289,7,3,3,7,7,2,0,0,13,20,5,1,0,1,1,0,0,0,0,0,1498,-18,4,-4,5,0,-7,4,-1,28.6,25.6,3,4,5,-1,1
14833,15626,265,255,4,7,7,4,6,12,0,1,32,24,3,4,2,0,1,0,0,1,0,0,-793,10,-3,3,-6,0,8,-1,2,22,14.6,7.4,4,3,1,0
15851,15377,262,283,7,4,4,7,6,3,0,1,20,169,2,8,2,2,1,0,0,1,0,0,474,-21,3,-3,3,0,-149,-6,0,41.2,34.2,7,5,5,0,1
16743,13950,251,263,10,3,3,10,13,2,0,0,15,16,5,2,2,0,1,0,0,0,0,0,2793,-12,7,-7,11,0,-1,3,2,109,18,91,5,4,1,1
16676,19985,249,283,8,15,15,8,14,21,0,1,17,16,1,4,1,2,0,1,0,1,0,0,-3309,-34,-7,7,-7,0,1,-3,-1,25.4,107,-81.6,5,4,1,0
14562,17069,257,284,4,8,8,4,3,9,0,0,16,85,2,7,1,1,1,0,0,0,0,0,-2507,-27,-4,4,-6,0,-69,-5,0,36,22.4,13.6,4,4,0,0
13906,14934,258,253,3,6,6,3,2,5,0,0,20,12,3,5,0,0,0,1,0,0,0,0,-1028,5,-3,3,-3,0,8,-2,0,17,80.4,-63.4,4,5,-1,1
14852,15691,273,291,4,5,5,4,2,8,0,1,16,16,2,5,0,3,0,1,0,1,0,0,-839,-18,-1,1,-6,0,0,-3,-3,10.6,12.6,-2,3,4,-1,0
16564,14249,282,247,7,4,4,7,8,6,0,0,35,13,3,1,3,0,1,0,0,0,0,0,2315,35,3,-3,2,0,22,2,3,19.8,30.6,-10.8,4,4,0,0
15296,14339,281,286,4,3,3,4,5,0,1,0,136,13,2,4,2,1,1,0,1,0,0,0,957,-5,1,-1,5,0,123,-2,1,41,30.6,10.4,4,5,-1,0
15633,15001,292,286,4,4,4,4,5,4,0,1,20,19,7,3,2,0,1,0,0,1,0,0,632,6,0,0,1,0,1,4,2,52,19.4,32.6,2,2,0,1
16285,13181,284,254,6,1,1,6,9,1,0,0,13,38,6,3,1,0,1,0,0,0,0,0,3104,30,5,-5,8,0,-25,3,1,16.2,29,-12.8,2,5,-3,1
13719,16083,259,272,2,6,6,2,3,10,0,1,16,18,5,1,1,2,1,0,0,1,0,0,-2364,-13,-4,4,-7,0,-2,4,-1,17.2,26.8,-9.6,5,4,1,0
14040,13851,267,249,3,3,3,3,1,5,0,0,16,16,6,4,0,0,0,1,0,0,0,0,189,18,0,0,-4,0,0,2,0,45.2,31,14.2,1,4,-3,1
16916,15166,265,272,8,3,3,8,10,4,0,1,13,14,1,3,2,1,1,0,0,1,0,0,1750,-7,5,-5,6,0,-1,-2,1,72.8,81.2,-8.4,5,5,0,0
16152,16963,241,239,7,11,12,7,13,12,0,0,13,19,0,1,2,0,0,1,0,0,0,0,-811,2,-4,5,1,0,-6,-1,2,83.6,28.4,55.2,5,3,2,0
14299,14152,258,277,2,2,2,2,2,3,0,0,28,20,4,2,2,0,0,1,0,0,0,0,147,-19,0,0,-1,0,8,2,2,136.4,18.8,117.6,5,4,1,0
16406,14792,275,275,8,3,3,8,6,4,0,0,34,18,3,1,1,0,1,0,0,0,0,0,1614,0,5,-5,2,0,16,2,1,42.4,30.6,11.8,4,4,0,1
14524,13446,306,265,2,2,2,2,3,0,1,0,16,17,6,4,0,1,0,1,1,0,0,0,1078,41,0,0,3,0,-1,2,-1,75.2,9.4,65.8,5,4,1,0
14726,16409,257,273,4,7,7,4,4,11,0,0,15,17,1,3,0,1,0,1,0,0,0,0,-1683,-16,-3,3,-7,0,-2,-2,-1,67.2,41.2,26,3,4,-1,0
14311,15136,248,280,4,5,5,4,7,7,0,1,19,24,2,3,0,0,1,0,0,1,0,0,-825,-32,-1,1,0,0,-5,-1,0,32.2,56.4,-24.2,4,3,1,0
13814,16562,227,227,4,11,11,4,2,13,0,1,18,182,2,7,0,2,0,1,0,1,0,0,-2748,0,-7,7,-11,0,-164,-5,-2,29,140.4,-111.4,4,4,0,0
16353,13868,304,290,6,2,2,6,6,1,0,1,15,15,4,6,2,0,1,0,0,1,0,0,2485,14,4,-4,5,0,0,-2,2,10.4,49.2,-38.8,3,4,-1,1
15721,15253,239,274,6,6,6,6,7,9,0,0,19,16,2,1,0,0,1,0,0,0,0,0,468,-35,0,0,-2,0,3,1,0,36.4,33.8,2.6,3,4,-1,1
15980,14371,311,264,5,3,3,5,2,5,0,0,14,10,1,7,2,0,1,0,0,0,0,0,1609,47,2,-2,-3,0,4,-6,2,102,21.4,80.6,4,3,1,1
15387,16171,257,232,6,9,9,6,4,11,1,0,17,12,4,2,1,0,0,1,1,0,0,0,-784,25,-3,3,-7,0,5,2,1,17.8,78.8,-61,3,3,0,1
13063,14719,274,266,0,5,5,0,0,7,0,1,35,18,4,2,0,1,0,1,0,1,0,0,-1656,8,-5,5,-7,0,17,2,-1,11.6,87.6,-76,4,3,1,0
14120,16706,229,247,5,11,11,5,6,10,0,0,15,19,3,5,0,2,1,0,0,0,0,0,-2586,-18,-6,6,-4,0,-4,-2,-2,51,22,29,3,4,-1,0
16590,15169,273,273,7,4,4,7,8,5,0,0,15,16,5,3,2,1,1,0,0,0,0,0,1421,0,3,-3,3,0,-1,2,1,99.2,17.4,81.8,4,4,0,1
12624,14489,202,251,2,5,5,2,2,1,0,0,16,20,0,3,0,2,0,1,0,0,0,0,-1865,-49,-3,3,1,0,-4,-3,-2,23,19.4,3.6,4,4,0,0
15534,15523,265,267,6,6,6,6,6,8,0,0,14,15,3,2,0,0,0,1,0,0,0,0,11,-2,0,0,-2,0,-1,1,0,29.8,110.6,-80.8,5,5,0,0
14059,14227,286,309,2,1,1,2,3,2,1,0,22,16,6,2,0,0,1,0,1,0,0,0,-168,-23,1,-1,1,0,6,4,0,30.6,6,24.6,5,2,3,1
13519,16560,237,278,2,8,8,3,2,10,0,0,15,13,1,5,0,0,0,1,0,0,0,0,-3041,-41,-6,5,-8,0,2,-4,0,13.4,51.8,-38.4,5,4,1,0
15037,15309,278,238,4,8,8,4,3,6,0,0,13,12,3,1,1,0,0,1,0,0,0,0,-272,40,-4,4,-3,0,1,2,1,20.2,70.2,-50,5,5,0,1
13823,15503,249,267,3,6,6,3,1,5,0,1,17,13,2,3,0,0,0,1,0,1,0,0,-1680,-18,-3,3,-4,0,4,-1,0,19.4,110.6,-91.2,4,4,0,0
15346,16351,224,272,6,8,8,6,6,8,0,0,16,20,6,1,0,0,1,0,0,0,0,0,-1005,-48,-2,2,-2,0,-4,5,0,24.8,68.6,-43.8,4,4,0,0
14579,15300,253,262,5,6,6,5,4,2,0,0,20,17,3,2,0,2,1,0,0,0,0,0,-721,-9,-1,1,2,0,3,1,-2,14.8,78.8,-64,4,5,-1,0
15720,14206,293,263,5,2,2,5,8,1,1,0,18,20,7,2,0,1,1,0,1,0,0,0,1514,30,3,-3,7,0,-2,5,-1,8.8,57.2,-48.4,4,4,0,1
15299,14179,299,288,3,2,2,3,4,2,0,0,14,16,3,0,0,1,1,0,0,0,0,0,1120,11,1,-1,2,0,-2,3,-1,37.4,66.8,-29.4,4,3,1,0
15628,15683,269,247,6,6,6,6,3,10,1,0,13,29,3,4,3,1,1,0,1,0,0,0,-55,22,0,0,-7,0,-16,-1,2,53,35.8,17.2,2,3,-1,1
14326,14004,285,253,2,3,3,2,2,5,0,1,16,19,2,6,0,0,0,1,0,1,0,0,322,32,-1,1,-3,0,-3,-4,0,45,97.4,-52.4,5,5,0,1
14491,14261,249,273,5,3,3,5,10,3,0,0,16,19,4,5,0,0,0,1,0,0,0,0,230,-24,2,-2,7,0,-3,-1,0,11.2,37.2,-26,3,4,-1,1
13707,14177,233,250,4,4,4,4,2,3,1,0,15,18,5,6,1,1,0,1,1,0,0,0,-470,-17,0,0,-1,0,-3,-1,0,15.6,58.6,-43,5,4,1,0
13170,15829,250,247,1,10,10,1,1,7,0,0,46,28,5,3,1,0,0,1,0,0,0,0,-2659,3,-9,9,-6,0,18,2,1,51.8,32.6,19.2,5,3,2,0
16189,15836,226,246,10,6,6,10,10,10,0,0,31,13,3,2,1,0,1,0,0,0,0,0,353,-20,4,-4,0,0,18,1,1,65.4,22.8,42.6,3,4,-1,0
15468,14788,276,259,5,4,5,5,6,4,0,0,24,115,3,6,1,0,1,0,0,0,0,0,680,17,1,0,2,0,-91,-3,1,46.4,36.4,10,4,4,0,1
14262,14244,220,238,5,4,4,5,2,4,0,1,15,19,3,2,2,0,1,0,0,1,0,0,18,-18,1,-1,-2,0,-4,1,2,41.6,11,30.6,4,4,0,1
15776,16116,246,266,7,8,8,7,9,5,0,0,16,18,3,7,2,3,0,1,0,0,0,0,-340,-20,-1,1,4,0,-2,-4,-1,31.8,14.2,17.6,5,2,3,0
15527,14975,282,290,5,3,3,5,5,4,0,0,34,16,3,4,0,0,1,0,0,0,0,0,552,-8,2,-2,1,0,18,-1,0,47,51.8,-4.8,3,5,-2,0
13928,16645,247,264,4,9,9,4,1,10,0,0,17,13,2,2,1,1,0,1,0,0,0,0,-2717,-17,-5,5,-9,0,4,0,0,27.4,51.6,-24.2,4,3,1,1
15057,17051,269,279,4,10,10,4,6,15,0,1,12,15,3,3,0,0,1,0,0,1,0,0,-1994,-10,-6,6,-9,0,-3,0,0,42.8,47,-4.2,5,5,0,1
14475,15058,291,268,2,5,5,2,1,7,0,1,16,15,5,1,0,0,0,1,0,1,0,0,-583,23,-3,3,-6,0,1,4,0,8,16,-8,2,4,-2,1
15814,14988,261,275,8,3,3,8,14,5,1,0,14,19,0,4,0,0,1,0,1,0,0,0,826,-14,5,-5,9,0,-5,-4,0,15.4,8.2,7.2,3,3,0,1
16038,15182,266,237,6,7,7,6,7,8,0,0,17,13,4,1,2,0,1,0,0,0,0,0,856,29,-1,1,-1,0,4,3,2,63,47.6,15.4,5,5,0,0
13204,16017,270,271,1,6,6,1,1,7,0,1,32,20,2,2,0,2,0,1,0,1,0,0,-2813,-1,-5,5,-6,0,12,0,-2,10.8,69.2,-58.4,4,5,-1,0
17872,13425,276,224,10,3,3,10,7,2,0,0,17,22,2,1,3,0,1,0,0,0,0,0,4447,52,7,-7,5,0,-5,1,3,31,15.4,15.6,4,4,0,1
14736,14483,267,289,5,3,3,5,3,4,0,0,17,16,4,5,0,0,1,0,0,0,0,0,253,-22,2,-2,-1,0,1,-1,0,13.2,17.4,-4.2,4,5,-1,1
15049,15024,246,267,5,4,4,5,7,4,0,1,11,16,3,3,0,1,0,1,0,1,0,0,25,-21,1,-1,3,0,-5,0,-1,22.4,52.2,-29.8,4,4,0,1
17686,13058,287,226,10,3,3,10,12,3,1,0,18,11,3,2,1,0,0,1,1,0,0,0,4628,61,7,-7,9,0,7,1,1,64.4,39.8,24.6,5,5,0,1
16610,15847,293,294,7,5,5,7,5,2,0,0,17,18,3,3,2,0,1,0,0,0,0,0,763,-1,2,-2,3,0,-1,0,2,9.8,49.8,-40,2,4,-2,1
15551,15922,278,241,6,7,8,6,4,6,0,0,19,18,5,6,0,0,1,0,0,0,0,0,-371,37,-1,2,-2,0,1,-1,0,60.2,106.2,-46,3,5,-2,0
15065,13297,279,260,5,1,1,5,4,0,1,0,17,40,3,2,0,1,1,0,1,0,0,0,1768,19,4,-4,4,0,-23,1,-1,16.6,17.8,-1.2,3,4,-1,1
18566,14195,283,243,11,3,3,11,12,4,0,0,38,18,6,0,3,2,1,0,0,0,0,0,4371,40,8,-8,8,0,20,6,1,33,30,3,4,5,-1,1
14002,17205,242,256,3,10,10,3,3,9,0,1,18,21,2,6,1,2,0,1,0,1,0,0,-3203,-14,-7,7,-6,0,-3,-4,-1,13.4,27.6,-14.2,5,4,1,0
15451,13690,276,263,5,1,1,5,8,1,0,0,17,14,0,3,0,2,1,0,0,0,0,0,1761,13,4,-4,7,0,3,-3,-2,49.4,21.8,27.6,4,3,1,0
14866,17110,275,275,4,9,9,4,4,10,1,0,14,13,3,2,0,0,0,1,1,0,0,0,-2244,0,-5,5,-6,0,1,1,0,11.6,11.8,-0.2,4,4,0,0
16284,14772,288,279,7,4,4,7,4,7,1,0,19,12,3,6,1,0,0,1,1,0,0,0,1512,9,3,-3,-3,0,7,-3,1,120.8,29.6,91.2,3,4,-1,0
15705,15356,290,268,5,6,6,5,4,7,0,1,15,10,0,7,0,1,0,1,0,1,0,0,349,22,-1,1,-3,0,5,-7,-1,44.6,43.6,1,3,4,-1,1
14965,17233,260,284,5,9,9,5,2,10,0,1,22,17,3,3,0,3,0,1,0,1,0,0,-2268,-24,-4,4,-8,0,5,0,-3,21.4,19.2,2.2,3,4,-1,0
15435,15858,267,265,5,7,7,5,6,6,0,0,24,12,2,4,0,0,1,0,0,0,0,0,-423,2,-2,2,0,0,12,-2,0,56.2,16.4,39.8,4,4,0,0
15139,16029,277,282,4,7,7,4,6,8,0,0,19,13,3,6,1,0,1,0,0,0,0,0,-890,-5,-3,3,-2,0,6,-3,1,16.4,98.8,-82.4,4,5,-1,0
16444,14678,262,270,8,4,4,8,15,4,1,0,16,17,5,1,2,0,1,0,1,0,0,0,1766,-8,4,-4,11,0,-1,4,2,39.4,43.4,-4,5,3,2,1
15020,13883,280,263,4,2,2,4,5,4,0,0,15,15,6,1,0,1,1,0,0,0,0,0,1137,17,2,-2,1,0,0,5,-1,18.6,20.6,-2,4,5,-1,1
14942,13068,286,263,4,1,1,4,1,1,0,1,16,36,3,2,0,0,0,1,0,1,0,0,1874,23,3,-3,0,0,-20,1,0,48.8,107.6,-58.8,4,4,0,1
13490,13637,281,269,1,1,1,1,1,1,1,0,20,16,2,2,0,0,0,1,1,0,0,0,-147,12,0,0,0,0,4,0,0,59.2,115.6,-56.4,4,4,0,1
16993,15818,267,262,9,6,6,10,14,5,0,0,17,30,3,4,0,2,1,0,0,0,0,0,1175,5,3,-4,9,0,-13,-1,-2,39.8,25.4,14.4,5,4,1,1
14799,16297,265,281,4,6,6,4,4,6,0,0,19,17,4,3,0,2,0,1,0,0,0,0,-1498,-16,-2,2,-2,0,2,1,-2,19.8,58,-38.2,5,4,1,0
14251,14987,275,265,2,5,5,2,3,8,1,0,14,20,2,4,0,0,0,1,1,0,0,0,-736,10,-3,3,-5,0,-6,-2,0,73,16,57,3,5,-2,1
14994,16198,273,280,4,6,6,4,7,7,0,1,18,17,6,3,0,1,1,0,0,1,0,0,-1204,-7,-2,2,0,0,1,3,-1,30,12.6,17.4,3,2,1,0
14626,14782,269,264,4,5,5,4,3,3,0,0,37,15,6,1,0,0,1,0,0,0,0,0,-156,5,-1,1,0,0,22,5,0,16.8,24.6,-7.8,5,4,1,0
12682,17426,231,279,1,10,10,1,1,14,0,0,14,25,3,4,0,0,0,1,0,0,0,0,-4744,-48,-9,9,-13,0,-11,-1,0,62.2,76.4,-14.2,5,5,0,0
14574,14636,277,288,3,4,4,3,5,2,0,1,15,22,1,3,0,0,0,1,0,1,0,0,-62,-11,-1,1,3,0,-7,-2,0,24.6,26,-1.4,2,5,-3,0
15337,15324,276,271,4,5,5,4,6,7,0,0,15,17,3,3,3,2,0,1,0,0,0,0,13,5,-1,1,-1,0,-2,0,1,61.4,27.4,34,5,3,2,0
13733,16792,253,267,2,9,9,3,2,12,0,0,19,15,3,4,0,1,0,1,0,0,0,0,-3059,-14,-7,6,-10,0,4,-1,-1,11.6,26.8,-15.2,3,4,-1,0
15144,15320,281,273,4,5,5,4,3,8,0,1,13,21,4,2,1,2,1,0,0,1,0,0,-176,8,-1,1,-5,0,-8,2,-1,119,14,105,5,5,0,1
15303,15157,279,288,5,4,4,5,6,4,0,0,14,18,2,2,0,0,1,0,0,0,0,0,146,-9,1,-1,2,0,-4,0,0,42,26.8,15.2,4,3,1,0
14588,16403,264,238,3,8,8,3,4,17,0,1,19,14,1,2,2,0,0,1,0,1,0,0,-1815,26,-5,5,-13,0,5,-1,2,13.2,64.8,-51.6,4,4,0,0
17064,15953,249,267,10,6,6,10,14,7,0,0,24,13,2,2,2,2,1,0,0,0,0,0,1111,-18,4,-4,7,0,11,0,0,46.4,85.2,-38.8,4,4,0,0
15813,15917,240,257,7,6,7,7,13,11,1,0,14,16,1,2,1,3,0,1,1,0,0,0,-104,-17,1,0,2,0,-2,-1,-2,21.6,11.8,9.8,4,2,2,1
16380,14572,298,287,6,2,2,6,5,3,0,1,16,14,0,6,1,0,1,0,0,1,0,0,1808,11,4,-4,2,0,2,-6,1,20.2,17.4,2.8,5,5,0,0
15372,13942,250,270,7,2,2,7,9,2,1,0,21,13,3,3,0,0,1,0,1,0,0,0,1430,-20,5,-5,7,0,8,0,0,13.4,44.4,-31,3,5,-2,1
18111,15191,274,218,10,7,7,10,12,9,0,1,17,14,3,5,5,1,1,0,0,1,0,0,2920,56,3,-3,3,0,3,-2,4,20.4,36.4,-16,5,5,0,1
13761,14973,309,294,0,4,4,0,0,2,0,1,18,15,3,4,0,0,0,1,0,1,0,0,-1212,15,-4,4,-2,0,3,-1,0,19.6,33,-13.4,5,5,0,1
13885,14451,260,261,2,4,4,2,6,3,0,0,18,13,1,5,0,1,0,1,0,0,0,0,-566,-1,-2,2,3,0,5,-4,-1,8.2,5,3.2,3,1,2,1
16007,14705,262,256,8,5,5,8,9,5,0,0,21,13,1,5,0,0,0,1,0,0,0,0,1302,6,3,-3,4,0,8,-4,0,30.8,10.4,20.4,3,2,1,1
15890,15913,284,271,6,6,6,6,4,6,0,1,12,13,3,1,2,1,1,0,0,1,0,0,-23,13,0,0,-2,0,-1,2,1,61,7.6,53.4,5,3,2,1
13544,14239,258,279,2,2,2,2,0,2,1,0,55,16,5,2,0,0,0,1,1,0,0,0,-695,-21,0,0,-2,0,39,3,0,16.6,27.6,-11,4,4,0,1
15277,15841,254,257,6,7,7,6,5,4,0,1,36,22,2,2,1,0,1,0,0,1,0,0,-564,-3,-1,1,1,0,14,0,1,82.4,17.2,65.2,4,3,1,0
14482,14686,268,275,3,4,4,3,2,3,0,0,13,20,3,2,1,0,0,1,0,0,0,0,-204,-7,-1,1,-1,0,-7,1,1,17.6,48.2,-30.6,4,5,-1,1
15315,13585,273,265,5,2,2,5,4,2,0,0,17,14,2,4,0,0,1,0,0,0,0,0,1730,8,3,-3,2,0,3,-2,0,15.4,12.4,3,5,4,1,1
16739,14479,275,240,8,4,4,8,11,3,0,1,18,17,2,4,2,0,1,0,0,1,0,0,2260,35,4,-4,8,0,1,-2,2,12.6,28.4,-15.8,4,4,0,1
14350,13588,272,268,3,2,2,3,1,2,0,1,17,17,4,1,0,0,1,0,0,1,0,0,762,4,1,-1,-1,0,0,3,0,40.8,8.4,32.4,4,3,1,1
14993,15211,287,284,4,3,3,4,5,9,0,0,15,19,2,5,0,0,1,0,0,0,0,0,-218,3,1,-1,-4,0,-4,-3,0,38.2,10.4,27.8,4,3,1,1
15992,14114,285,259,5,3,3,5,5,1,0,1,19,16,1,6,0,1,0,1,0,1,0,0,1878,26,2,-2,4,0,3,-5,-1,6.4,15.6,-9.2,3,5,-2,1
15103,14199,292,267,3,3,3,3,4,3,0,1,105,17,1,2,0,0,0,1,0,1,0,0,904,25,0,0,1,0,88,-1,0,29.2,26.6,2.6,4,4,0,0
17256,16284,275,287,9,6,6,9,13,6,1,0,17,19,7,4,0,0,1,0,1,0,0,0,972,-12,3,-3,7,0,-2,3,0,17.6,6.4,11.2,4,3,1,1
14687,17853,230,251,6,13,13,6,7,21,0,1,37,17,6,4,0,1,1,0,0,1,0,0,-3166,-21,-7,7,-14,0,20,2,-1,13.2,13,0.2,4,3,1,0
13811,16164,268,258,3,8,8,3,2,13,0,1,15,20,3,5,0,0,0,1,0,1,0,0,-2353,10,-5,5,-11,0,-5,-2,0,11,36,-25,3,5,-2,0
15320,15156,249,264,6,5,5,6,11,5,1,0,15,14,4,4,0,1,1,0,1,0,0,0,164,-15,1,-1,6,0,1,0,-1,15.2,12.4,2.8,3,3,0,1
14731,14662,263,285,5,3,3,5,5,1,0,1,13,28,4,4,0,2,1,0,0,1,0,0,69,-22,2,-2,4,0,-15,0,-2,34.2,77,-42.8,3,3,0,1
14882,16703,209,265,6,7,7,6,5,15,0,0,17,20,5,3,0,2,0,1,0,0,0,0,-1821,-56,-1,1,-10,0,-3,2,-2,24.4,18.4,6,4,3,1,0
14281,14576,317,308,1,2,2,1,0,1,1,0,18,15,3,7,1,1,1,0,1,0,0,0,-295,9,-1,1,-1,0,3,-4,0,13.4,21.2,-7.8,4,3,1,1
15523,16420,264,258,4,8,8,4,5,13,0,0,18,19,3,6,0,0,0,1,0,0,0,0,-897,6,-4,4,-8,0,-1,-3,0,13.4,46.6,-33.2,2,4,-2,1
16371,15351,262,248,7,6,6,8,6,8,0,0,16,128,3,0,1,1,1,0,0,0,0,0,1020,14,1,-2,-2,0,-112,3,0,38,50.2,-12.2,4,5,-1,1
13644,15476,265,266,2,6,6,2,3,8,0,1,21,24,5,8,0,0,1,0,0,1,0,0,-1832,-1,-4,4,-5,0,-3,-3,0,44,52.8,-8.8,4,5,-1,0
16968,12812,288,253,9,1,1,9,8,0,1,0,16,17,4,2,0,0,1,0,1,0,0,0,4156,35,8,-8,8,0,-1,2,0,18.4,17,1.4,5,4,1,1
16654,14261,242,247,9,4,4,9,13,3,0,0,31,16,5,3,0,0,1,0,0,0,0,0,2393,-5,5,-5,10,0,15,2,0,28.8,11.2,17.6,5,3,2,1
15434,14531,264,272,6,3,3,6,2,5,0,0,37,22,1,4,1,0,0,1,0,0,0,0,903,-8,3,-3,-3,0,15,-3,1,36.2,10.8,25.4,3,3,0,1
14117,15037,258,258,3,5,5,3,3,7,0,0,17,15,5,2,0,0,1,0,0,0,0,0,-920,0,-2,2,-4,0,2,3,0,12.2,47.4,-35.2,3,4,-1,1
17506,16586,230,258,13,9,9,14,13,8,1,0,23,16,3,3,3,1,1,0,1,0,0,0,920,-28,4,-5,5,0,7,0,2,42.4,11.8,30.6,5,4,1,1
16394,14628,294,269,6,3,3,6,5,3,0,0,22,17,4,4,1,0,1,0,0,0,0,0,1766,25,3,-3,2,0,5,0,1,17.2,9.8,7.4,5,4,1,1
15445,17680,270,276,4,9,9,4,5,14,0,0,19,19,4,6,2,0,0,1,0,0,0,0,-2235,-6,-5,5,-9,0,0,-2,2,12.2,55.2,-43,4,3,1,0
14237,16064,270,293,2,6,6,2,2,5,0,0,15,19,5,7,1,1,0,1,0,0,0,0,-1827,-23,-4,4,-3,0,-4,-2,0,25,23.4,1.6,5,5,0,0
13870,17440,215,267,2,10,10,2,4,15,0,1,110,19,4,5,3,2,0,1,0,1,0,0,-3570,-52,-8,8,-11,0,91,-1,1,56.2,111.8,-55.6,5,5,0,0
13844,14662,301,289,0,3,3,0,0,6,0,1,17,21,7,5,0,0,0,1,0,1,0,0,-818,12,-3,3,-6,0,-4,2,0,11.8,7.6,4.2,3,2,1,0
17140,17052,289,304,7,7,8,7,9,9,0,1,45,120,3,5,0,0,0,1,0,1,0,0,88,-15,0,1,0,0,-75,-2,0,19.6,33.6,-14,3,4,-1,0
13861,14141,291,278,1,2,2,1,0,2,0,0,21,20,6,5,0,0,1,0,0,0,0,0,-280,13,-1,1,-2,0,1,1,0,9.2,31.2,-22,3,5,-2,1
17230,14613,260,218,10,6,6,10,8,7,1,0,16,25,2,2,1,0,1,0,1,0,0,0,2617,42,4,-4,1,0,-9,0,1,20.2,53.6,-33.4,5,4,1,1
16326,14661,262,261,9,4,4,9,6,2,1,0,17,18,4,7,2,2,1,0,1,0,0,0,1665,1,5,-5,4,0,-1,-3,0,34.8,70,-35.2,4,5,-1,1
12374,14768,254,287,1,4,4,1,0,1,1,0,14,15,1,0,0,0,0,1,1,0,0,0,-2394,-33,-3,3,-1,0,-1,1,0,12.4,7.8,4.6,3,1,2,0
14502,14635,252,244,4,7,7,4,6,5,0,1,18,11,1,1,1,0,1,0,0,1,0,0,-133,8,-3,3,1,0,7,0,1,10,4.6,5.4,5,1,4,0
14106,14884,207,244,5,4,4,5,2,4,0,1,17,14,3,0,1,0,1,0,0,1,0,0,-778,-37,1,-1,-2,0,3,3,1,26.8,10.6,16.2,4,4,0,1
13298,15249,248,266,2,5,5,2,2,4,0,0,15,15,3,2,0,0,1,0,0,0,0,0,-1951,-18,-3,3,-2,0,0,1,0,5.8,4.6,1.2,2,1,1,1
17303,14073,319,282,7,2,2,7,10,2,0,0,116,17,6,4,1,0,1,0,0,0,0,0,3230,37,5,-5,8,0,99,2,1,31.6,21.2,10.4,4,3,1,1
16033,15061,292,266,6,5,5,6,10,6,0,0,13,213,2,2,1,0,1,0,0,0,0,0,972,26,1,-1,4,0,-200,0,1,145.4,38.8,106.6,4,5,-1,1
12015,17589,201,291,1,8,8,1,2,12,0,0,32,32,5,3,0,0,0,1,0,0,0,0,-5574,-90,-7,7,-10,0,0,2,0,19.2,11.8,7.4,4,2,2,0
16627,16182,251,237,11,7,7,12,5,8,0,0,9,14,1,1,0,0,1,0,0,0,0,0,445,14,4,-5,-3,0,-5,0,0,26.8,28.6,-1.8,4,4,0,0
17884,15963,261,215,12,8,8,12,7,11,1,0,16,33,3,1,1,0,0,1,1,0,0,0,1921,46,4,-4,-4,0,-17,2,1,93,13.8,79.2,4,3,1,0
13296,16759,281,284,1,9,9,1,0,11,0,0,32,15,3,3,0,0,0,1,0,0,0,0,-3463,-3,-8,8,-11,0,17,0,0,103.8,52.8,51,3,5,-2,0
14937,16078,244,243,6,8,8,6,7,9,1,0,9,17,2,1,0,1,1,0,1,0,0,0,-1141,1,-2,2,-2,0,-8,1,-1,11.2,24.8,-13.6,3,3,0,1
18380,17742,239,245,15,11,11,15,13,9,0,0,20,21,0,4,2,1,1,0,0,0,0,0,638,-6,4,-4,4,0,-1,-4,1,65.8,37.4,28.4,4,5,-1,0
16517,14544,250,274,9,4,4,9,9,3,0,1,55,13,3,5,1,0,1,0,0,1,0,0,1973,-24,5,-5,6,0,42,-2,1,23.8,29.6,-5.8,4,3,1,0
17079,18101,220,234,11,12,12,11,12,16,0,1,17,18,0,3,1,0,0,1,0,1,0,0,-1022,-14,-1,1,-4,0,-1,-3,1,11.4,80.8,-69.4,4,5,-1,0
15769,14188,254,252,7,3,3,7,16,3,0,0,44,18,1,4,0,1,1,0,0,0,0,0,1581,2,4,-4,13,0,26,-3,-1,16.4,54.2,-37.8,3,2,1,1
14628,15129,262,285,4,4,4,4,8,7,1,0,15,33,1,1,0,1,0,1,1,0,0,0,-501,-23,0,0,1,0,-18,0,-1,24.8,47.4,-22.6,4,3,1,1
14933,15672,260,262,5,7,7,6,3,9,1,0,41,14,5,2,0,0,0,1,1,0,0,0,-739,-2,-2,1,-6,0,27,3,0,117,36.4,80.6,5,3,2,1
15129,15132,294,297,3,4,4,3,4,4,0,1,16,17,0,1,2,0,0,1,0,1,0,0,-3,-3,-1,1,0,0,-1,-1,2,28.6,49,-20.4,4,4,0,1
15120,15992,252,224,5,10,10,5,7,10,0,0,17,17,2,6,0,0,0,1,0,0,0,0,-872,28,-5,5,-3,0,0,-4,0,36.6,14.4,22.2,4,3,1,0
16011,14526,249,269,7,3,3,7,6,3,0,0,14,13,4,2,1,1,0,1,0,0,0,0,1485,-20,4,-4,3,0,1,2,0,37.2,58.6,-21.4,4,5,-1,1
14264,13648,276,259,2,2,2,2,2,4,0,0,15,32,2,5,2,1,0,1,0,0,0,0,616,17,0,0,-2,0,-17,-3,1,34.6,24.4,10.2,4,3,1,1
15947,17996,253,261,7,12,12,7,10,21,0,0,13,40,2,3,0,2,0,1,0,0,0,0,-2049,-8,-5,5,-11,0,-27,-1,-2,92,50.4,41.6,4,4,0,0
13823,14396,229,257,3,4,4,3,6,4,0,1,14,21,5,3,0,0,1,0,0,1,0,0,-573,-28,-1,1,2,0,-7,2,0,19.8,29.2,-9.4,4,3,1,0
15490,16562,251,236,7,11,11,7,8,13,1,0,15,18,6,4,0,1,1,0,1,0,0,0,-1072,15,-4,4,-5,0,-3,2,-1,39.4,78.4,-39,5,3,2,0
17706,13295,285,228,9,2,2,9,8,3,0,0,42,12,1,3,3,0,0,1,0,0,0,0,4411,57,7,-7,5,0,30,-2,3,101.6,22,79.6,5,3,2,1
18617,16874,253,255,12,8,8,12,17,10,1,0,17,18,6,4,2,1,1,0,1,0,0,0,1743,-2,4,-4,7,0,-1,2,1,65.4,79.2,-13.8,4,4,0,1
14681,15563,256,287,5,5,5,5,8,7,0,0,37,17,4,0,0,0,1,0,0,0,0,0,-882,-31,0,0,1,0,20,4,0,17,14,3,5,4,1,0
16562,16158,240,230,9,9,9,9,9,7,0,0,17,13,5,4,0,1,0,1,0,0,0,0,404,10,0,0,2,0,4,1,-1,62.4,9.4,53,4,3,1,1
16306,14491,257,259,8,4,4,8,12,5,0,0,17,36,8,2,1,1,0,1,0,0,0,0,1815,-2,4,-4,7,0,-19,6,0,10.8,34,-23.2,4,3,1,0
15722,17459,251,269,6,13,13,6,4,6,0,1,16,37,3,1,1,1,0,1,0,1,0,0,-1737,-18,-7,7,-2,0,-21,2,0,32.4,28.4,4,3,4,-1,0
14087,14754,282,263,2,4,4,2,4,8,0,0,35,18,3,3,0,1,1,0,0,0,0,0,-667,19,-2,2,-4,0,17,0,-1,31.6,53.4,-21.8,5,3,2,1
15416,15412,284,285,4,6,6,4,8,6,0,1,14,18,5,4,1,1,0,1,0,1,0,0,4,-1,-2,2,2,0,-4,1,0,52,20,32,3,3,0,0
15817,15274,258,253,8,7,7,8,10,9,0,0,16,15,2,2,0,0,0,1,0,0,0,0,543,5,1,-1,1,0,1,0,0,7.4,59.6,-52.2,3,4,-1,0
13457,16212,228,291,2,6,6,2,3,6,0,0,39,13,1,7,0,2,0,1,0,0,0,0,-2755,-63,-4,4,-3,0,26,-6,-2,22.8,11.6,11.2,4,3,1,0
16313,13410,271,225,10,2,2,10,5,2,1,0,18,17,5,1,2,0,1,0,1,0,0,0,2903,46,8,-8,3,0,1,4,2,60,103.6,-43.6,4,4,0,1
17438,13742,282,271,9,2,2,9,8,1,0,0,14,10,1,3,2,0,1,0,0,0,0,0,3696,11,7,-7,7,0,4,-2,2,44,121.4,-77.4,4,2,2,1
14089,17127,216,272,4,11,11,4,5,6,0,0,14,22,2,0,0,2,0,1,0,0,0,0,-3038,-56,-7,7,-1,0,-8,2,-2,13.4,7,6.4,1,3,-2,0
15020,17461,206,249,8,11,11,8,11,10,0,0,16,17,2,2,0,1,0,1,0,0,0,0,-2441,-43,-3,3,1,0,-1,0,-1,6.6,92,-85.4,2,4,-2,0
14917,15576,253,258,5,5,5,5,9,9,0,0,14,16,4,1,1,2,1,0,0,0,0,0,-659,-5,0,0,0,0,-2,3,-1,39.6,12.6,27,2,2,0,1
12933,15817,275,275,0,6,6,0,0,3,0,0,15,19,1,3,0,4,0,1,0,0,0,0,-2884,0,-6,6,-3,0,-4,-2,-4,36.2,119,-82.8,5,4,1,1
16131,16211,266,260,6,8,8,6,6,6,0,1,15,15,2,0,1,1,0,1,0,1,0,0,-80,6,-2,2,0,0,0,2,0,33.4,16.2,17.2,4,4,0,1
15485,16367,264,238,6,8,8,6,6,15,0,0,20,19,2,2,2,1,0,1,0,0,0,0,-882,26,-2,2,-9,0,1,0,1,7.6,11.8,-4.2,2,3,-1,0
15216,18426,233,286,6,11,11,6,9,8,1,0,16,17,4,3,0,1,0,1,1,0,0,0,-3210,-53,-5,5,1,0,-1,1,-1,17.6,53.4,-35.8,2,4,-2,0
15527,15206,236,175,7,9,9,7,5,14,0,0,12,16,2,2,3,0,1,0,0,0,0,0,321,61,-2,2,-9,0,-4,0,3,25,7.6,17.4,3,2,1,1
14985,15474,275,284,5,5,5,5,5,3,1,0,17,15,4,3,0,3,1,0,1,0,0,0,-489,-9,0,0,2,0,2,1,-3,21.8,120.8,-99,3,5,-2,1
14013,16917,235,264,4,9,9,4,6,16,0,0,17,13,3,2,1,0,1,0,0,0,0,0,-2904,-29,-5,5,-10,0,4,1,1,66,23.4,42.6,5,3,2,0
12716,14218,208,289,2,2,2,2,4,2,0,0,18,37,4,4,0,1,1,0,0,0,0,0,-1502,-81,0,0,2,0,-19,0,-1,50.4,11.4,39,3,3,0,0
16021,13639,240,243,8,2,2,8,11,2,0,0,35,41,4,4,1,0,1,0,0,0,0,0,2382,-3,6,-6,9,0,-6,0,1,14.8,101.8,-87,4,3,1,1
13808,16061,246,259,4,7,7,4,2,4,0,0,16,22,1,2,1,2,1,0,0,0,0,0,-2253,-13,-3,3,-2,0,-6,-1,-1,5,6.2,-1.2,1,2,-1,0
14466,16261,264,268,4,9,9,4,3,9,1,0,36,23,1,2,0,0,0,1,1,0,0,0,-1795,-4,-5,5,-6,0,13,-1,0,9.2,22,-12.8,4,5,-1,0
14127,16282,261,287,3,7,7,3,1,6,0,0,16,33,5,5,0,1,0,1,0,0,0,0,-2155,-26,-4,4,-5,0,-17,0,-1,46,30.4,15.6,5,4,1,0
15300,14306,297,262,4,3,3,4,2,3,0,0,12,16,4,1,1,0,1,0,0,0,0,0,994,35,1,-1,-1,0,-4,3,1,12,38.4,-26.4,2,5,-3,1
15489,13543,293,259,4,2,2,5,5,4,0,1,31,25,0,2,0,0,0,1,0,1,0,0,1946,34,2,-3,1,0,6,-2,0,27.8,106.2,-78.4,4,5,-1,1
13947,15480,244,260,3,6,6,3,2,4,0,0,20,17,2,5,0,3,0,1,0,0,0,0,-1533,-16,-3,3,-2,0,3,-3,-3,10.2,40.8,-30.6,2,4,-2,0
15792,15027,281,267,7,5,5,7,5,6,0,0,14,18,2,4,0,0,1,0,0,0,0,0,765,14,2,-2,-1,0,-4,-2,0,53.8,62.6,-8.8,5,4,1,1
14993,14137,276,260,5,3,3,5,4,7,1,0,17,14,2,5,1,0,1,0,1,0,0,0,856,16,2,-2,-3,0,3,-3,1,22.6,17.2,5.4,5,3,2,0
15302,16819,283,278,4,7,7,4,5,11,0,0,16,34,7,5,1,0,0,1,0,0,0,0,-1517,5,-3,3,-6,0,-18,2,1,46.8,64.8,-18,4,4,0,0
14585,14995,242,265,6,4,4,6,10,3,0,1,16,22,6,3,0,1,1,0,0,1,0,0,-410,-23,2,-2,7,0,-6,3,-1,50.8,24.2,26.6,4,5,-1,0
14632,17387,259,308,5,9,9,5,7,14,0,1,26,63,3,4,0,0,0,1,0,1,0,0,-2755,-49,-4,4,-7,0,-37,-1,0,12.2,46.2,-34,3,2,1,0
17002,13702,286,250,10,2,2,10,9,2,1,0,15,12,1,0,2,0,1,0,1,0,0,0,3300,36,8,-8,7,0,3,1,2,33.2,12.6,20.6,5,3,2,1
15293,14367,248,243,6,4,4,6,10,5,0,0,16,46,6,2,1,2,1,0,0,0,0,0,926,5,2,-2,5,0,-30,4,-1,6.6,72.8,-66.2,3,4,-1,1
15862,13567,286,237,6,2,2,6,5,3,0,0,17,14,3,3,2,1,1,0,0,0,0,0,2295,49,4,-4,2,0,3,0,1,57.2,92.2,-35,5,3,2,1
19014,14256,275,250,13,3,3,13,14,3,0,0,37,15,0,2,1,0,0,1,0,0,0,0,4758,25,10,-10,11,0,22,-2,1,101,7.4,93.6,4,3,1,1
15335,15244,269,272,4,4,5,4,3,8,0,1,19,18,2,4,2,0,1,0,0,1,0,0,91,-3,0,1,-5,0,1,-2,2,41.8,104,-62.2,5,5,0,0
15240,16190,269,248,5,8,8,5,5,14,0,1,17,19,2,4,1,0,1,0,0,1,0,0,-950,21,-3,3,-9,0,-2,-2,1,23.4,47.2,-23.8,3,5,-2,0
13240,16074,281,286,0,6,6,0,0,6,0,1,14,18,1,3,0,0,0,1,0,1,0,0,-2834,-5,-6,6,-6,0,-4,-2,0,12.6,25,-12.4,4,5,-1,1
15263,15504,245,265,6,6,7,6,7,5,0,1,19,14,4,3,1,1,0,1,0,1,0,0,-241,-20,0,1,2,0,5,1,0,30.8,64.6,-33.8,2,4,-2,0
14123,15696,269,259,2,7,7,2,2,4,0,0,15,36,5,6,0,0,0,1,0,0,0,0,-1573,10,-5,5,-2,0,-21,-1,0,23.6,10.4,13.2,3,2,1,0
15507,15701,256,278,5,6,6,5,5,7,0,0,21,89,0,2,0,0,1,0,0,0,0,0,-194,-22,-1,1,-2,0,-68,-2,0,42.2,14,28.2,4,2,2,1
13425,14630,265,258,1,4,4,1,1,6,0,0,16,16,4,4,0,0,1,0,0,0,0,0,-1205,7,-3,3,-5,0,0,0,0,28,40,-12,3,5,-2,1
16434,14341,217,209,12,6,6,12,8,5,0,0,14,11,1,2,2,0,0,1,0,0,0,0,2093,8,6,-6,3,0,3,-1,2,29.8,7,22.8,4,2,2,1
14220,16997,227,247,5,11,11,5,5,9,0,0,14,15,4,3,0,0,1,0,0,0,0,0,-2777,-20,-6,6,-4,0,-1,1,0,8.4,22.4,-14,3,3,0,1
15851,14844,267,265,5,4,4,5,8,3,1,0,32,16,5,2,0,0,0,1,1,0,0,0,1007,2,1,-1,5,0,16,3,0,112.6,20.4,92.2,5,3,2,1
15723,13657,269,242,6,3,3,6,8,3,0,0,60,17,2,0,1,0,0,1,0,0,0,0,2066,27,3,-3,5,0,43,2,1,14.2,97,-82.8,2,3,-1,0
14623,16628,254,257,4,8,8,4,5,12,0,0,14,18,3,5,2,1,1,0,0,0,0,0,-2005,-3,-4,4,-7,0,-4,-2,1,24.4,18.2,6.2,4,3,1,1
18406,15039,270,253,13,4,4,13,14,9,0,0,21,21,4,7,1,0,1,0,0,0,0,0,3367,17,9,-9,5,0,0,-3,1,73.8,57.6,16.2,4,3,1,1
18639,15148,276,237,15,5,5,15,16,7,1,0,14,14,1,3,0,0,1,0,1,0,0,0,3491,39,10,-10,9,0,0,-2,0,76.6,23.2,53.4,4,4,0,1
14455,15573,236,245,4,8,8,4,8,6,0,1,15,17,0,0,0,1,0,1,0,1,0,0,-1118,-9,-4,4,2,0,-2,0,-1,9.8,50,-40.2,3,3,0,0
16912,14564,244,247,9,4,4,9,9,5,0,1,20,14,4,3,2,0,1,0,0,1,0,0,2348,-3,5,-5,4,0,6,1,2,118.4,38.6,79.8,5,5,0,1
16549,16581,261,223,9,10,10,9,5,10,1,0,17,15,3,5,1,1,1,0,1,0,0,0,-32,38,-1,1,-5,0,2,-2,0,24.4,35.4,-11,4,5,-1,1
15200,15512,266,270,4,5,5,4,6,7,0,1,18,16,2,3,3,1,1,0,0,1,0,0,-312,-4,-1,1,-1,0,2,-1,2,67,36.4,30.6,4,4,0,1
13280,15644,239,293,2,5,5,2,0,4,0,1,36,35,4,3,0,2,0,1,0,1,0,0,-2364,-54,-3,3,-4,0,1,1,-2,41.6,71.4,-29.8,4,5,-1,0
14517,15038,242,247,4,6,6,4,4,8,0,1,15,70,1,2,2,0,1,0,0,1,0,0,-521,-5,-2,2,-4,0,-55,-1,2,128.6,8,120.6,5,2,3,0
16238,15585,249,254,7,7,7,7,7,6,1,0,63,19,5,1,3,1,0,1,1,0,0,0,653,-5,0,0,1,0,44,4,2,11.2,74.8,-63.6,4,4,0,0
14292,15883,246,307,4,4,4,4,2,5,0,0,17,21,7,0,1,2,0,1,0,0,0,0,-1591,-61,0,0,-3,0,-4,7,-1,61.6,55.4,6.2,5,5,0,0
16358,15932,258,254,8,7,7,8,16,9,0,0,27,19,5,2,2,0,1,0,0,0,0,0,426,4,1,-1,7,0,8,3,2,28.8,61.4,-32.6,4,5,-1,0
15602,15147,264,291,7,5,5,7,6,1,0,1,12,19,5,1,1,1,0,1,0,1,0,0,455,-27,2,-2,5,0,-7,4,0,97.2,106.4,-9.2,4,4,0,0
15850,14255,287,229,5,5,5,5,9,3,1,0,16,15,5,4,2,0,1,0,1,0,0,0,1595,58,0,0,6,0,1,1,2,17,98.6,-81.6,4,4,0,1
15498,15541,261,256,7,6,6,7,6,7,1,0,13,16,6,2,0,0,1,0,1,0,0,0,-43,5,1,-1,-1,0,-3,4,0,53.2,141.4,-88.2,3,4,-1,1
15667,14235,266,256,6,5,5,6,12,0,0,0,13,13,2,2,0,0,0,1,0,0,0,0,1432,10,1,-1,12,0,0,0,0,111,154,-43,5,4,1,1
16912,14657,263,256,8,4,7,8,11,4,1,0,16,18,1,4,2,1,0,1,1,0,0,0,2255,7,4,-1,7,0,-2,-3,1,31,102.8,-71.8,3,5,-2,1
14625,16613,239,241,6,9,9,6,4,17,0,1,76,23,4,2,0,0,1,0,0,1,0,0,-1988,-2,-3,3,-13,0,53,2,0,33.6,97.2,-63.6,3,4,-1,0
16591,17078,273,261,8,8,8,8,9,13,0,0,20,35,6,4,3,2,1,0,0,0,0,0,-487,12,0,0,-4,0,-15,2,1,99.6,16,83.6,4,3,1,0
16319,17811,217,284,10,10,10,10,14,9,0,1,19,14,3,2,0,1,0,1,0,1,0,0,-1492,-67,0,0,5,0,5,1,-1,30,91,-61,4,4,0,1
16916,16405,286,259,7,9,9,7,12,10,0,0,18,17,5,3,1,0,0,1,0,0,0,0,511,27,-2,2,2,0,1,2,1,36.6,55.2,-18.6,3,3,0,0
13647,14382,268,273,2,3,3,2,1,4,0,1,13,33,1,2,0,0,1,0,0,1,0,0,-735,-5,-1,1,-3,0,-20,-1,0,35.8,125.8,-90,4,3,1,0
14734,15173,257,268,4,4,4,4,4,6,1,0,18,17,3,4,0,1,1,0,1,0,0,0,-439,-11,0,0,-2,0,1,-1,-1,104.4,23.6,80.8,5,5,0,1
14397,15733,258,271,3,6,6,3,3,11,0,1,43,14,0,5,1,0,1,0,0,1,0,0,-1336,-13,-3,3,-8,0,29,-5,1,23,26,-3,3,4,-1,1
15514,14889,264,226,6,5,5,7,8,5,0,0,23,14,5,2,1,0,0,1,0,0,0,0,625,38,1,-2,3,0,9,3,1,84.2,18,66.2,5,4,1,1
13797,17343,242,287,3,9,9,3,3,10,0,1,17,34,0,4,1,0,0,1,0,1,0,0,-3546,-45,-6,6,-7,0,-17,-4,1,27.8,64,-36.2,4,4,0,0
13459,13207,270,237,1,2,2,1,0,2,0,0,16,18,4,5,0,0,0,1,0,0,0,0,252,33,-1,1,-2,0,-2,-1,0,7.6,92.8,-85.2,3,4,-1,0
17254,15504,244,243,13,7,7,13,10,4,0,0,112,17,1,1,0,1,0,1,0,0,0,0,1750,1,6,-6,6,0,95,0,-1,27.4,32,-4.6,4,3,1,1
16786,14681,271,253,8,4,4,8,5,3,0,0,21,17,1,2,3,1,1,0,0,0,0,0,2105,18,4,-4,2,0,4,-1,2,98.2,11.6,86.6,5,3,2,0
15287,15763,242,274,6,6,6,6,9,6,0,0,12,18,0,3,0,1,0,1,0,0,0,0,-476,-32,0,0,3,0,-6,-3,-1,30.4,45,-14.6,3,5,-2,0
14248,14713,264,282,2,3,3,2,4,4,0,0,14,13,1,3,0,1,0,1,0,0,0,0,-465,-18,-1,1,0,0,1,-2,-1,11.4,81.2,-69.8,3,5,-2,0
15359,15674,267,280,5,5,5,5,7,6,0,1,25,16,1,3,2,2,0,1,0,1,0,0,-315,-13,0,0,1,0,9,-2,0,30.4,11.2,19.2,4,3,1,1
13788,16010,270,286,1,5,5,1,2,5,0,0,17,19,1,5,2,1,0,1,0,0,0,0,-2222,-16,-4,4,-3,0,-2,-4,1,10.6,109,-98.4,4,4,0,0
14460,18591,229,272,4,13,13,4,6,16,0,0,88,20,0,2,0,1,0,1,0,0,0,0,-4131,-43,-9,9,-10,0,68,-2,-1,33.8,19.4,14.4,3,4,-1,0
12430,16160,251,273,0,7,7,0,0,9,0,0,16,20,6,2,0,1,0,1,0,0,0,0,-3730,-22,-7,7,-9,0,-4,4,-1,34.4,35.8,-1.4,4,4,0,0
15865,15164,262,243,8,6,6,8,9,5,1,0,86,19,2,1,1,0,1,0,1,0,0,0,701,19,2,-2,4,0,67,1,1,36.4,36.8,-0.4,3,4,-1,0
16513,16148,248,257,9,8,8,9,9,5,1,0,14,13,2,0,2,2,1,0,1,0,0,0,365,-9,1,-1,4,0,1,2,0,41.6,10.2,31.4,4,2,2,1
16152,16141,273,262,7,6,7,7,7,9,0,0,14,19,6,3,0,1,1,0,0,0,0,0,11,11,1,0,-2,0,-5,3,-1,78.4,44.4,34,4,5,-1,1
14447,14364,263,264,4,4,4,4,3,4,0,1,17,16,1,5,0,0,0,1,0,1,0,0,83,-1,0,0,-1,0,1,-4,0,18.8,5.8,13,5,1,4,1
13567,13513,243,280,3,1,1,3,2,0,0,1,15,21,4,2,0,0,0,1,0,1,0,0,54,-37,2,-2,2,0,-6,2,0,29.6,63.4,-33.8,4,5,-1,0
15318,15293,262,241,5,7,7,5,4,11,0,0,17,33,3,5,1,0,1,0,0,0,0,0,25,21,-2,2,-7,0,-16,-2,1,92.6,32.8,59.8,4,5,-1,1
18733,16041,273,257,14,7,7,14,14,14,0,1,14,17,4,2,0,0,1,0,0,1,0,0,2692,16,7,-7,0,0,-3,2,0,44.6,16.2,28.4,4,2,2,1
13948,15107,276,283,2,4,4,2,1,5,0,0,35,15,1,5,1,0,1,0,0,0,0,0,-1159,-7,-2,2,-4,0,20,-4,1,10.4,11,-0.6,2,4,-2,0
15474,16447,239,226,7,9,9,7,4,10,0,0,14,16,5,5,0,1,1,0,0,0,0,0,-973,13,-2,2,-6,0,-2,0,-1,16.2,53,-36.8,2,3,-1,1
16226,13425,252,257,8,2,2,8,8,2,0,0,18,15,3,2,1,0,1,0,0,0,0,0,2801,-5,6,-6,6,0,3,1,1,162,22,140,5,5,0,1
14294,15689,259,263,3,7,7,3,2,6,0,0,16,17,2,3,1,0,0,1,0,0,0,0,-1395,-4,-4,4,-4,0,-1,-1,1,15.8,14.4,1.4,3,3,0,0
13626,15035,238,279,3,3,3,3,3,4,0,0,39,51,0,1,0,1,0,1,0,0,0,0,-1409,-41,0,0,-1,0,-12,-1,-1,33.2,17.6,15.6,4,4,0,0
15798,17192,260,254,6,10,10,6,6,11,0,0,14,19,4,1,1,1,0,1,0,0,0,0,-1394,6,-4,4,-5,0,-5,3,0,15.2,97,-81.8,2,4,-2,1
16604,14191,238,237,10,5,5,10,13,4,0,1,17,15,3,2,1,0,1,0,0,1,0,0,2413,1,5,-5,9,0,2,1,1,24.8,8.8,16,3,3,0,0
14139,16559,254,284,4,8,8,4,2,6,0,0,17,16,3,3,0,1,0,1,0,0,0,0,-2420,-30,-4,4,-4,0,1,0,-1,29.4,68.4,-39,3,4,-1,0
15150,13793,303,282,4,2,2,4,3,1,0,1,16,19,2,3,0,0,1,0,0,1,0,0,1357,21,2,-2,2,0,-3,-1,0,11.4,20.8,-9.4,3,3,0,1
14857,13549,236,243,5,3,3,5,4,4,0,0,15,14,4,6,1,0,0,1,0,0,0,0,1308,-7,2,-2,0,0,1,-2,1,36,18.4,17.6,5,3,2,1
16340,14743,285,248,7,5,5,7,10,7,1,0,21,15,3,3,0,0,0,1,1,0,0,0,1597,37,2,-2,3,0,6,0,0,9,69.8,-60.8,2,4,-2,1
14676,16184,280,284,3,5,6,3,7,8,0,0,18,39,2,6,0,0,0,1,0,0,0,0,-1508,-4,-2,3,-1,0,-21,-4,0,72.6,38,34.6,5,3,2,1
14579,16117,249,247,5,8,8,5,3,11,1,0,21,34,3,5,1,0,0,1,1,0,0,0,-1538,2,-3,3,-8,0,-13,-2,1,44.6,14.2,30.4,3,3,0,1
15177,18076,259,296,5,11,11,5,6,9,0,0,11,14,2,2,1,2,0,1,0,0,0,0,-2899,-37,-6,6,-3,0,-3,0,-1,7.6,61.4,-53.8,2,4,-2,0
14473,13576,267,267,4,1,1,4,5,4,0,1,12,24,4,2,0,1,0,1,0,1,0,0,897,0,3,-3,1,0,-12,2,-1,49.4,46.6,2.8,3,4,-1,0
19186,13213,284,226,12,2,2,12,13,1,0,0,112,33,2,3,4,0,1,0,0,0,0,0,5973,58,10,-10,12,0,79,-1,4,48.4,47,1.4,3,3,0,1
16386,16052,248,268,10,7,7,10,7,6,0,1,16,18,4,3,0,2,1,0,0,1,0,0,334,-20,3,-3,1,0,-2,1,-2,13.6,12.2,1.4,3,5,-2,0
14206,13975,240,252,4,2,2,4,2,4,0,0,28,16,3,2,0,2,1,0,0,0,0,0,231,-12,2,-2,-2,0,12,1,-2,33.4,10.8,22.6,3,5,-2,1
16355,13530,270,273,7,2,2,7,8,0,0,1,33,14,1,2,1,0,1,0,0,1,0,0,2825,-3,5,-5,8,0,19,-1,1,76.2,18.8,57.4,4,5,-1,1
14075,14572,261,262,3,4,4,3,2,3,0,0,14,14,4,1,0,0,0,1,0,0,0,0,-497,-1,-1,1,-1,0,0,3,0,55.6,78,-22.4,5,5,0,1
15010,18031,276,283,4,9,9,4,3,16,0,0,15,18,4,5,1,2,1,0,0,0,0,0,-3021,-7,-5,5,-13,0,-3,-1,-1,82.8,17.4,65.4,5,3,2,0
16199,17047,276,270,6,9,9,6,10,9,0,0,19,18,5,3,0,0,1,0,0,0,0,0,-848,6,-3,3,1,0,1,2,0,8.2,32.2,-24,4,4,0,0
15631,14180,251,259,6,3,3,6,11,3,0,0,22,17,4,5,1,1,1,0,0,0,0,0,1451,-8,3,-3,8,0,5,-1,0,41.2,20.4,20.8,2,4,-2,0
16135,14783,316,268,5,4,4,5,3,5,0,0,103,15,3,1,2,1,1,0,0,0,0,0,1352,48,1,-1,-2,0,88,2,1,18.8,28.4,-9.6,4,4,0,1
15355,16713,237,255,5,10,10,5,11,9,0,1,20,36,1,5,1,2,0,1,0,1,0,0,-1358,-18,-5,5,2,0,-16,-4,-1,26.8,37.6,-10.8,5,3,2,1
15275,15848,277,282,5,6,6,5,3,11,0,0,40,19,5,4,0,0,1,0,0,0,0,0,-573,-5,-1,1,-8,0,21,1,0,11,14.4,-3.4,3,3,0,1
14759,14733,270,300,4,3,4,4,4,4,0,0,14,16,2,3,0,0,0,1,0,0,0,0,26,-30,1,0,0,0,-2,-1,0,21.8,26.8,-5,4,4,0,1
14476,15211,256,267,4,6,6,4,3,6,0,1,14,14,2,4,0,0,1,0,0,1,0,0,-735,-11,-2,2,-3,0,0,-2,0,63.6,24.2,39.4,3,3,0,0
14647,13689,282,273,3,1,1,3,2,0,0,0,14,18,4,4,0,1,1,0,0,0,0,0,958,9,2,-2,2,0,-4,0,-1,15.6,14.6,1,3,3,0,1
17242,16236,267,241,10,8,8,10,7,7,0,0,15,19,2,1,3,0,1,0,0,0,0,0,1006,26,2,-2,0,0,-4,1,3,14,22.8,-8.8,5,5,0,1
14347,13709,298,283,2,1,1,2,1,2,0,1,15,111,4,1,1,1,0,1,0,1,0,0,638,15,1,-1,-1,0,-96,3,0,26,24.2,1.8,4,4,0,1
15453,12954,262,273,6,0,0,6,8,0,1,0,16,23,2,5,0,0,1,0,1,0,0,0,2499,-11,6,-6,8,0,-7,-3,0,25.2,48.8,-23.6,5,4,1,1
13108,17986,254,273,1,13,13,1,0,17,0,1,15,23,4,3,0,0,1,0,0,1,0,0,-4878,-19,-12,12,-17,0,-8,1,0,18.2,19.4,-1.2,5,5,0,0
16664,14971,255,236,10,6,7,10,13,9,0,0,17,15,3,4,0,0,0,1,0,0,0,0,1693,19,4,-3,4,0,2,-1,0,23.6,51.8,-28.2,3,3,0,1
14023,15437,271,283,2,5,5,2,0,4,0,1,15,20,3,4,1,1,1,0,0,1,0,0,-1414,-12,-3,3,-4,0,-5,-1,0,16.8,8.6,8.2,5,3,2,1
15947,14876,287,260,6,4,4,7,5,5,1,0,13,26,5,2,1,1,1,0,1,0,0,0,1071,27,2,-3,0,0,-13,3,0,68.6,63.8,4.8,5,3,2,0
16607,15142,264,264,9,4,4,9,9,2,0,1,16,33,10,3,0,1,1,0,0,1,0,0,1465,0,5,-5,7,0,-17,7,-1,22.8,50.4,-27.6,3,4,-1,1
16481,15328,256,252,8,7,7,8,8,8,0,0,19,14,2,3,0,0,1,0,0,0,0,0,1153,4,1,-1,0,0,5,-1,0,13.8,43.6,-29.8,3,4,-1,1
14320,15756,298,280,2,6,6,2,1,7,1,0,18,16,2,7,0,2,0,1,1,0,0,0,-1436,18,-4,4,-6,0,2,-5,-2,22.6,33.4,-10.8,4,5,-1,1
14986,14822,280,287,4,3,3,4,4,2,0,0,20,15,4,6,1,0,1,0,0,0,0,0,164,-7,1,-1,2,0,5,-2,1,12.4,14,-1.6,4,4,0,1
14442,13145,293,280,3,0,0,3,1,0,0,1,21,16,1,4,0,0,1,0,0,1,0,0,1297,13,3,-3,1,0,5,-3,0,25.6,36.2,-10.6,4,3,1,1
14739,14176,240,257,6,4,4,6,3,3,0,0,12,13,2,0,0,0,0,1,0,0,0,0,563,-17,2,-2,0,0,-1,2,0,22.4,23.2,-0.8,3,3,0,1
16932,14655,289,240,8,5,5,8,5,7,0,1,37,16,3,2,1,2,0,1,0,1,0,0,2277,49,3,-3,-2,0,21,1,-1,17.8,10,7.8,2,3,-1,1
16894,15768,240,270,9,4,4,9,15,4,0,0,116,18,2,2,0,1,1,0,0,0,0,0,1126,-30,5,-5,11,0,98,0,-1,17,19.6,-2.6,3,5,-2,1
14613,14646,263,248,4,5,5,4,5,7,0,0,15,14,1,5,0,0,0,1,0,0,0,0,-33,15,-1,1,-2,0,1,-4,0,13.4,15,-1.6,5,4,1,0
15475,16466,254,282,6,6,6,6,7,7,0,1,16,34,2,3,1,1,1,0,0,1,0,0,-991,-28,0,0,0,0,-18,-1,0,57.8,54.6,3.2,5,5,0,0
16344,14157,284,286,7,2,2,7,7,2,0,1,15,14,4,5,0,0,1,0,0,1,0,0,2187,-2,5,-5,5,0,1,-1,0,40,21.4,18.6,4,4,0,1
15395,15166,265,278,5,4,4,5,6,3,0,1,15,35,1,1,1,1,0,1,0,1,0,0,229,-13,1,-1,3,0,-20,0,0,56.6,55.4,1.2,3,5,-2,0
16013,13959,285,273,7,2,2,7,13,0,0,0,20,19,6,2,0,0,0,1,0,0,0,0,2054,12,5,-5,13,0,1,4,0,8.8,37.6,-28.8,2,5,-3,0
15942,14650,276,241,6,4,4,6,3,3,0,0,133,33,5,4,2,1,1,0,0,0,0,0,1292,35,2,-2,0,0,100,1,1,39.8,44.2,-4.4,5,5,0,1
17462,12944,285,259,9,1,1,9,15,0,0,1,17,25,8,1,0,0,1,0,0,1,0,0,4518,26,8,-8,15,0,-8,7,0,15.8,60.4,-44.6,5,5,0,1
15473,14032,294,290,4,1,1,4,3,2,0,0,18,34,0,2,0,1,1,0,0,0,0,0,1441,4,3,-3,1,0,-16,-2,-1,31.6,33.4,-1.8,4,4,0,1
15542,15450,293,296,4,5,5,4,2,6,0,1,15,20,6,3,2,0,1,0,0,1,0,0,92,-3,-1,1,-4,0,-5,3,2,29.4,87,-57.6,3,5,-2,0
16403,14146,266,262,9,2,2,9,15,3,1,0,42,16,2,4,0,1,1,0,1,0,0,0,2257,4,7,-7,12,0,26,-2,-1,38,22.8,15.2,4,4,0,1
13812,16382,251,293,2,7,7,2,5,10,0,1,18,20,4,5,0,1,0,1,0,1,0,0,-2570,-42,-5,5,-5,0,-2,-1,-1,16.2,23.2,-7,4,3,1,1
13972,14326,262,251,2,5,5,3,1,3,0,1,16,31,5,2,1,0,0,1,0,1,0,0,-354,11,-3,2,-2,0,-15,3,1,8.2,49,-40.8,1,4,-3,1
17287,15076,257,249,10,5,5,10,22,9,1,0,16,16,5,2,0,1,0,1,1,0,0,0,2211,8,5,-5,13,0,0,3,-1,33.8,8.8,25,4,3,1,1
14209,15820,260,288,4,6,6,4,3,5,0,1,14,18,2,4,1,2,0,1,0,1,0,0,-1611,-28,-2,2,-2,0,-4,-2,-1,20.6,23,-2.4,4,4,0,0
14501,14156,256,281,4,2,2,4,5,2,0,0,15,15,3,3,0,1,1,0,0,0,0,0,345,-25,2,-2,3,0,0,0,-1,19,25.2,-6.2,4,4,0,0
15297,15354,242,273,6,4,4,6,7,8,0,0,106,19,5,3,1,2,0,1,0,0,0,0,-57,-31,2,-2,-1,0,87,2,-1,12.2,12.4,-0.2,3,3,0,1
16065,15398,279,281,7,5,5,7,8,4,1,0,106,48,4,3,0,0,1,0,1,0,0,0,667,-2,2,-2,4,0,58,1,0,123,18,105,4,4,0,1
13769,13136,243,252,3,1,1,3,2,2,0,0,15,15,4,2,0,0,1,0,0,0,0,0,633,-9,2,-2,0,0,0,2,0,7.2,15.4,-8.2,2,5,-3,1
15554,13329,285,225,5,2,2,5,7,4,1,0,19,16,5,2,0,0,0,1,1,0,0,0,2225,60,3,-3,3,0,3,3,0,29.2,37.2,-8,4,4,0,1
17121,14631,254,279,9,2,2,9,11,2,0,1,15,17,5,1,0,1,1,0,0,1,0,0,2490,-25,7,-7,9,0,-2,4,-1,64.4,32.8,31.6,5,4,1,1
17891,13787,275,263,12,2,2,12,13,2,0,0,15,19,3,3,0,1,1,0,0,0,0,0,4104,12,10,-10,11,0,-4,0,-1,16.8,43.4,-26.6,3,5,-2,1
14313,16041,290,259,2,7,7,2,2,9,0,0,17,37,4,3,0,0,0,1,0,0,0,0,-1728,31,-5,5,-7,0,-20,1,0,37.4,15.2,22.2,5,3,2,0
13810,17886,245,261,4,12,12,4,2,8,1,0,15,136,5,1,0,0,1,0,1,0,0,0,-4076,-16,-8,8,-6,0,-121,4,0,11.2,36.6,-25.4,5,4,1,0
15296,14993,290,277,5,5,5,5,3,8,0,1,16,35,2,4,0,0,0,1,0,1,0,0,303,13,0,0,-5,0,-19,-2,0,10.8,11.4,-0.6,3,5,-2,0
13652,16170,294,295,1,5,5,1,0,7,0,0,367,14,2,2,1,1,0,1,0,0,0,0,-2518,-1,-4,4,-7,0,353,0,0,29.4,24.8,4.6,3,5,-2,0
16601,14568,257,264,9,3,3,9,9,4,0,0,19,17,6,4,0,0,1,0,0,0,0,0,2033,-7,6,-6,5,0,2,2,0,24.6,65,-40.4,4,4,0,1
16755,15474,268,258,7,7,7,7,9,8,0,1,22,17,2,3,4,0,0,1,0,1,0,0,1281,10,0,0,1,0,5,-1,4,29.4,60.2,-30.8,5,5,0,1
13945,15211,256,244,3,8,8,3,3,9,0,1,14,18,2,2,0,0,0,1,0,1,0,0,-1266,12,-5,5,-6,0,-4,0,0,25.4,49.2,-23.8,4,3,1,0
15358,16562,263,247,5,9,9,5,6,10,0,0,16,17,3,3,1,1,1,0,0,0,0,0,-1204,16,-4,4,-4,0,-1,0,0,15.8,23,-7.2,3,3,0,1
15075,14671,256,245,6,5,5,6,4,5,0,0,76,18,4,2,0,0,0,1,0,0,0,0,404,11,1,-1,-1,0,58,2,0,85.4,60.2,25.2,4,4,0,1
16540,13192,276,280,7,0,0,7,10,0,0,1,86,11,5,1,2,1,1,0,0,1,0,0,3348,-4,7,-7,10,0,75,4,1,52.2,28.8,23.4,4,4,0,1
15967,17045,224,248,8,10,10,8,7,10,0,0,16,35,1,4,0,0,0,1,0,0,0,0,-1078,-24,-2,2,-3,0,-19,-3,0,105,37.8,67.2,5,3,2,0
14298,14684,269,277,2,5,5,2,2,2,0,1,15,216,3,4,0,2,0,1,0,1,0,0,-386,-8,-3,3,0,0,-201,-1,-2,42.6,25,17.6,3,3,0,0
13471,16769,225,287,3,8,8,3,5,10,1,0,15,15,1,3,0,3,1,0,1,0,0,0,-3298,-62,-5,5,-5,0,0,-2,-3,7.2,53.8,-46.6,3,4,-1,0
12557,16436,227,248,1,8,8,1,1,11,0,0,11,36,3,5,0,0,1,0,0,0,0,0,-3879,-21,-7,7,-10,0,-25,-2,0,34,11.6,22.4,3,3,0,0
14702,13415,266,256,5,2,2,5,5,5,0,1,15,11,1,2,0,0,1,0,0,1,0,0,1287,10,3,-3,0,0,4,-1,0,25,45.8,-20.8,5,5,0,0
17518,13458,249,276,10,1,2,10,19,0,0,1,15,15,3,3,1,0,1,0,0,1,0,0,4060,-27,9,-8,19,0,0,0,1,14.6,35,-20.4,3,4,-1,0
15777,16456,252,275,7,9,9,7,8,5,0,0,16,89,2,3,0,0,0,1,0,0,0,0,-679,-23,-2,2,3,0,-73,-1,0,28.4,105.8,-77.4,3,4,-1,1
15309,14985,298,271,4,5,5,4,3,5,0,1,16,13,2,5,0,0,1,0,0,1,0,0,324,27,-1,1,-2,0,3,-3,0,32.8,27,5.8,3,2,1,0
17153,15963,208,211,12,9,9,12,11,7,0,0,46,195,2,2,1,1,1,0,0,0,0,0,1190,-3,3,-3,4,0,-149,0,0,74.6,40.2,34.4,5,3,2,0
13778,13762,259,234,2,4,4,2,2,2,0,0,20,22,3,3,0,0,0,1,0,0,0,0,16,25,-2,2,0,0,-2,0,0,34.6,13.6,21,3,4,-1,1
13500,16798,222,247,2,10,10,2,2,13,0,0,14,24,1,4,2,1,0,1,0,0,0,0,-3298,-25,-8,8,-11,0,-10,-3,1,5.6,50.8,-45.2,1,4,-3,0
13966,16144,268,236,3,9,9,3,4,6,0,0,15,29,1,5,0,1,1,0,0,0,0,0,-2178,32,-6,6,-2,0,-14,-4,-1,75,12.8,62.2,5,3,2,0
14632,15689,295,287,2,4,4,2,3,8,0,1,17,32,0,3,2,1,0,1,0,1,0,0,-1057,8,-2,2,-5,0,-15,-3,1,113.8,34.2,79.6,5,4,1,0
15716,17233,228,270,8,8,8,8,14,9,0,1,12,14,2,0,1,2,1,0,0,1,0,1,-1517,-42,0,0,5,0,-2,2,-1,47.4,37.2,10.2,5,3,2,0
11995,17211,209,261,1,12,12,1,1,12,0,1,18,25,4,2,0,0,0,1,0,1,0,0,-5216,-52,-11,11,-11,0,-7,2,0,6.6,7.8,-1.2,1,2,-1,0
17459,16263,250,261,10,6,6,10,18,13,1,0,16,16,1,4,2,0,1,0,1,0,0,0,1196,-11,4,-4,5,0,0,-3,2,46.2,95.2,-49,4,2,2,1
16001,16387,266,256,7,9,9,7,9,8,0,0,16,104,1,2,0,0,0,1,0,0,0,0,-386,10,-2,2,1,0,-88,-1,0,41.2,11.4,29.8,4,3,1,0
15461,14050,252,252,6,2,2,6,8,3,0,0,15,15,2,4,1,0,0,1,0,0,0,0,1411,0,4,-4,5,0,0,-2,1,55.2,62.4,-7.2,4,3,1,0
14240,17539,240,258,4,12,12,4,3,14,0,1,121,17,1,5,0,1,0,1,0,1,0,0,-3299,-18,-8,8,-11,0,104,-4,-1,59,8.6,50.4,4,2,2,0
14965,13688,275,251,4,2,2,4,3,2,0,0,16,15,5,5,0,1,0,1,0,0,0,0,1277,24,2,-2,1,0,1,0,-1,118,24.2,93.8,3,4,-1,0
15169,14644,262,236,5,5,5,5,6,11,0,0,62,22,1,1,0,1,0,1,0,0,0,0,525,26,0,0,-5,0,40,0,-1,12,106.8,-94.8,4,4,0,1
14097,16633,254,277,3,8,8,3,4,9,0,0,24,163,0,3,0,1,0,1,0,0,0,0,-2536,-23,-5,5,-5,0,-139,-3,-1,18.4,46.8,-28.4,3,2,1,0
14709,15020,277,256,4,6,6,4,3,9,0,1,16,25,4,4,0,0,0,1,0,1,0,0,-311,21,-2,2,-6,0,-9,0,0,30.8,27.8,3,4,3,1,1
14342,13416,295,248,2,2,2,2,2,4,0,1,27,27,2,3,0,0,1,0,0,1,0,0,926,47,0,0,-2,0,0,-1,0,88.8,61.4,27.4,4,3,1,0
16534,13748,241,249,9,3,3,9,13,4,1,0,19,11,1,3,0,0,0,1,1,0,0,0,2786,-8,6,-6,9,0,8,-2,0,57.8,36.4,21.4,5,3,2,1
15576,14828,292,257,5,4,4,5,2,7,0,1,15,17,6,2,1,0,1,0,0,1,0,0,748,35,1,-1,-5,0,-2,4,1,11.6,56.2,-44.6,3,5,-2,0
16603,15149,233,249,9,6,6,9,12,7,1,0,25,35,1,1,1,0,0,1,1,0,0,0,1454,-16,3,-3,5,0,-10,0,1,46.8,15.8,31,3,3,0,1
13369,16714,273,275,1,10,10,1,1,13,0,1,28,23,1,3,0,1,0,1,0,1,0,0,-3345,-2,-9,9,-12,0,5,-2,-1,31.4,75.4,-44,3,5,-2,0
13637,16209,242,244,2,9,9,2,2,9,0,0,13,126,2,3,0,0,0,1,0,0,0,0,-2572,-2,-7,7,-7,0,-113,-1,0,39.6,34,5.6,5,5,0,0
17187,15487,248,284,11,5,5,11,22,8,1,0,19,18,3,4,1,2,0,1,1,0,0,0,1700,-36,6,-6,14,0,1,-1,-1,35.6,18.4,17.2,4,4,0,1
14272,15518,241,237,4,7,8,4,3,10,0,0,22,13,2,2,0,0,0,1,0,0,0,0,-1246,4,-3,4,-7,0,9,0,0,68.2,31.6,36.6,3,4,-1,0
15333,14483,278,271,5,3,3,5,5,2,0,0,16,16,1,5,1,0,1,0,0,0,0,0,850,7,2,-2,3,0,0,-4,1,7.8,43,-35.2,3,4,-1,1
15014,14578,303,271,4,3,3,4,2,4,0,1,11,17,6,2,0,0,1,0,0,1,0,0,436,32,1,-1,-2,0,-6,4,0,32.2,35.2,-3,4,4,0,1
15797,15558,261,260,6,7,7,6,7,5,0,1,12,14,2,1,0,0,0,1,0,1,0,0,239,1,-1,1,2,0,-2,1,0,14.4,39.8,-25.4,4,3,1,1
15241,17078,255,284,7,8,8,7,4,9,1,0,20,17,1,7,0,1,0,1,1,0,0,0,-1837,-29,-1,1,-5,0,3,-6,-1,32,47.8,-15.8,2,4,-2,0
13786,13446,283,252,1,1,1,1,0,1,0,0,16,202,1,2,1,0,1,0,0,0,0,0,340,31,0,0,-1,0,-186,-1,1,9.8,72.6,-62.8,3,5,-2,0
16053,14758,282,264,6,4,4,6,4,6,0,0,14,28,1,2,2,0,0,1,0,0,0,0,1295,18,2,-2,-2,0,-14,-1,2,28,14.6,13.4,5,4,1,1
18222,14627,280,252,12,4,4,12,12,9,0,1,14,10,4,0,3,0,1,0,0,1,0,0,3595,28,8,-8,3,0,4,4,3,40.2,33.8,6.4,4,4,0,1
16637,14778,260,252,10,4,5,10,14,4,0,0,15,18,2,3,2,2,1,0,0,0,0,0,1859,8,6,-5,10,0,-3,-1,0,9.8,62.2,-52.4,3,5,-2,1
17129,17622,260,240,9,11,11,9,5,13,0,0,15,17,2,3,2,1,1,0,0,0,0,0,-493,20,-2,2,-8,0,-2,-1,1,29.4,34.4,-5,2,3,-1,0
16500,14217,271,266,7,3,3,7,8,3,0,0,13,107,3,1,0,0,1,0,0,0,0,0,2283,5,4,-4,5,0,-94,2,0,18.8,78.2,-59.4,4,4,0,1
16196,15517,260,248,8,5,5,9,14,4,0,0,17,15,2,4,0,0,1,0,0,0,0,0,679,12,3,-4,10,0,2,-2,0,32.4,37.6,-5.2,4,4,0,1
16374,16074,255,256,8,8,8,8,5,8,0,1,16,30,2,3,2,0,1,0,0,1,0,0,300,-1,0,0,-3,0,-14,-1,2,59.6,19.6,40,5,4,1,0
14642,13935,316,308,1,0,0,1,2,0,0,1,15,12,2,5,0,0,1,0,0,1,0,0,707,8,1,-1,2,0,3,-3,0,26.4,44.8,-18.4,4,5,-1,0
14324,13169,270,246,4,1,1,4,3,1,0,0,17,18,1,1,1,1,1,0,0,0,0,0,1155,24,3,-3,2,0,-1,0,0,37.4,12.6,24.8,4,4,0,1
17112,17576,237,266,11,10,10,11,11,15,0,0,13,15,3,3,0,2,1,0,0,0,0,0,-464,-29,1,-1,-4,0,-2,0,-2,31.6,49.2,-17.6,3,4,-1,0
14699,16020,256,267,4,7,7,4,4,13,0,0,16,56,5,4,0,1,0,1,0,0,0,0,-1321,-11,-3,3,-9,0,-40,1,-1,27.4,11.6,15.8,3,3,0,0
15205,13416,286,252,4,2,2,4,1,3,0,1,9,18,3,4,0,0,1,0,0,1,0,0,1789,34,2,-2,-2,0,-9,-1,0,12.8,37.2,-24.4,2,4,-2,1
16193,14156,277,260,6,3,3,6,9,2,1,0,30,19,3,3,1,1,0,1,1,0,0,0,2037,17,3,-3,7,0,11,0,0,26.8,44.6,-17.8,5,4,1,1
16856,14000,266,244,10,3,3,10,9,1,0,0,16,31,5,6,2,0,1,0,0,0,0,0,2856,22,7,-7,8,0,-15,-1,2,159.2,56.8,102.4,5,3,2,1
16524,14579,278,261,9,5,5,9,6,4,0,0,17,17,0,5,0,0,0,1,0,0,0,0,1945,17,4,-4,2,0,0,-5,0,16.8,14.6,2.2,5,5,0,1
15826,14421,289,303,5,2,2,5,6,1,1,0,62,18,2,4,0,1,1,0,1,0,0,0,1405,-14,3,-3,5,0,44,-2,-1,68.8,24.2,44.6,5,3,2,1
14446,15191,256,261,4,6,6,4,4,4,0,0,16,18,5,4,0,1,0,1,0,0,0,0,-745,-5,-2,2,0,0,-2,1,-1,31.4,60.8,-29.4,4,5,-1,1
15449,14269,280,276,5,2,2,5,7,3,0,0,15,19,2,1,0,0,1,0,0,0,0,0,1180,4,3,-3,4,0,-4,1,0,11.8,18,-6.2,1,3,-2,1
15038,13486,276,224,5,4,5,5,2,1,0,1,17,16,4,5,1,0,0,1,0,1,0,0,1552,52,1,0,1,0,1,-1,1,95,22.6,72.4,5,2,3,1
16549,15485,243,229,9,7,7,9,12,7,0,0,38,32,2,4,0,0,0,1,0,0,0,0,1064,14,2,-2,5,0,6,-2,0,31.6,26.4,5.2,3,4,-1,0
15798,15406,249,281,6,5,5,6,6,3,0,0,35,33,3,4,1,2,0,1,0,0,0,0,392,-32,1,-1,3,0,2,-1,-1,84.6,44.6,40,5,3,2,0
16132,13847,263,195,8,5,5,8,12,5,0,1,19,14,2,3,0,0,0,1,0,1,0,0,2285,68,3,-3,7,0,5,-1,0,7.8,23,-15.2,3,3,0,1
15586,15711,278,284,5,5,5,5,5,6,0,0,18,18,4,6,1,1,0,1,0,0,0,0,-125,-6,0,0,-1,0,0,-2,0,64,14.4,49.6,4,2,2,0
17048,14459,278,245,8,4,5,8,11,6,0,1,17,30,4,2,3,0,1,0,0,1,0,0,2589,33,4,-3,5,0,-13,2,3,60,14.6,45.4,4,3,1,1
16280,14741,285,254,6,4,4,6,11,6,0,1,19,14,4,4,1,1,1,0,0,1,0,0,1539,31,2,-2,5,0,5,0,0,41.6,14,27.6,5,4,1,1
15120,14934,243,294,6,3,3,6,9,2,1,0,15,14,2,6,0,0,1,0,1,0,0,0,186,-51,3,-3,7,0,1,-4,0,27.2,73,-45.8,4,4,0,1
15512,13176,278,254,5,1,1,5,6,1,0,1,31,20,2,1,0,0,1,0,0,1,0,0,2336,24,4,-4,5,0,11,1,0,18.6,84.2,-65.6,3,4,-1,1
14270,14286,303,287,2,2,2,2,1,2,0,1,17,17,1,3,0,0,1,0,0,1,0,0,-16,16,0,0,-1,0,0,-2,0,14,30.2,-16.2,4,5,-1,1
12473,18221,221,297,1,11,11,1,0,13,0,0,13,18,3,1,1,3,0,1,0,0,0,0,-5748,-76,-10,10,-13,0,-5,2,-2,32.2,20.8,11.4,4,5,-1,0
16636,15027,255,290,8,3,3,8,12,3,0,0,123,17,5,5,1,1,1,0,0,0,0,0,1609,-35,5,-5,9,0,106,0,0,79.4,39.4,40,4,5,-1,1
14194,14648,246,277,4,3,3,4,3,3,0,1,14,9,1,4,1,2,1,0,0,1,0,0,-454,-31,1,-1,0,0,5,-3,-1,36.6,35,1.6,3,4,-1,0
15845,16732,274,270,6,7,7,6,5,9,0,1,16,18,2,3,1,1,0,1,0,1,0,0,-887,4,-1,1,-4,0,-2,-1,0,36.6,29.8,6.8,3,4,-1,0
15315,17348,283,254,5,12,12,5,5,11,0,0,22,15,2,3,0,1,0,1,0,0,0,0,-2033,29,-7,7,-6,0,7,-1,-1,109.2,60,49.2,5,3,2,0
15175,14817,260,289,4,3,3,4,8,3,0,0,18,31,0,7,0,0,1,0,0,0,0,0,358,-29,1,-1,5,0,-13,-7,0,74.2,40.4,33.8,4,3,1,0
16221,14305,276,277,7,3,3,7,5,4,0,0,18,16,6,3,1,1,1,0,0,0,0,0,1916,-1,4,-4,1,0,2,3,0,29.6,8,21.6,3,1,2,1
16198,13924,271,273,6,2,2,6,6,1,0,0,17,16,3,2,0,1,0,1,0,0,0,0,2274,-2,4,-4,5,0,1,1,-1,12,10.4,1.6,3,2,1,1
15251,14392,259,255,5,3,3,5,7,3,0,1,41,18,2,4,0,1,0,1,0,1,0,0,859,4,2,-2,4,0,23,-2,-1,10.8,13.2,-2.4,4,3,1,1
14463,15051,286,269,3,5,5,3,4,3,0,0,36,15,5,2,0,0,1,0,0,0,0,0,-588,17,-2,2,1,0,21,3,0,6.4,33.2,-26.8,2,4,-2,0
13994,14864,288,301,2,3,3,2,2,2,1,0,17,15,1,4,0,1,1,0,1,0,0,0,-870,-13,-1,1,0,0,2,-3,-1,33.4,82,-48.6,4,5,-1,0
13615,14266,238,291,3,2,2,3,4,1,1,0,17,12,1,6,0,0,0,1,1,0,0,0,-651,-53,1,-1,3,0,5,-5,0,22.6,11,11.6,4,2,2,1
16648,14610,282,237,8,5,5,8,6,4,0,0,13,18,2,3,1,0,1,0,0,0,0,0,2038,45,3,-3,2,0,-5,-1,1,7.8,11.4,-3.6,3,2,1,1
15118,15541,248,261,5,6,6,5,5,8,0,0,28,19,4,2,1,0,0,1,0,0,0,0,-423,-13,-1,1,-3,0,9,2,1,34.8,62,-27.2,4,4,0,0
15812,13747,272,244,6,2,2,6,8,1,0,0,13,35,5,2,0,1,1,0,0,0,0,0,2065,28,4,-4,7,0,-22,3,-1,21.2,61.4,-40.2,3,4,-1,0
15647,14847,245,261,7,4,4,7,11,7,0,1,16,15,4,5,1,2,1,0,0,1,0,0,800,-16,3,-3,4,0,1,-1,-1,54.2,18.4,35.8,4,2,2,0
14477,15095,263,254,5,4,4,5,2,4,1,0,21,41,1,9,0,1,1,0,1,0,0,0,-618,9,1,-1,-2,0,-20,-8,-1,31.4,48.6,-17.2,3,4,-1,1
16911,14446,257,231,10,4,4,10,15,8,0,0,16,19,3,3,0,1,0,1,0,0,0,0,2465,26,6,-6,7,0,-3,0,-1,19,106.6,-87.6,3,4,-1,1
14151,14436,242,270,4,3,3,4,4,3,0,0,16,37,5,5,0,1,0,1,0,0,0,0,-285,-28,1,-1,1,0,-21,0,-1,65.4,5.4,60,3,2,1,0
14856,15583,223,278,5,7,7,5,8,3,0,1,31,180,2,5,1,1,1,0,0,1,0,0,-727,-55,-2,2,5,0,-149,-3,0,24,49.6,-25.6,4,5,-1,0
2551,2615,1,4,0,0,0,0,0,0,0,0,2,2,0,0,0,0,0,0,0,0,0,0,-64,-3,0,0,0,0,0,0,0,27.6,57.6,-30,5,4,1,1
13853,16812,229,260,4,10,10,4,6,16,0,0,16,16,3,6,0,1,0,1,0,0,0,0,-2959,-31,-6,6,-10,0,0,-3,-1,11,33.2,-22.2,2,3,-1,0
15475,15440,233,239,6,7,7,6,6,11,0,0,19,31,1,3,0,0,0,1,0,0,0,0,35,-6,-1,1,-5,0,-12,-2,0,32.6,20.6,12,3,3,0,1
2531,2552,0,1,0,0,0,0,0,0,0,0,1,1,0,0,0,0,0,0,0,0,0,0,-21,-1,0,0,0,0,0,0,0,64.2,9.8,54.4,5,3,2,0
12701,16416,238,280,1,7,7,1,0,10,0,0,187,18,3,6,0,1,1,0,0,0,0,0,-3715,-42,-6,6,-10,0,169,-3,-1,39.4,25.6,13.8,5,1,4,0
16170,16086,224,257,10,8,8,10,8,5,0,0,17,15,0,4,0,1,0,1,0,0,0,0,84,-33,2,-2,3,0,2,-4,-1,11.6,9.8,1.8,2,4,-2,1
16419,15634,196,201,13,9,9,13,18,12,1,0,21,19,3,4,0,1,1,0,1,0,0,0,785,-5,4,-4,6,0,2,-1,-1,15.6,23.8,-8.2,3,3,0,1
16091,13340,276,269,7,1,1,7,7,0,0,1,18,22,4,5,2,1,1,0,0,1,0,0,2751,7,6,-6,7,0,-4,-1,1,44.8,18.2,26.6,5,5,0,1
16374,15797,251,256,8,6,6,8,9,7,0,0,41,14,5,4,1,2,1,0,0,0,0,0,577,-5,2,-2,2,0,27,1,-1,47,35.6,11.4,3,4,-1,0
14877,14391,267,285,5,3,3,5,5,3,0,1,16,15,4,6,0,0,0,1,0,1,0,0,486,-18,2,-2,2,0,1,-2,0,20.6,16.6,4,4,3,1,0
16025,14957,269,272,6,5,5,6,13,3,1,0,13,29,7,4,0,0,0,1,1,0,0,0,1068,-3,1,-1,10,0,-16,3,0,41.2,46,-4.8,4,4,0,1
17171,16859,256,253,10,10,10,10,11,11,0,0,18,33,4,4,0,1,0,1,0,0,0,0,312,3,0,0,0,0,-15,0,-1,35.4,138.2,-102.8,4,4,0,0
17082,20495,218,260,11,17,17,11,14,25,0,1,16,26,0,6,0,0,0,1,0,1,0,0,-3413,-42,-6,6,-11,0,-10,-6,0,39.4,47,-7.6,3,4,-1,0
15621,14943,264,265,6,6,6,6,8,7,1,0,15,18,3,4,0,0,1,0,1,0,0,0,678,-1,0,0,1,0,-3,-1,0,24.6,7.6,17,5,3,2,1
12862,17122,243,278,1,9,9,1,1,9,0,1,18,20,1,4,0,3,0,1,0,1,0,0,-4260,-35,-8,8,-8,0,-2,-3,-3,24,57.6,-33.6,3,5,-2,0
13811,15136,237,276,3,4,4,3,4,4,0,0,19,14,2,4,0,2,0,1,0,0,0,0,-1325,-39,-1,1,0,0,5,-2,-2,12.4,48.2,-35.8,3,5,-2,0
14202,17380,261,266,3,12,12,3,3,16,0,0,15,20,3,4,0,0,1,0,0,0,0,0,-3178,-5,-9,9,-13,0,-5,-1,0,13.4,26,-12.6,4,4,0,0
16509,15786,256,246,8,7,7,8,14,6,1,0,19,20,4,3,0,0,0,1,1,0,0,0,723,10,1,-1,8,0,-1,1,0,80,46,34,4,3,1,0
16107,15200,276,248,7,7,7,7,7,7,1,0,26,36,4,1,0,0,0,1,1,0,0,0,907,28,0,0,0,0,-10,3,0,20.4,28.2,-7.8,2,3,-1,1
15626,14795,258,294,5,3,3,5,8,5,0,0,19,43,5,8,1,0,0,1,0,0,0,0,831,-36,2,-2,3,0,-24,-3,1,57,30.4,26.6,3,4,-1,1
15132,15997,258,273,6,7,7,6,6,8,0,0,18,17,6,5,0,0,1,0,0,0,0,0,-865,-15,-1,1,-2,0,1,1,0,15.2,15.2,0,4,5,-1,1
16552,19045,209,259,10,13,13,10,12,14,0,0,104,28,4,2,0,1,0,1,0,0,0,0,-2493,-50,-3,3,-2,0,76,2,-1,21.4,134.8,-113.4,4,5,-1,0
13899,16343,246,256,3,8,8,3,2,11,0,1,34,21,6,5,0,1,1,0,0,1,0,0,-2444,-10,-5,5,-9,0,13,1,-1,24.2,42,-17.8,3,3,0,0
17423,13463,256,222,11,4,4,11,14,1,0,0,18,13,2,4,0,0,1,0,0,0,0,0,3960,34,7,-7,13,0,5,-2,0,23.6,9.2,14.4,5,3,2,0
15258,15574,274,255,6,7,7,6,3,5,0,0,17,21,3,1,0,0,0,1,0,0,0,0,-316,19,-1,1,-2,0,-4,2,0,16.4,21.4,-5,3,4,-1,1
12293,15791,231,244,1,8,8,1,0,7,0,0,25,18,3,1,0,0,0,1,0,0,0,0,-3498,-13,-7,7,-7,0,7,2,0,33.4,51.6,-18.2,5,4,1,0
12913,15380,262,254,0,8,8,0,0,6,0,0,35,16,2,4,0,0,0,1,0,0,0,0,-2467,8,-8,8,-6,0,19,-2,0,29.6,28.6,1,5,4,1,0
14953,16578,278,270,5,8,8,5,4,10,0,0,16,11,2,5,1,0,1,0,0,0,0,0,-1625,8,-3,3,-6,0,5,-3,1,24.6,145.8,-121.2,3,5,-2,0
16127,14134,263,258,7,4,4,7,9,2,0,0,16,35,3,3,0,0,0,1,0,0,0,0,1993,5,3,-3,7,0,-19,0,0,23.4,35.8,-12.4,4,3,1,1
14554,15728,260,241,3,9,9,3,4,7,0,0,28,19,3,2,0,0,0,1,0,0,0,0,-1174,19,-6,6,-3,0,9,1,0,12.6,17.6,-5,4,4,0,0
15874,14267,285,240,7,3,3,7,2,5,0,0,38,16,4,3,1,1,1,0,0,0,0,0,1607,45,4,-4,-3,0,22,1,0,25.6,45.8,-20.2,3,4,-1,1
13382,15516,255,270,1,6,6,1,1,6,0,0,32,18,4,1,1,1,0,1,0,0,0,0,-2134,-15,-5,5,-5,0,14,3,0,20.4,18.4,2,3,3,0,0
17604,14327,286,267,8,4,4,8,13,3,0,1,35,24,7,4,2,0,1,0,0,1,0,0,3277,19,4,-4,10,0,11,3,2,17.2,28.6,-11.4,4,4,0,0
15374,15116,255,212,6,8,8,6,5,7,0,0,14,16,2,2,1,0,1,0,0,0,0,0,258,43,-2,2,-2,0,-2,0,1,146.2,8.8,137.4,4,3,1,0
13326,16306,248,252,2,9,9,2,2,8,0,1,102,108,4,4,0,0,0,1,0,1,0,0,-2980,-4,-7,7,-6,0,-6,0,0,21.6,26.4,-4.8,1,4,-3,0
14882,14125,301,282,3,1,1,3,3,2,0,1,16,45,7,4,2,0,1,0,0,1,0,0,757,19,2,-2,1,0,-29,3,2,23.8,39.6,-15.8,4,3,1,1
16609,15165,268,288,9,4,4,9,8,0,0,0,19,37,2,6,1,2,1,0,0,0,0,0,1444,-20,5,-5,8,0,-18,-4,-1,18.2,50.6,-32.4,3,5,-2,0
16897,15379,257,277,10,5,5,10,16,3,0,0,10,16,3,4,0,0,0,1,0,0,0,0,1518,-20,5,-5,13,0,-6,-1,0,29.8,12.2,17.6,5,2,3,0
13590,18078,251,297,3,12,12,3,1,12,0,0,23,14,5,2,0,1,0,1,0,0,0,0,-4488,-46,-9,9,-11,0,9,3,-1,24.6,89.6,-65,3,5,-2,0
13901,13594,284,278,1,1,1,1,2,1,0,0,17,16,5,3,0,0,1,0,0,0,0,0,307,6,0,0,1,0,1,2,0,102.2,44.8,57.4,4,5,-1,0
16643,14788,258,271,9,3,3,9,8,1,0,0,22,15,4,3,1,1,1,0,0,0,0,0,1855,-13,6,-6,7,0,7,1,0,14.6,10.4,4.2,4,1,3,1
15466,15270,237,234,8,7,7,8,7,9,0,0,12,13,3,4,0,0,1,0,0,0,0,0,196,3,1,-1,-2,0,-1,-1,0,35.4,138.4,-103,4,2,2,0
16854,14545,262,235,8,6,6,8,9,4,0,1,88,11,3,3,1,0,1,0,0,1,0,0,2309,27,2,-2,5,0,77,0,1,32.6,9.4,23.2,4,2,2,1
14905,15700,290,270,4,6,6,4,2,10,0,0,138,17,3,2,0,0,1,0,0,0,0,0,-795,20,-2,2,-8,0,121,1,0,55.8,94.8,-39,5,4,1,1
15916,16948,259,246,7,12,12,7,6,9,0,1,12,16,0,1,1,0,0,1,0,1,0,0,-1032,13,-5,5,-3,0,-4,-1,1,44.2,22.2,22,5,3,2,0
13730,14616,222,256,4,3,3,4,3,2,0,0,17,19,2,1,0,0,1,0,0,0,0,0,-886,-34,1,-1,1,0,-2,1,0,58.2,16.2,42,5,4,1,0
15358,16614,257,241,6,10,10,6,5,11,0,1,9,19,6,2,0,1,0,1,0,1,0,0,-1256,16,-4,4,-6,0,-10,4,-1,191.4,38.4,153,4,4,0,1
14115,15833,307,300,1,5,5,1,1,7,0,0,12,19,6,1,0,0,1,0,0,0,0,0,-1718,7,-4,4,-6,0,-7,5,0,11.2,31.6,-20.4,3,4,-1,0
16290,15987,226,240,10,6,6,10,20,10,0,1,13,25,3,2,1,1,1,0,0,1,0,0,303,-14,4,-4,10,0,-12,1,0,91,23,68,3,4,-1,1
17655,15233,228,261,12,4,4,12,16,4,0,0,15,15,3,6,2,1,1,0,0,0,0,0,2422,-33,8,-8,12,0,0,-3,1,15.8,11,4.8,4,3,1,1
13633,15455,258,264,2,6,6,2,3,7,0,0,13,14,4,3,2,0,0,1,0,0,0,0,-1822,-6,-4,4,-4,0,-1,1,2,136,27.8,108.2,5,4,1,0
15344,15362,236,270,6,5,5,6,7,7,0,0,21,17,2,2,1,0,1,0,0,0,0,0,-18,-34,1,-1,0,0,4,0,1,85,28.4,56.6,2,4,-2,0
13888,18068,236,276,3,11,11,3,3,14,0,0,13,21,1,1,0,1,1,0,0,0,0,0,-4180,-40,-8,8,-11,0,-8,0,-1,43.8,19.6,24.2,2,3,-1,0
14781,16286,272,263,5,9,9,5,7,14,1,0,39,13,1,7,0,0,0,1,1,0,0,0,-1505,9,-4,4,-7,0,26,-6,0,43.8,116.6,-72.8,3,5,-2,0
3000,3012,13,14,0,0,0,0,0,0,0,0,5,2,0,0,0,0,0,0,0,0,0,0,-12,-1,0,0,0,0,3,0,0,35.4,53.2,-17.8,2,4,-2,0
14919,14780,277,304,4,3,3,4,3,1,1,0,18,19,4,4,1,1,1,0,1,0,0,0,139,-27,1,-1,2,0,-1,0,0,21.8,46.2,-24.4,4,4,0,0
16537,15899,260,256,8,6,6,8,8,7,0,0,110,16,4,1,0,0,1,0,0,0,0,0,638,4,2,-2,1,0,94,3,0,102.2,95.2,7,4,4,0,0
13720,13480,275,273,1,1,1,1,1,2,1,0,16,44,19,4,1,2,0,1,1,0,0,0,240,2,0,0,-1,0,-28,15,-1,46.2,149.8,-103.6,3,5,-2,0
14211,18765,211,276,5,12,12,5,6,11,0,1,32,26,3,3,0,3,0,1,0,1,0,0,-4554,-65,-7,7,-5,0,6,0,-3,27,44.2,-17.2,3,4,-1,0
15441,15110,270,265,5,5,5,5,7,5,0,0,17,27,4,5,1,0,0,1,0,0,0,0,331,5,0,0,2,0,-10,-1,1,38.4,107.2,-68.8,5,5,0,1
16626,15255,250,239,10,8,8,10,24,9,0,0,26,13,2,5,0,0,0,1,0,0,0,0,1371,11,2,-2,15,0,13,-3,0,9.6,15.2,-5.6,4,4,0,1
15492,14741,247,216,7,6,7,7,7,6,0,0,18,15,2,2,1,1,1,0,0,0,0,0,751,31,1,0,1,0,3,0,0,38.8,18,20.8,5,4,1,0
16255,16044,276,278,7,6,6,7,7,5,0,1,13,17,4,1,0,2,1,0,0,1,0,0,211,-2,1,-1,2,0,-4,3,-2,6.2,16,-9.8,2,4,-2,0
14472,14954,297,267,2,5,5,2,0,9,0,0,16,13,1,5,1,0,0,1,0,0,0,0,-482,30,-3,3,-9,0,3,-4,1,14.8,14,0.8,4,4,0,0
14520,14912,247,258,4,4,4,4,6,5,0,1,33,16,2,2,0,2,0,1,0,1,0,0,-392,-11,0,0,1,0,17,0,-2,12.8,87.2,-74.4,4,4,0,0
16884,16199,256,275,9,7,7,9,13,15,0,1,24,85,4,2,0,1,0,1,0,1,0,0,685,-19,2,-2,-2,0,-61,2,-1,33.2,29.2,4,5,4,1,1
14616,14867,271,257,3,4,4,3,3,10,1,0,14,18,7,1,1,2,1,0,1,0,0,0,-251,14,-1,1,-7,0,-4,6,-1,22.6,25.8,-3.2,3,5,-2,0
15032,14511,261,267,5,3,3,5,7,4,1,0,13,37,3,3,0,0,0,1,1,0,0,0,521,-6,2,-2,3,0,-24,0,0,130.4,128,2.4,5,2,3,1
17099,14016,295,286,7,2,2,7,9,2,0,0,14,16,5,2,0,0,1,0,0,0,0,0,3083,9,5,-5,7,0,-2,3,0,29,60.8,-31.8,4,2,2,1
17911,15516,271,247,9,6,6,9,13,14,0,1,18,18,2,4,0,0,0,1,0,1,0,0,2395,24,3,-3,-1,0,0,-2,0,51.8,75.6,-23.8,4,5,-1,0
16655,14618,267,273,9,4,4,9,9,3,0,1,15,11,2,2,1,0,1,0,0,1,0,0,2037,-6,5,-5,6,0,4,0,1,44.4,85.2,-40.8,5,4,1,1
2699,2709,6,6,0,0,0,0,0,0,0,0,1,2,0,0,0,0,0,0,0,0,0,0,-10,0,0,0,0,0,-1,0,0,22.8,39.8,-17,2,5,-3,1
15403,13925,291,260,5,3,3,5,2,3,0,1,15,13,5,3,1,1,1,0,0,1,0,0,1478,31,2,-2,-1,0,2,2,0,51,7.2,43.8,4,2,2,1
16465,15351,245,247,9,5,5,9,10,6,0,0,11,209,2,2,1,0,1,0,0,0,0,0,1114,-2,4,-4,4,0,-198,0,1,9.8,8.8,1,2,2,0,0
15685,13972,289,244,5,4,4,5,5,3,0,0,12,16,3,0,2,0,0,1,0,0,0,0,1713,45,1,-1,2,0,-4,3,2,101,13.4,87.6,5,3,2,1
15253,14891,254,227,5,7,7,5,5,9,0,0,15,18,5,2,1,0,0,1,0,0,0,0,362,27,-2,2,-4,0,-3,3,1,16,76.6,-60.6,2,3,-1,0
14921,14174,266,241,5,4,4,5,4,5,0,0,13,19,3,3,1,0,1,0,0,0,0,0,747,25,1,-1,-1,0,-6,0,1,23.4,129.4,-106,3,5,-2,1
15393,14213,281,258,5,3,3,5,4,3,0,0,19,32,6,3,2,1,1,0,0,0,0,0,1180,23,2,-2,1,0,-13,3,1,57.6,23.6,34,5,4,1,1
14368,15194,286,290,3,5,5,3,2,6,0,1,11,16,3,4,0,0,0,1,0,1,0,0,-826,-4,-2,2,-4,0,-5,-1,0,71,40.2,30.8,5,4,1,0
14608,14001,284,296,3,1,1,3,3,0,0,0,17,16,6,3,0,0,1,0,0,0,0,0,607,-12,2,-2,3,0,1,3,0,37.6,20.2,17.4,5,5,0,0
14589,14998,241,260,4,5,5,4,7,8,0,0,11,32,3,1,0,0,0,1,0,0,0,0,-409,-19,-1,1,-1,0,-21,2,0,86.2,54.2,32,4,5,-1,1
14439,14881,267,287,3,3,3,4,4,1,1,0,20,19,7,3,1,0,1,0,1,0,0,0,-442,-20,0,-1,3,0,1,4,1,16.8,18.4,-1.6,4,4,0,0
15027,17466,230,246,6,13,13,6,5,16,0,1,33,104,1,3,1,0,0,1,0,1,0,0,-2439,-16,-7,7,-11,0,-71,-2,1,14.6,47.4,-32.8,4,3,1,0
13248,16704,276,257,1,9,9,1,0,16,1,0,12,16,2,2,1,0,0,1,1,0,0,0,-3456,19,-8,8,-16,0,-4,0,1,28.6,68,-39.4,5,4,1,0
15639,18030,240,231,6,11,11,6,7,17,0,0,21,16,1,0,0,2,0,1,0,0,0,0,-2391,9,-5,5,-10,0,5,1,-2,14.8,36.2,-21.4,3,5,-2,0
15466,16391,293,269,5,9,9,5,5,6,0,0,12,33,3,0,0,0,1,0,0,0,0,0,-925,24,-4,4,-1,0,-21,3,0,17.2,71.4,-54.2,3,4,-1,0
15999,14009,289,247,5,3,3,5,6,3,0,0,20,11,1,3,1,0,1,0,0,0,0,0,1990,42,2,-2,3,0,9,-2,1,142.2,38.8,103.4,5,4,1,1
15089,15071,217,247,7,6,6,7,9,4,0,0,13,14,1,0,2,1,0,1,0,0,0,0,18,-30,1,-1,5,0,-1,1,1,7,4.8,2.2,2,1,1,0
15482,17912,252,269,6,11,11,6,6,14,0,0,37,19,2,3,0,0,0,1,0,0,0,0,-2430,-17,-5,5,-8,0,18,-1,0,10.4,9,1.4,4,4,0,1
15174,17355,235,288,6,8,9,6,8,9,0,0,116,16,3,1,0,2,0,1,0,0,0,0,-2181,-53,-2,3,-1,0,100,2,-2,116,15.8,100.2,4,4,0,0
15391,13165,265,230,5,3,3,5,6,0,0,1,28,34,2,2,1,1,0,1,0,1,0,0,2226,35,2,-2,6,0,-6,0,0,44.6,46,-1.4,5,3,2,0
13319,15987,260,264,1,6,6,1,2,10,0,0,12,22,4,1,0,3,0,1,0,0,0,0,-2668,-4,-5,5,-8,0,-10,3,-3,17.8,10.4,7.4,3,3,0,0
16732,13678,282,244,7,2,2,7,8,2,0,0,16,35,4,2,0,0,1,0,0,0,0,0,3054,38,5,-5,6,0,-19,2,0,83.2,127.6,-44.4,5,4,1,1
16412,13628,231,242,9,3,3,9,13,2,0,0,38,17,3,5,1,0,1,0,0,0,0,0,2784,-11,6,-6,11,0,21,-2,1,43.6,12,31.6,4,4,0,1
16182,15132,257,234,8,7,7,8,7,5,0,1,13,23,3,2,0,0,1,0,0,1,0,0,1050,23,1,-1,2,0,-10,1,0,18.6,13.8,4.8,3,3,0,1
15586,14176,267,309,6,1,1,6,7,2,0,0,20,13,3,6,0,1,1,0,0,0,0,0,1410,-42,5,-5,5,0,7,-3,-1,15.8,11.2,4.6,4,4,0,0
15274,13694,262,284,5,2,2,5,9,0,0,1,38,13,3,14,0,0,0,1,0,1,0,0,1580,-22,3,-3,9,0,25,-11,0,146.4,138.6,7.8,5,4,1,1
14876,15720,261,273,6,5,5,6,3,6,0,1,17,16,0,3,0,0,1,0,0,1,0,0,-844,-12,1,-1,-3,0,1,-3,0,10.8,5.6,5.2,4,2,2,0
13150,17160,189,256,4,12,12,4,8,15,0,0,19,11,1,2,0,4,1,0,0,0,0,0,-4010,-67,-8,8,-7,0,8,-1,-4,5.4,7,-1.6,1,1,0,0
13689,16100,230,280,3,7,8,3,3,6,0,0,29,14,3,1,2,1,0,1,0,0,0,0,-2411,-50,-4,5,-3,0,15,2,1,109.4,15.2,94.2,5,4,1,1
17326,14020,269,273,11,2,2,11,10,2,1,0,14,11,1,0,0,0,1,0,1,0,0,0,3306,-4,9,-9,8,0,3,1,0,38,75.8,-37.8,5,3,2,1
15978,14459,266,258,8,4,4,8,9,2,0,0,18,15,0,3,1,0,1,0,0,0,0,0,1519,8,4,-4,7,0,3,-3,1,14.6,16.2,-1.6,5,4,1,1
15129,15451,246,286,5,5,5,5,8,4,1,0,40,15,1,4,0,3,1,0,1,0,0,0,-322,-40,0,0,4,0,25,-3,-3,48.4,60,-11.6,5,4,1,0
12752,14089,253,282,0,2,2,0,0,2,0,0,34,20,4,2,0,1,0,1,0,0,0,0,-1337,-29,-2,2,-2,0,14,2,-1,12.2,7.4,4.8,4,2,2,0
14334,16286,296,289,3,6,6,3,3,9,1,0,17,17,2,5,0,0,0,1,1,0,0,0,-1952,7,-3,3,-6,0,0,-3,0,22,16.8,5.2,5,5,0,0
15462,15954,232,271,6,7,7,6,9,6,0,0,38,24,2,5,0,1,0,1,0,0,0,0,-492,-39,-1,1,3,0,14,-3,-1,15.2,16.6,-1.4,4,5,-1,0
14548,17248,215,277,6,8,8,6,6,8,0,1,20,15,2,6,0,4,1,0,0,1,0,0,-2700,-62,-2,2,-2,0,5,-4,-4,36.4,23.6,12.8,3,2,1,0
14710,15131,248,249,4,7,7,4,7,8,0,1,29,93,6,2,0,0,0,1,0,1,0,0,-421,-1,-3,3,-1,0,-64,4,0,20.6,5.8,14.8,4,3,1,0
13379,13986,252,252,1,4,4,1,1,6,0,1,108,17,3,2,0,0,0,1,0,1,0,0,-607,0,-3,3,-5,0,91,1,0,8.4,22.8,-14.4,2,5,-3,0
14865,15304,231,245,6,5,5,7,3,9,0,0,10,10,2,1,2,0,1,0,0,0,0,0,-439,-14,1,-2,-6,0,0,1,2,14.4,4,10.4,4,0,4,0
15670,15285,290,290,5,6,6,5,4,0,0,0,23,102,7,6,0,0,1,0,0,0,0,0,385,0,-1,1,4,0,-79,1,0,16.4,31,-14.6,4,3,1,1
14703,15374,286,286,2,4,4,2,3,7,0,1,17,15,4,6,0,2,0,1,0,1,0,0,-671,0,-2,2,-4,0,2,-2,-2,10.6,37.2,-26.6,4,4,0,1
15001,15629,259,254,5,7,7,5,6,7,0,0,15,14,3,2,0,0,0,1,0,0,0,0,-628,5,-2,2,-1,0,1,1,0,18.2,14.2,4,3,3,0,1
14829,14119,269,278,4,2,2,4,2,4,0,1,15,47,1,5,2,0,0,1,0,1,0,0,710,-9,2,-2,-2,0,-32,-4,2,28.8,26.2,2.6,4,5,-1,1
16359,13443,273,279,7,1,1,7,8,0,0,0,16,16,3,4,0,1,1,0,0,0,0,0,2916,-6,6,-6,8,0,0,-1,-1,21,9,12,4,3,1,1
14614,14199,292,324,2,1,1,2,3,0,0,1,104,36,6,4,2,0,0,1,0,1,0,0,415,-32,1,-1,3,0,68,2,2,15.8,26.8,-11,3,4,-1,1
15600,13882,272,267,6,3,3,6,7,5,0,0,32,15,1,4,2,0,0,1,0,0,0,0,1718,5,3,-3,2,0,17,-3,2,20.6,131.4,-110.8,4,5,-1,1
16326,15088,268,249,8,6,6,8,4,7,0,0,20,16,3,6,1,0,0,1,0,0,0,0,1238,19,2,-2,-3,0,4,-3,1,23.8,9.4,14.4,2,3,-1,1
16724,12892,278,248,8,1,1,8,7,2,0,0,18,34,7,4,0,0,1,0,0,0,0,0,3832,30,7,-7,5,0,-16,3,0,19.2,23.4,-4.2,4,4,0,1
13329,13293,296,247,0,2,2,0,0,3,0,1,14,14,5,1,1,0,0,1,0,1,0,0,36,49,-2,2,-3,0,0,4,1,5.6,15,-9.4,2,5,-3,1
15419,14831,257,246,5,7,7,5,4,3,1,0,17,13,3,4,2,1,0,1,1,0,0,0,588,11,-2,2,1,0,4,-1,1,7.2,4.4,2.8,1,1,0,0
17989,16081,273,269,11,7,7,11,17,9,0,0,13,15,5,6,1,1,0,1,0,0,0,0,1908,4,4,-4,8,0,-2,-1,0,33.6,72.4,-38.8,4,4,0,0
15049,13913,280,250,5,2,2,5,4,4,1,0,16,35,5,3,0,0,1,0,1,0,0,0,1136,30,3,-3,0,0,-19,2,0,23,111,-88,4,3,1,1
15364,14924,261,245,6,5,5,6,4,6,0,0,33,173,0,3,0,0,0,1,0,0,0,0,440,16,1,-1,-2,0,-140,-3,0,14,33.8,-19.8,5,5,0,1
16356,14819,292,259,7,5,5,7,6,5,0,1,16,20,6,3,2,1,1,0,0,1,0,0,1537,33,2,-2,1,0,-4,3,1,93.8,22.6,71.2,2,2,0,0
17072,16371,264,254,9,8,8,9,8,11,0,0,15,38,6,2,1,0,0,1,0,0,0,0,701,10,1,-1,-3,0,-23,4,1,19,17,2,5,3,2,1
14573,15558,265,284,4,5,5,4,4,5,1,0,20,22,3,2,0,0,0,1,1,0,0,0,-985,-19,-1,1,-1,0,-2,1,0,10.8,22.2,-11.4,4,4,0,0
15078,15666,268,264,5,6,6,5,4,6,1,0,15,102,2,1,0,0,0,1,1,0,0,0,-588,4,-1,1,-2,0,-87,1,0,10.6,67.4,-56.8,3,4,-1,0
16342,16051,249,254,9,6,6,9,9,8,0,0,21,37,5,3,3,1,1,0,0,0,0,0,291,-5,3,-3,1,0,-16,2,2,7,23.8,-16.8,3,3,0,1
6181,7891,88,128,0,2,2,0,0,1,0,0,2,5,1,0,0,0,0,1,0,0,0,0,-1710,-40,-2,2,-1,0,-3,1,0,14.6,9.8,4.8,4,2,2,0
14439,16677,230,268,5,10,10,5,6,9,0,0,44,17,4,3,0,0,1,0,0,0,0,0,-2238,-38,-5,5,-3,0,27,1,0,88.4,15,73.4,5,4,1,0
14859,13146,252,265,6,1,1,6,5,1,0,1,22,19,0,4,0,0,1,0,0,1,0,0,1713,-13,5,-5,4,0,3,-4,0,64,59.8,4.2,5,5,0,1
14552,14506,269,289,4,2,2,4,4,2,0,0,17,41,2,3,0,1,1,0,0,0,0,0,46,-20,2,-2,2,0,-24,-1,-1,13.2,35.6,-22.4,3,5,-2,1
15270,15939,205,259,6,8,8,6,9,7,0,1,32,15,1,4,0,2,0,1,0,1,0,0,-669,-54,-2,2,2,0,17,-3,-2,28.8,11.8,17,3,2,1,0
14254,14410,236,226,5,6,6,5,4,5,1,0,10,24,1,4,0,0,1,0,1,0,0,0,-156,10,-1,1,-1,0,-14,-3,0,6.8,27.4,-20.6,2,4,-2,1
17365,12652,251,208,10,2,2,10,11,2,0,1,12,17,5,0,3,0,1,0,0,1,0,0,4713,43,8,-8,9,0,-5,5,3,61,51.2,9.8,5,2,3,1
15409,14457,276,250,5,4,5,5,2,3,1,0,15,19,6,1,1,0,1,0,1,0,0,0,952,26,1,0,-1,0,-4,5,1,21.8,40,-18.2,3,4,-1,0
15537,15536,252,269,7,6,6,7,7,5,0,1,94,15,1,4,0,0,0,1,0,1,0,0,1,-17,1,-1,2,0,79,-3,0,34.6,22,12.6,4,4,0,1
14756,14182,278,283,4,2,2,4,1,2,0,1,16,19,3,0,1,0,1,0,0,1,0,0,574,-5,2,-2,-1,0,-3,3,1,14.6,9.4,5.2,2,4,-2,0
13698,16100,245,241,3,8,8,3,3,12,0,0,30,11,0,1,1,0,0,1,0,0,0,0,-2402,4,-5,5,-9,0,19,-1,1,6.4,12.4,-6,2,3,-1,0
14598,13763,281,265,2,2,2,2,3,2,0,0,17,18,3,2,2,0,1,0,0,0,0,0,835,16,0,0,1,0,-1,1,2,25.8,23,2.8,5,5,0,1
16637,13742,268,269,9,2,2,9,13,3,1,0,11,21,1,2,0,0,0,1,1,0,0,0,2895,-1,7,-7,10,0,-10,-1,0,102.4,39.4,63,4,5,-1,1
15270,13137,251,253,5,1,1,5,6,0,0,0,18,14,1,4,1,0,0,1,0,0,0,0,2133,-2,4,-4,6,0,4,-3,1,8.6,18.8,-10.2,2,5,-3,1
14913,15457,265,275,5,4,4,6,5,4,0,0,17,13,2,3,0,0,0,1,0,0,0,0,-544,-10,1,-2,1,0,4,-1,0,11,23.8,-12.8,3,4,-1,1
15111,14318,255,251,5,3,3,5,5,2,0,0,17,38,1,2,0,2,0,1,0,0,0,0,793,4,2,-2,3,0,-21,-1,-2,9.2,38.2,-29,3,4,-1,0
16928,14091,235,214,10,6,6,10,16,3,1,0,10,12,1,2,2,0,1,0,1,0,0,0,2837,21,4,-4,13,0,-2,-1,2,8.4,13.4,-5,2,3,-1,0
15939,17174,244,240,8,11,11,8,7,13,0,0,13,23,5,3,0,1,1,0,0,0,0,0,-1235,4,-3,3,-6,0,-10,2,-1,28.6,19.6,9,2,4,-2,1
15780,16415,236,233,8,9,9,8,5,13,0,1,16,19,3,6,0,0,0,1,0,1,0,0,-635,3,-1,1,-8,0,-3,-3,0,67.4,4.4,63,3,0,3,1
14170,14903,281,263,2,4,4,2,2,6,0,1,41,22,4,5,0,0,1,0,0,1,0,0,-733,18,-2,2,-4,0,19,-1,0,8.4,26.6,-18.2,3,4,-1,0
15159,13814,271,258,5,3,3,6,6,1,0,1,20,14,3,3,0,1,1,0,0,1,0,0,1345,13,2,-3,5,0,6,0,-1,190.6,56.4,134.2,3,4,-1,1
16262,16631,278,262,7,9,9,7,9,7,0,1,17,19,6,4,0,1,1,0,0,1,0,0,-369,16,-2,2,2,0,-2,2,-1,16.6,17.6,-1,4,4,0,1
14521,14723,255,272,3,4,4,3,4,7,0,0,19,18,2,2,3,0,0,1,0,0,0,0,-202,-17,-1,1,-3,0,1,0,3,8,7.4,0.6,2,3,-1,1
15473,14391,246,262,6,5,5,6,8,2,0,0,15,14,3,4,0,0,1,0,0,0,0,0,1082,-16,1,-1,6,0,1,-1,0,67.4,73.4,-6,4,5,-1,1
17457,16875,250,261,11,8,9,11,10,7,0,1,15,14,2,2,0,2,0,1,0,1,0,0,582,-11,3,-2,3,0,1,0,-2,17.4,18.6,-1.2,4,3,1,1
18553,15025,244,189,17,7,7,17,14,9,0,0,28,24,1,1,4,0,1,0,0,0,0,0,3528,55,10,-10,5,0,4,0,4,33.8,98.8,-65,4,2,2,1
16724,16087,247,271,9,6,6,9,9,5,0,1,32,9,2,3,0,1,0,1,0,1,0,0,637,-24,3,-3,4,0,23,-1,-1,12.4,21.4,-9,3,4,-1,1
16264,16550,228,286,8,8,8,8,7,7,0,0,15,17,2,2,0,0,1,0,0,0,0,0,-286,-58,0,0,0,0,-2,0,0,10,20.8,-10.8,3,4,-1,0
17447,16844,259,262,11,9,9,11,8,8,0,0,17,20,4,4,0,1,1,0,0,0,0,0,603,-3,2,-2,0,0,-3,0,-1,76.4,13.4,63,4,3,1,1
15093,15042,252,226,4,6,7,4,5,10,0,0,77,19,3,1,1,0,0,1,0,0,0,0,51,26,-2,3,-5,0,58,2,1,22,29.4,-7.4,3,4,-1,0
13592,16494,235,280,3,8,8,3,1,5,0,1,13,16,5,3,0,1,1,0,0,1,0,0,-2902,-45,-5,5,-4,0,-3,2,-1,167.2,38.4,128.8,3,3,0,0
15412,16485,228,270,8,7,7,8,13,6,1,0,107,11,2,7,0,1,1,0,1,0,0,0,-1073,-42,1,-1,7,0,96,-5,-1,8.2,21,-12.8,2,5,-3,0
16845,13735,251,266,10,2,2,11,21,3,0,0,30,14,5,4,0,0,1,0,0,0,0,0,3110,-15,8,-9,18,0,16,1,0,51.4,43,8.4,3,3,0,1
15075,16613,241,261,6,7,7,6,13,20,0,0,15,17,0,4,1,0,0,1,0,0,0,0,-1538,-20,-1,1,-7,0,-2,-4,1,27.6,81.6,-54,4,5,-1,1
17567,15661,248,232,11,9,9,11,10,8,0,0,13,15,6,3,0,1,0,1,0,0,0,0,1906,16,2,-2,2,0,-2,3,-1,34.8,30.4,4.4,4,5,-1,1
15155,14643,253,249,5,4,4,5,6,5,0,0,17,55,5,1,0,1,0,1,0,0,0,0,512,4,1,-1,1,0,-38,4,-1,11.2,19.6,-8.4,4,3,1,0
16615,16427,272,272,8,7,7,8,6,6,0,0,17,14,5,4,0,3,1,0,0,0,0,0,188,0,1,-1,0,0,3,1,-3,40.4,7.6,32.8,3,2,1,1
15773,16769,245,235,7,11,11,7,10,10,0,1,15,17,3,3,0,0,0,1,0,1,0,0,-996,10,-4,4,0,0,-2,0,0,29,14.8,14.2,4,3,1,0
15606,16238,208,262,9,7,7,9,9,9,0,0,15,16,2,3,0,0,1,0,0,0,0,0,-632,-54,2,-2,0,0,-1,-1,0,35.6,32.2,3.4,3,5,-2,0
15161,13891,259,273,6,2,2,6,8,2,0,1,47,14,1,5,0,1,1,0,0,1,0,0,1270,-14,4,-4,6,0,33,-4,-1,62.4,24.4,38,5,4,1,0
16767,14342,235,273,11,4,4,11,19,3,0,0,50,50,2,1,1,0,1,0,0,0,0,0,2425,-38,7,-7,16,0,0,1,1,32,49.2,-17.2,3,4,-1,1
15440,14732,285,264,5,3,3,5,6,4,0,0,13,15,3,3,0,0,1,0,0,0,0,0,708,21,2,-2,2,0,-2,0,0,45,57.2,-12.2,3,3,0,0
16020,15518,244,253,9,7,7,9,9,5,0,1,18,17,2,4,1,1,0,1,0,1,0,0,502,-9,2,-2,4,0,1,-2,0,103,52.2,50.8,5,4,1,1
17659,14327,264,233,12,5,5,12,12,3,0,0,16,16,5,2,4,0,1,0,0,0,0,0,3332,31,7,-7,9,0,0,3,4,100.6,85.8,14.8,4,4,0,1
18028,14513,268,253,12,3,3,12,21,2,0,0,12,37,6,5,2,0,1,0,0,0,0,0,3515,15,9,-9,19,0,-25,1,2,15.4,22.6,-7.2,3,3,0,1
16686,14581,291,244,8,3,3,8,6,3,0,0,13,22,2,2,1,0,1,0,0,0,0,0,2105,47,5,-5,3,0,-9,0,1,12.8,51.8,-39,3,5,-2,1
14503,16074,260,304,4,6,6,4,3,4,0,1,20,17,1,4,0,0,0,1,0,1,0,0,-1571,-44,-2,2,-1,0,3,-3,0,18,98,-80,4,5,-1,0
15304,14319,254,256,6,2,2,6,7,2,0,0,15,42,2,3,1,2,1,0,0,0,0,0,985,-2,4,-4,5,0,-27,-1,-1,36.2,76.2,-40,3,5,-2,1
16098,15405,228,235,9,6,6,9,11,8,0,0,17,15,2,2,1,1,0,1,0,0,0,0,693,-7,3,-3,3,0,2,0,0,28.4,100.2,-71.8,4,5,-1,1
16772,14119,273,285,8,1,1,8,12,0,1,0,56,15,4,3,0,1,0,1,1,0,0,0,2653,-12,7,-7,12,0,41,1,-1,102.8,19.8,83,3,4,-1,1
15570,14795,247,239,8,5,5,8,9,3,0,0,41,15,2,3,1,1,1,0,0,0,0,0,775,8,3,-3,6,0,26,-1,0,30.4,27.6,2.8,4,2,2,0
16881,15642,262,269,8,6,6,8,12,3,0,0,17,19,1,3,2,0,0,1,0,0,0,0,1239,-7,2,-2,9,0,-2,-2,2,86.2,15.6,70.6,3,4,-1,1
17128,16194,276,237,9,7,7,9,12,11,0,0,15,16,3,1,0,1,1,0,0,0,0,0,934,39,2,-2,1,0,-1,2,-1,41,22.2,18.8,5,4,1,1
14869,16604,240,288,5,8,8,5,4,6,0,1,14,17,3,4,1,1,0,1,0,1,0,0,-1735,-48,-3,3,-2,0,-3,-1,0,34.4,43.6,-9.2,3,4,-1,0
14099,15556,267,306,2,5,5,2,2,4,0,1,118,28,1,1,0,1,0,1,0,1,0,0,-1457,-39,-3,3,-2,0,90,0,-1,53.4,83.6,-30.2,3,5,-2,0
16141,13891,281,254,6,4,4,6,8,1,0,0,21,14,0,2,1,0,0,1,0,0,0,0,2250,27,2,-2,7,0,7,-2,1,78.6,35,43.6,4,4,0,1
15258,13850,260,226,5,4,4,5,4,4,1,0,13,14,2,3,3,0,1,0,1,0,0,0,1408,34,1,-1,0,0,-1,-1,3,245.4,54,191.4,4,5,-1,1
15525,14037,295,282,4,2,2,4,7,2,0,1,15,15,1,4,1,0,0,1,0,1,0,0,1488,13,2,-2,5,0,0,-3,1,14.8,27.6,-12.8,5,2,3,1
14093,16408,259,247,3,9,9,3,1,7,0,1,11,16,4,1,0,2,0,1,0,1,0,0,-2315,12,-6,6,-6,0,-5,3,-2,23.2,15.4,7.8,3,3,0,1
13965,14799,244,275,3,5,5,3,5,2,0,0,17,19,2,2,0,0,0,1,0,0,0,0,-834,-31,-2,2,3,0,-2,0,0,15.2,12.2,3,4,3,1,0
15841,13058,292,263,6,1,1,6,3,0,0,1,17,15,2,4,1,0,1,0,0,1,0,0,2783,29,5,-5,3,0,2,-2,1,16.6,72.8,-56.2,4,5,-1,1
15422,15350,242,251,7,6,6,7,4,7,0,0,30,16,0,3,1,0,0,1,0,0,0,0,72,-9,1,-1,-3,0,14,-3,1,91.2,32.4,58.8,5,5,0,1
13585,16922,265,294,1,8,8,1,2,12,0,1,14,15,3,6,0,0,0,1,0,1,0,0,-3337,-29,-7,7,-10,0,-1,-3,0,65.4,18.4,47,3,3,0,0
13684,15015,266,277,1,4,4,2,2,5,0,1,34,20,4,1,1,1,0,1,0,1,0,0,-1331,-11,-3,2,-3,0,14,3,0,8.8,30.4,-21.6,2,4,-2,1
13552,15765,291,287,0,5,5,0,0,5,0,0,38,30,5,4,1,0,0,1,0,0,0,0,-2213,4,-5,5,-5,0,8,1,1,18.4,38.8,-20.4,4,3,1,0
15401,16455,254,245,5,9,9,5,3,11,1,0,13,35,3,4,2,0,0,1,1,0,0,0,-1054,9,-4,4,-8,0,-22,-1,2,10.8,27.2,-16.4,4,5,-1,0
15756,13776,303,282,4,2,2,4,5,1,0,1,36,13,4,2,2,0,1,0,0,1,0,0,1980,21,2,-2,4,0,23,2,2,16,12,4,4,3,1,1
16261,14556,229,251,9,5,5,9,16,5,0,0,34,17,6,2,1,0,0,1,0,0,0,0,1705,-22,4,-4,11,0,17,4,1,64.2,10.8,53.4,4,3,1,1
14990,14263,286,264,4,3,3,4,4,3,0,0,19,17,3,6,0,0,0,1,0,0,0,0,727,22,1,-1,1,0,2,-3,0,12.2,18.8,-6.6,4,5,-1,0
17181,15279,262,249,11,7,7,11,7,5,0,1,17,14,3,3,4,1,1,0,0,1,0,0,1902,13,4,-4,2,0,3,0,3,22.6,14.8,7.8,2,4,-2,0
14987,15376,291,288,4,3,3,4,6,5,1,0,115,33,4,4,0,3,1,0,1,0,0,0,-389,3,1,-1,1,0,82,0,-3,34,8.4,25.6,5,2,3,0
15322,16766,233,278,5,8,8,5,5,7,0,1,26,55,2,6,1,3,0,1,0,1,0,0,-1444,-45,-3,3,-2,0,-29,-4,-2,10.8,12.6,-1.8,3,2,1,0
15315,14137,279,261,5,3,3,5,4,4,0,1,16,21,1,2,1,0,1,0,0,1,0,0,1178,18,2,-2,0,0,-5,-1,1,17.6,197,-179.4,5,4,1,0
14034,14253,252,269,3,3,3,3,4,6,0,0,26,19,5,2,0,0,0,1,0,0,0,0,-219,-17,0,0,-2,0,7,3,0,44.6,13.2,31.4,5,4,1,0
14967,15989,285,263,4,6,6,4,4,7,0,0,16,39,6,4,0,1,0,1,0,0,0,0,-1022,22,-2,2,-3,0,-23,2,-1,52.8,33,19.8,4,3,1,0
16906,14934,240,230,12,5,5,13,11,3,0,0,18,14,1,6,0,1,1,0,0,0,0,0,1972,10,7,-8,8,0,4,-5,-1,12.6,10.6,2,3,3,0,1
17212,16565,270,236,9,9,9,9,9,9,0,0,20,16,1,7,3,0,1,0,0,0,0,0,647,34,0,0,0,0,4,-6,3,14.2,25.2,-11,4,5,-1,0
15298,16635,248,264,6,9,9,6,6,4,0,0,29,37,4,3,0,3,0,1,0,0,0,0,-1337,-16,-3,3,2,0,-8,1,-3,20.4,15.2,5.2,5,4,1,0
16181,15898,272,270,8,7,7,8,7,4,0,0,14,13,3,2,0,0,0,1,0,0,0,0,283,2,1,-1,3,0,1,1,0,13,133.8,-120.8,4,4,0,1
15577,16774,245,265,6,9,9,6,5,10,0,1,12,28,3,3,1,2,1,0,0,1,0,0,-1197,-20,-3,3,-5,0,-16,0,-1,32.8,86.8,-54,4,5,-1,1
16359,15020,257,240,8,5,5,8,7,4,0,0,18,18,4,3,0,0,1,0,0,0,0,0,1339,17,3,-3,3,0,0,1,0,7.6,8.6,-1,2,2,0,1
14922,15260,248,260,5,6,6,5,4,7,0,1,14,16,3,1,0,1,0,1,0,1,0,0,-338,-12,-1,1,-3,0,-2,2,-1,21.4,9.2,12.2,4,1,3,0
17427,13191,286,233,10,3,3,10,6,0,1,0,16,16,4,5,3,0,1,0,1,0,0,0,4236,53,7,-7,6,0,0,-1,3,28.8,10.6,18.2,3,3,0,0
15186,18348,271,263,5,12,12,5,5,15,1,0,18,16,2,5,0,1,1,0,1,0,0,0,-3162,8,-7,7,-10,0,2,-3,-1,18.8,32.4,-13.6,3,3,0,0
16622,17222,239,252,8,10,10,8,17,21,0,1,16,11,1,3,0,0,0,1,0,1,0,0,-600,-13,-2,2,-4,0,5,-2,0,86.8,15.8,71,4,2,2,1
15032,15162,243,232,5,6,6,5,5,7,0,0,13,17,3,0,1,0,1,0,0,0,0,0,-130,11,-1,1,-2,0,-4,3,1,32.8,7.4,25.4,4,2,2,1
17536,14760,282,255,10,4,4,10,12,6,0,0,45,111,3,3,1,0,1,0,0,0,0,0,2776,27,6,-6,6,0,-66,0,1,19.4,31,-11.6,5,5,0,1
15472,15158,243,260,7,5,5,7,12,4,0,0,19,17,4,2,1,0,1,0,0,0,0,0,314,-17,2,-2,8,0,2,2,1,9.4,104.6,-95.2,3,3,0,0
14819,15400,261,289,4,5,5,4,9,4,0,0,37,124,3,1,0,0,0,1,0,0,0,0,-581,-28,-1,1,5,0,-87,2,0,14.4,35,-20.6,4,5,-1,0
2608,2531,4,0,0,0,0,0,0,0,0,0,1,0,0,0,0,0,0,0,0,0,0,0,77,4,0,0,0,0,1,0,0,74.2,31.8,42.4,5,4,1,1
16342,17373,257,263,8,9,9,8,6,14,1,0,16,14,3,3,0,0,1,0,1,0,0,0,-1031,-6,-1,1,-8,0,2,0,0,46.8,18.6,28.2,3,2,1,0
15901,14918,283,264,6,5,5,6,15,2,0,0,10,14,5,3,0,1,1,0,0,0,0,0,983,19,1,-1,13,0,-4,2,-1,26.2,15.2,11,3,4,-1,1
15767,15688,259,244,7,8,8,7,3,6,0,1,18,35,1,3,2,1,1,0,0,1,0,0,79,15,-1,1,-3,0,-17,-2,1,11.2,15.4,-4.2,2,3,-1,0
13336,14985,264,231,1,7,7,2,1,5,0,0,13,18,6,0,1,0,0,1,0,0,0,0,-1649,33,-6,5,-4,0,-5,6,1,16,16,0,4,4,0,1
17388,14227,269,269,9,2,2,9,16,4,0,0,16,36,2,4,0,0,1,0,0,0,0,0,3161,0,7,-7,12,0,-20,-2,0,19,76.2,-57.2,3,4,-1,1
16745,15378,259,245,10,6,6,10,5,7,0,0,14,14,6,0,2,1,1,0,0,0,0,0,1367,14,4,-4,-2,0,0,6,1,11.2,14,-2.8,4,3,1,1
15479,15780,241,276,6,7,7,6,5,11,0,1,17,18,4,4,0,1,0,1,0,1,0,0,-301,-35,-1,1,-6,0,-1,0,-1,31.8,31.8,0,2,4,-2,1
16702,16555,242,251,11,10,10,11,15,7,1,0,16,11,3,2,0,0,0,1,1,0,0,0,147,-9,1,-1,8,0,5,1,0,84.4,142,-57.6,4,4,0,0
15660,15632,268,278,5,5,5,5,9,2,0,0,16,16,3,5,0,3,0,1,0,0,0,0,28,-10,0,0,7,0,0,-2,-3,40.4,18.6,21.8,4,4,0,1
14278,15336,235,270,4,7,7,4,5,4,0,1,18,114,3,4,0,0,0,1,0,1,0,0,-1058,-35,-3,3,1,0,-96,-1,0,23.4,70.6,-47.2,4,5,-1,0
14853,15366,276,271,4,5,5,4,3,9,0,0,14,59,2,4,1,0,0,1,0,0,0,0,-513,5,-1,1,-6,0,-45,-2,1,30.2,15.6,14.6,3,2,1,0
15804,16551,260,245,7,8,8,7,10,12,0,1,14,20,5,3,0,1,0,1,0,1,0,0,-747,15,-1,1,-2,0,-6,2,-1,13.8,53.8,-40,4,5,-1,0
15283,13047,263,250,7,2,2,7,6,0,0,1,10,31,0,6,1,0,1,0,0,1,0,0,2236,13,5,-5,6,0,-21,-6,1,18.6,12.6,6,4,5,-1,1
16009,13704,276,270,7,2,2,7,6,2,0,1,18,17,0,7,0,0,0,1,0,1,0,0,2305,6,5,-5,4,0,1,-7,0,11.8,55.2,-43.4,4,5,-1,1
15033,16128,254,267,5,7,7,5,5,11,0,1,14,19,6,5,1,3,0,1,0,1,0,0,-1095,-13,-2,2,-6,0,-5,1,-2,9,10.6,-1.6,2,3,-1,0
15789,14137,320,245,5,5,5,5,5,5,0,0,15,13,1,3,0,0,0,1,0,0,0,0,1652,75,0,0,0,0,2,-2,0,17.2,42.4,-25.2,4,4,0,1
15460,15510,223,246,7,8,8,7,7,6,0,1,15,14,3,1,2,1,0,1,0,1,0,0,-50,-23,-1,1,1,0,1,2,1,26,32,-6,4,3,1,1
15512,14519,252,303,6,2,3,6,6,0,0,0,28,15,0,1,0,0,0,1,0,0,0,0,993,-51,4,-3,6,0,13,-1,0,27,14.8,12.2,3,4,-1,1
15331,17810,249,240,6,11,11,6,9,17,0,0,15,18,3,1,0,2,0,1,0,0,0,0,-2479,9,-5,5,-8,0,-3,2,-2,51.4,44.6,6.8,5,3,2,0
14141,14081,270,274,3,3,3,3,3,3,0,0,15,15,4,4,0,0,1,0,0,0,0,0,60,-4,0,0,0,0,0,0,0,36.2,46.4,-10.2,4,3,1,0
13802,16634,253,296,2,7,7,2,2,9,0,0,17,16,4,7,0,2,0,1,0,0,0,0,-2832,-43,-5,5,-7,0,1,-3,-2,16.8,42.6,-25.8,3,4,-1,0
15862,15654,264,270,5,6,6,5,11,6,0,0,49,16,5,7,0,1,0,1,0,0,0,0,208,-6,-1,1,5,0,33,-2,-1,19.2,63,-43.8,5,4,1,1
14720,14513,277,282,3,3,3,3,5,2,0,0,26,13,2,4,1,1,0,1,0,0,0,0,207,-5,0,0,3,0,13,-2,0,27.6,30.2,-2.6,4,4,0,1
15878,15545,245,224,7,8,9,8,7,8,0,0,15,23,3,2,1,0,1,0,0,0,0,0,333,21,-1,1,-1,0,-8,1,1,14,31.6,-17.6,3,5,-2,1
15198,16366,277,275,5,7,7,5,2,7,0,0,11,15,3,3,0,2,1,0,0,0,0,0,-1168,2,-2,2,-5,0,-4,0,-2,63.8,21.2,42.6,4,3,1,0
14807,15940,228,273,7,5,5,7,5,8,0,0,16,14,4,3,1,1,1,0,0,0,0,0,-1133,-45,2,-2,-3,0,2,1,0,25.8,53.4,-27.6,5,4,1,0
14188,14111,243,285,4,3,3,4,3,2,0,1,19,36,1,1,0,0,0,1,0,1,0,0,77,-42,1,-1,1,0,-17,0,0,25.4,64.2,-38.8,5,3,2,1
16258,13686,252,251,7,2,3,7,9,3,0,0,115,21,1,1,1,0,1,0,0,0,0,0,2572,1,5,-4,6,0,94,0,1,45.4,15.8,29.6,4,3,1,1
15912,14750,272,230,9,6,6,9,6,5,0,0,15,28,6,2,0,0,0,1,0,0,0,0,1162,42,3,-3,1,0,-13,4,0,9.2,28,-18.8,3,3,0,1
13437,15854,271,289,2,6,6,2,0,3,1,0,33,14,1,2,0,0,0,1,1,0,0,0,-2417,-18,-4,4,-3,0,19,-1,0,13.6,34.8,-21.2,3,4,-1,0
16931,14538,267,253,10,4,4,10,9,4,0,0,39,102,1,4,1,0,1,0,0,0,0,0,2393,14,6,-6,5,0,-63,-3,1,9.4,29.8,-20.4,2,2,0,1
14085,13663,280,260,2,2,2,2,1,1,0,0,16,16,2,4,0,0,1,0,0,0,0,0,422,20,0,0,0,0,0,-2,0,18.2,49.2,-31,4,4,0,1
17044,14763,271,217,10,7,7,10,11,8,0,0,17,33,2,1,1,0,0,1,0,0,0,0,2281,54,3,-3,3,0,-16,1,1,14,40,-26,3,5,-2,1
14750,14849,260,264,4,4,4,4,4,7,0,1,15,18,3,3,2,1,1,0,0,1,0,0,-99,-4,0,0,-3,0,-3,0,1,12.2,14.6,-2.4,4,4,0,0
14822,14561,291,285,3,3,3,3,1,3,0,1,141,16,4,3,0,0,0,1,0,1,0,0,261,6,0,0,-2,0,125,1,0,34.8,35.4,-0.6,5,5,0,1
13998,16060,250,249,3,8,8,4,6,11,0,0,15,23,2,3,0,0,0,1,0,0,0,0,-2062,1,-5,4,-5,0,-8,-1,0,14.8,13,1.8,3,3,0,0
15634,15070,276,229,6,7,7,6,4,8,0,1,112,15,0,5,2,0,0,1,0,1,0,0,564,47,-1,1,-4,0,97,-5,2,47.4,60.6,-13.2,4,5,-1,0
13887,15808,285,305,2,5,5,2,1,5,0,1,14,12,3,3,0,1,1,0,0,1,0,0,-1921,-20,-3,3,-4,0,2,0,-1,33.2,18.6,14.6,3,3,0,0
15486,15238,294,284,5,4,4,5,5,6,0,0,10,35,2,0,1,1,1,0,0,0,0,0,248,10,1,-1,-1,0,-25,2,0,25.8,8.6,17.2,4,2,2,1
17762,14902,291,236,10,6,6,10,10,8,1,0,12,35,6,1,3,0,1,0,1,0,0,0,2860,55,4,-4,2,0,-23,5,3,55,13.4,41.6,3,3,0,1
15180,15280,283,294,4,3,3,4,6,5,0,1,17,15,3,4,0,1,1,0,0,1,0,0,-100,-11,1,-1,1,0,2,-1,-1,14,9.2,4.8,3,4,-1,0
15285,15307,233,272,6,5,5,6,10,5,0,0,14,36,3,1,0,1,1,0,0,0,0,0,-22,-39,1,-1,5,0,-22,2,-1,39.6,15.4,24.2,3,4,-1,0
16508,14128,267,270,8,3,3,9,10,1,0,0,15,17,4,4,0,0,1,0,0,0,0,0,2380,-3,5,-6,9,0,-2,0,0,7,77.4,-70.4,2,5,-3,1
15651,14406,267,257,7,3,3,7,6,5,1,0,15,25,6,3,1,0,1,0,1,0,0,0,1245,10,4,-4,1,0,-10,3,1,16.8,40,-23.2,3,4,-1,0
15675,13563,264,246,6,2,2,6,8,4,0,0,19,16,5,3,0,0,0,1,0,0,0,0,2112,18,4,-4,4,0,3,2,0,81.6,74.6,7,4,5,-1,1
16424,14832,313,306,5,3,3,5,6,6,0,1,17,17,3,5,1,0,0,1,0,1,0,0,1592,7,2,-2,0,0,0,-2,1,13.6,13.4,0.2,2,3,-1,1
16526,14843,290,228,7,6,6,7,5,7,0,0,15,15,3,5,0,0,0,1,0,0,0,0,1683,62,1,-1,-2,0,0,-2,0,21.6,49,-27.4,4,5,-1,1
16236,14835,250,276,9,4,4,9,7,2,1,0,11,15,2,4,0,0,0,1,1,0,0,0,1401,-26,5,-5,5,0,-4,-2,0,67,87.8,-20.8,3,5,-2,1
16740,14394,279,278,9,3,3,9,6,4,1,0,15,12,2,1,3,0,1,0,1,0,0,0,2346,1,6,-6,2,0,3,1,3,21.8,69.2,-47.4,4,4,0,1
14943,15644,263,277,5,5,5,5,7,14,1,0,16,12,0,3,0,0,1,0,1,0,0,0,-701,-14,0,0,-7,0,4,-3,0,28.4,38.6,-10.2,4,3,1,0
14563,14622,295,292,2,3,3,2,3,4,0,1,110,18,3,1,0,0,0,1,0,1,0,0,-59,3,-1,1,-1,0,92,2,0,61.2,45.4,15.8,5,4,1,0
15331,14733,282,276,4,3,3,5,6,3,0,1,16,26,2,0,1,2,0,1,0,1,0,0,598,6,1,-2,3,0,-10,2,-1,18.2,28,-9.8,4,4,0,1
17011,14132,265,223,10,5,5,10,10,2,0,0,29,36,3,3,1,0,1,0,0,0,0,0,2879,42,5,-5,8,0,-7,0,1,15,51,-36,3,4,-1,0
14042,14640,275,281,2,4,4,2,4,5,0,1,17,17,2,4,0,0,0,1,0,1,0,0,-598,-6,-2,2,-1,0,0,-2,0,7.6,21.2,-13.6,2,3,-1,0
15156,17653,263,253,5,13,13,6,4,14,0,0,15,20,0,2,1,1,0,1,0,0,0,0,-2497,10,-8,7,-10,0,-5,-2,0,84.4,10.2,74.2,5,4,1,1
14729,14974,259,261,4,5,5,4,4,9,0,1,14,18,4,1,0,1,0,1,0,1,0,0,-245,-2,-1,1,-5,0,-4,3,-1,15.4,17.4,-2,5,3,2,1
14131,13837,244,250,5,3,3,5,1,3,0,0,16,18,2,3,0,0,1,0,0,0,0,0,294,-6,2,-2,-2,0,-2,-1,0,51,18.4,32.6,5,3,2,1
15459,17440,268,243,6,12,12,6,4,20,0,0,14,24,1,3,1,1,0,1,0,0,0,0,-1981,25,-6,6,-16,0,-10,-2,0,19.2,59,-39.8,4,2,2,1
14336,15078,273,269,3,4,4,3,1,6,0,0,24,35,3,5,1,1,1,0,0,0,0,0,-742,4,-1,1,-5,0,-11,-2,0,49,19.4,29.6,5,4,1,1
15673,15559,263,284,7,5,5,7,5,2,1,0,14,33,5,5,1,0,1,0,1,0,0,0,114,-21,2,-2,3,0,-19,0,1,116,109.6,6.4,4,5,-1,1
16993,15137,248,214,11,7,7,11,7,5,0,0,17,98,2,3,2,0,0,1,0,0,0,0,1856,34,4,-4,2,0,-81,-1,2,35.2,35.6,-0.4,4,3,1,1
15841,14153,260,259,6,4,4,6,9,2,0,1,13,19,3,3,0,1,0,1,0,1,0,0,1688,1,2,-2,7,0,-6,0,-1,12.6,14.6,-2,3,3,0,0
16349,14425,316,242,6,4,4,7,7,7,0,0,36,13,1,4,0,0,1,0,0,0,0,0,1924,74,2,-3,0,0,23,-3,0,40.6,35.4,5.2,5,5,0,1
15261,14864,261,267,5,5,5,5,8,2,0,1,15,29,2,3,0,0,1,0,0,1,0,0,397,-6,0,0,6,0,-14,-1,0,70.8,49,21.8,5,5,0,0
13728,17026,238,263,3,9,10,3,4,15,0,0,15,16,3,6,0,1,0,1,0,0,0,0,-3298,-25,-6,7,-11,0,-1,-3,-1,28.2,17.8,10.4,3,3,0,0
13512,14636,287,308,1,2,2,1,1,0,0,1,15,18,4,3,0,0,1,0,0,1,0,0,-1124,-21,-1,1,1,0,-3,1,0,62.4,14.6,47.8,5,3,2,1
16822,14914,301,269,7,5,5,7,11,9,0,1,15,13,1,3,0,0,0,1,0,1,0,0,1908,32,2,-2,2,0,2,-2,0,45.4,62.4,-17,4,3,1,1
16365,15606,295,269,6,6,6,6,5,3,0,1,16,21,6,2,1,1,1,0,0,1,0,0,759,26,0,0,2,0,-5,4,0,60.4,14.8,45.6,4,4,0,0
14093,17060,233,264,4,9,9,4,3,13,0,0,32,28,5,4,1,1,0,1,0,0,0,0,-2967,-31,-5,5,-10,0,4,1,0,33.6,60.6,-27,4,5,-1,1
15210,16734,269,250,4,10,10,4,5,8,0,0,112,48,0,0,1,1,0,1,0,0,0,0,-1524,19,-6,6,-3,0,64,0,0,60.2,69,-8.8,3,4,-1,0
16092,14371,279,252,7,5,5,7,8,3,0,1,19,18,3,6,1,0,1,0,0,1,0,0,1721,27,2,-2,5,0,1,-3,1,22,104.8,-82.8,4,4,0,1
14374,14736,239,218,5,7,7,5,3,10,0,0,53,33,3,3,0,0,0,1,0,0,0,0,-362,21,-2,2,-7,0,20,0,0,11.8,36.6,-24.8,1,3,-2,0
13349,15104,238,263,2,6,6,2,3,6,0,1,17,20,3,0,1,0,1,0,0,1,0,0,-1755,-25,-4,4,-3,0,-3,3,1,11,8.6,2.4,4,2,2,0
15330,15227,232,273,7,5,6,7,8,7,0,0,25,15,0,6,0,0,1,0,0,0,0,0,103,-41,2,-1,1,0,10,-6,0,100.8,126.6,-25.8,5,5,0,1
15876,15356,280,286,5,4,4,5,11,6,0,1,17,17,3,3,0,0,0,1,0,1,0,0,520,-6,1,-1,5,0,0,0,0,63.6,222.4,-158.8,4,4,0,0
14673,16700,250,261,4,8,8,4,6,8,0,1,15,14,1,2,1,1,1,0,0,1,0,0,-2027,-11,-4,4,-2,0,1,-1,0,19.6,92.4,-72.8,4,5,-1,0
14699,14882,271,282,5,3,3,5,2,5,1,0,14,17,4,5,1,1,1,0,1,0,0,0,-183,-11,2,-2,-3,0,-3,-1,0,22.4,9.2,13.2,3,4,-1,1
2518,2545,0,2,0,0,0,0,0,0,0,0,2,10,0,0,0,0,0,0,0,0,0,0,-27,-2,0,0,0,0,-8,0,0,21.6,22.4,-0.8,4,4,0,1
16050,13905,244,243,8,3,3,8,12,3,0,0,34,125,5,2,1,0,1,0,0,0,0,0,2145,1,5,-5,9,0,-91,3,1,54.8,28.6,26.2,4,3,1,1
15321,15743,266,279,6,6,6,6,7,6,0,1,19,19,5,5,0,1,0,1,0,1,0,0,-422,-13,0,0,1,0,0,0,-1,50,20,30,4,4,0,0
18219,13425,284,243,11,3,4,11,10,2,0,0,36,20,3,3,4,0,0,1,0,0,0,0,4794,41,8,-7,8,0,16,0,4,111.4,96,15.4,5,3,2,1
15111,14834,294,280,3,3,3,3,2,3,0,1,237,40,3,1,1,1,0,1,0,1,0,0,277,14,0,0,-1,0,197,2,0,36,17.2,18.8,4,4,0,1
17072,14513,282,259,8,4,4,8,5,4,0,1,20,27,2,7,1,0,1,0,0,1,0,0,2559,23,4,-4,1,0,-7,-5,1,56.6,62.8,-6.2,5,4,1,1
15527,15353,241,295,7,4,4,7,10,3,0,0,15,14,4,4,0,1,0,1,0,0,0,0,174,-54,3,-3,7,0,1,0,-1,89.2,55.8,33.4,3,4,-1,1
14749,15572,255,281,5,5,5,5,10,6,0,1,25,26,0,3,1,1,1,0,0,1,0,0,-823,-26,0,0,4,0,-1,-3,0,11.2,44.6,-33.4,3,3,0,0
2540,2510,1,0,0,0,0,0,0,0,0,0,2,2,1,0,0,0,0,0,0,0,0,0,30,1,0,0,0,0,0,1,0,64,22.2,41.8,4,4,0,1
15917,13944,226,253,11,2,2,11,14,3,0,0,15,59,5,1,1,1,1,0,0,0,0,0,1973,-27,9,-9,11,0,-44,4,0,40.2,83.6,-43.4,5,4,1,1
14207,15936,278,266,3,9,9,3,2,5,0,1,113,40,4,1,0,0,1,0,0,1,0,0,-1729,12,-6,6,-3,0,73,3,0,108.2,62.8,45.4,5,3,2,0
17183,15726,248,228,9,7,7,9,22,9,0,0,13,24,4,5,1,0,0,1,0,0,0,0,1457,20,2,-2,13,0,-11,-1,1,142,14.2,127.8,3,4,-1,1
17660,13667,264,250,9,1,3,9,14,1,0,0,18,15,1,3,4,1,1,0,0,0,0,0,3993,14,8,-6,13,0,3,-2,3,73.2,11.8,61.4,4,3,1,1
16230,15610,285,295,6,5,5,6,7,6,0,0,17,17,3,3,0,0,0,1,0,0,0,0,620,-10,1,-1,1,0,0,0,0,62.8,65.6,-2.8,5,4,1,0
14603,14115,291,264,2,2,2,2,3,6,0,1,12,16,1,4,2,0,1,0,0,1,0,0,488,27,0,0,-3,0,-4,-3,2,13.8,87,-73.2,3,5,-2,1
18387,15039,249,192,14,7,7,14,18,8,0,0,22,14,5,2,0,0,1,0,0,0,0,0,3348,57,7,-7,10,0,8,3,0,98.8,58,40.8,4,4,0,1
15703,14605,266,278,6,3,3,6,9,3,0,0,119,36,2,3,0,1,0,1,0,0,0,0,1098,-12,3,-3,6,0,83,-1,-1,26.6,12,14.6,3,5,-2,1
15253,15274,252,287,5,3,3,5,9,3,0,1,13,14,3,1,1,2,1,0,0,1,0,0,-21,-35,2,-2,6,0,-1,2,-1,29,37.2,-8.2,5,4,1,1
14687,14251,281,241,3,5,5,3,3,3,1,0,12,18,4,3,1,0,0,1,1,0,0,0,436,40,-2,2,0,0,-6,1,1,6.8,26.2,-19.4,2,3,-1,1
15512,15193,292,293,4,4,4,4,4,4,0,1,13,14,3,2,0,1,1,0,0,1,0,0,319,-1,0,0,0,0,-1,1,-1,46.2,22,24.2,4,2,2,1
15750,16739,236,258,7,8,8,7,7,12,0,1,20,16,3,3,1,3,0,1,0,1,0,0,-989,-22,-1,1,-5,0,4,0,-2,84,52.2,31.8,5,5,0,1
16835,15636,243,228,10,9,9,10,5,6,0,0,16,18,2,6,3,0,1,0,0,0,0,0,1199,15,1,-1,-1,0,-2,-4,3,18,40.2,-22.2,4,5,-1,1
15865,15512,307,274,5,6,6,5,6,6,1,0,15,23,4,5,0,0,0,1,1,0,0,0,353,33,-1,1,0,0,-8,-1,0,55.6,68.2,-12.6,5,4,1,1
13722,15213,262,241,2,7,7,2,2,13,0,0,16,24,5,2,1,0,0,1,0,0,0,0,-1491,21,-5,5,-11,0,-8,3,1,62,22,40,4,5,-1,1
13795,14680,228,270,4,4,4,4,5,3,0,0,32,18,2,4,0,1,0,1,0,0,0,0,-885,-42,0,0,2,0,14,-2,-1,18.2,25.8,-7.6,3,4,-1,0
14544,13597,274,280,3,1,1,3,4,1,0,1,19,16,3,5,0,0,1,0,0,1,0,0,947,-6,2,-2,3,0,3,-2,0,32.2,60.2,-28,3,5,-2,0
16448,15144,259,256,8,6,6,8,7,7,0,0,43,28,4,5,1,0,1,0,0,0,0,0,1304,3,2,-2,0,0,15,-1,1,97.2,13.4,83.8,4,5,-1,1
14612,18834,207,268,7,12,12,7,6,9,0,0,17,28,1,1,0,2,0,1,0,0,0,0,-4222,-61,-5,5,-3,0,-11,0,-2,31,16.4,14.6,2,3,-1,0
16737,15847,277,262,8,6,6,8,10,9,0,0,27,21,3,2,1,0,0,1,0,0,0,0,890,15,2,-2,1,0,6,1,1,43.4,76.8,-33.4,4,5,-1,1
13489,15120,256,269,1,4,4,1,0,4,0,1,20,38,2,4,0,0,1,0,0,1,0,0,-1631,-13,-3,3,-4,0,-18,-2,0,57.2,13.4,43.8,4,3,1,0
17202,14452,273,226,9,5,5,9,7,6,0,1,15,15,3,1,2,0,1,0,0,1,0,0,2750,47,4,-4,1,0,0,2,2,120,50.6,69.4,4,3,1,1
15514,14826,274,296,6,2,2,6,7,2,1,0,16,16,4,4,1,1,1,0,1,0,0,0,688,-22,4,-4,5,0,0,0,0,91.8,40.6,51.2,4,3,1,1
16305,15254,264,275,8,5,5,8,8,4,1,0,19,15,2,6,0,0,0,1,1,0,0,0,1051,-11,3,-3,4,0,4,-4,0,17.6,11.2,6.4,4,3,1,0
15275,14191,270,263,5,3,3,5,4,3,0,0,48,15,2,3,2,1,0,1,0,0,0,0,1084,7,2,-2,1,0,33,-1,1,80.6,47.4,33.2,3,4,-1,0
14356,14504,288,280,2,3,3,2,0,3,0,1,18,100,2,1,1,0,1,0,0,1,0,0,-148,8,-1,1,-3,0,-82,1,1,9.2,52.2,-43,4,5,-1,1
15131,16586,269,256,6,9,9,6,5,8,1,0,21,13,3,4,1,3,0,1,1,0,0,0,-1455,13,-3,3,-3,0,8,-1,-2,14.6,76.6,-62,4,5,-1,1
15057,14890,285,275,4,4,4,4,6,6,0,1,21,17,2,4,0,0,1,0,0,1,0,0,167,10,0,0,0,0,4,-2,0,57.2,66.6,-9.4,3,5,-2,1
17563,16142,262,242,11,7,7,11,10,11,0,0,34,20,2,1,0,1,1,0,0,0,0,0,1421,20,4,-4,-1,0,14,1,-1,36.8,59.2,-22.4,3,4,-1,0
15381,14796,272,274,5,3,3,5,9,4,1,0,19,17,3,2,0,0,1,0,1,0,0,0,585,-2,2,-2,5,0,2,1,0,19.8,93.4,-73.6,5,5,0,1
14350,13803,246,219,5,5,5,5,3,7,0,0,13,10,0,0,1,1,0,1,0,0,0,0,547,27,0,0,-4,0,3,0,0,7.8,6,1.8,3,4,-1,1
17390,13993,243,264,11,2,2,11,19,3,1,0,17,14,2,3,0,0,1,0,1,0,0,0,3397,-21,9,-9,16,0,3,-1,0,48.4,18,30.4,4,4,0,1
16306,17003,235,249,9,11,11,9,10,16,1,0,15,14,2,3,0,0,0,1,1,0,0,0,-697,-14,-2,2,-6,0,1,-1,0,25.6,183.8,-158.2,4,3,1,1
14300,17255,289,282,2,8,8,2,4,11,0,0,17,16,2,4,0,1,1,0,0,0,0,0,-2955,7,-6,6,-7,0,1,-2,-1,21,75.4,-54.4,3,2,1,0
15092,15430,229,268,5,6,6,5,6,7,0,0,24,32,3,8,2,0,0,1,0,0,0,0,-338,-39,-1,1,-1,0,-8,-5,2,104.8,47.8,57,4,3,1,0
14573,14300,233,248,5,4,4,5,7,6,0,0,18,16,1,1,1,0,1,0,0,0,0,0,273,-15,1,-1,1,0,2,0,1,23.4,68.6,-45.2,4,3,1,0
15081,17056,281,266,3,9,9,3,7,13,0,0,16,16,6,3,0,0,0,1,0,0,0,0,-1975,15,-6,6,-6,0,0,3,0,9.6,24.8,-15.2,2,3,-1,0
15638,14373,303,277,4,3,3,4,7,2,0,1,17,15,2,3,0,0,0,1,0,1,0,0,1265,26,1,-1,5,0,2,-1,0,59.2,17.6,41.6,3,3,0,1
17146,15129,268,272,8,5,5,8,13,2,0,0,14,35,4,4,1,2,0,1,0,0,0,0,2017,-4,3,-3,11,0,-21,0,-1,14.2,70.2,-56,4,4,0,1
14706,15439,282,289,3,5,5,3,2,4,0,0,14,20,7,1,1,1,0,1,0,0,0,0,-733,-7,-2,2,-2,0,-6,6,0,13.8,9.2,4.6,3,4,-1,1
15566,15085,264,258,6,6,6,6,6,3,0,1,121,17,1,1,1,1,0,1,0,1,0,0,481,6,0,0,3,0,104,0,0,9.2,50.4,-41.2,3,5,-2,1
11970,18437,183,308,1,13,13,1,1,6,0,0,22,223,3,0,0,3,0,1,0,0,0,0,-6467,-125,-12,12,-5,0,-201,3,-3,27.2,13,14.2,4,3,1,0
15236,15456,250,260,6,5,5,6,9,13,1,0,18,16,0,4,1,0,1,0,1,0,0,0,-220,-10,1,-1,-4,0,2,-4,1,12.6,72.8,-60.2,5,5,0,1
14551,13017,250,219,4,2,2,4,6,2,0,0,16,25,5,1,2,1,1,0,0,0,0,0,1534,31,2,-2,4,0,-9,4,1,5.2,33.4,-28.2,1,2,-1,1
15590,15439,274,231,5,8,8,5,8,13,0,1,16,19,2,1,1,0,0,1,0,1,0,0,151,43,-3,3,-5,0,-3,1,1,22.4,15.6,6.8,5,5,0,1
13756,16642,250,283,3,7,7,3,3,6,0,0,13,18,4,3,0,1,1,0,0,0,0,0,-2886,-33,-4,4,-3,0,-5,1,-1,14.8,10.8,4,5,4,1,0
16423,15803,305,285,6,4,4,6,6,6,0,0,15,39,6,5,0,1,1,0,0,0,0,0,620,20,2,-2,0,0,-24,1,-1,33,41.2,-8.2,3,5,-2,0
15361,15585,275,261,5,6,6,5,5,9,0,0,16,33,3,4,0,0,0,1,0,0,0,0,-224,14,-1,1,-4,0,-17,-1,0,43.6,37.4,6.2,3,4,-1,0
14849,16012,246,291,4,5,5,4,7,5,0,0,16,35,2,3,1,1,1,0,0,0,0,0,-1163,-45,-1,1,2,0,-19,-1,0,43.8,35.4,8.4,4,5,-1,0
16384,16245,257,274,8,7,7,8,11,8,0,0,28,16,2,2,0,0,0,1,0,0,0,0,139,-17,1,-1,3,0,12,0,0,50.4,62.8,-12.4,4,5,-1,0
14554,14079,270,235,4,4,4,4,3,4,0,1,275,13,2,5,1,1,0,1,0,1,0,0,475,35,0,0,-1,0,262,-3,0,24,26.6,-2.6,4,5,-1,1
18381,13170,235,203,13,3,3,13,14,3,1,0,12,13,2,0,5,0,1,0,1,0,1,0,5211,32,10,-10,11,0,-1,2,5,17.2,87.4,-70.2,3,4,-1,1
15832,14665,228,215,9,7,7,9,14,8,0,0,22,14,0,3,0,1,0,1,0,0,0,0,1167,13,2,-2,6,0,8,-3,-1,27,38.6,-11.6,4,5,-1,1
14596,14669,250,267,4,4,4,4,8,5,0,1,19,16,2,3,0,0,1,0,0,1,0,0,-73,-17,0,0,3,0,3,-1,0,12.4,19.2,-6.8,3,3,0,0
18124,14090,289,238,10,4,4,10,8,4,0,0,16,14,2,3,2,1,1,0,0,0,0,0,4034,51,6,-6,4,0,2,-1,1,20.2,4.8,15.4,5,1,4,1
15624,16112,222,276,7,6,6,7,10,7,0,0,37,15,3,2,0,2,0,1,0,0,0,0,-488,-54,1,-1,3,0,22,1,-2,28.4,30.6,-2.2,3,4,-1,1
16288,15052,251,251,7,5,5,7,9,5,0,0,23,29,5,1,1,1,0,1,0,0,0,0,1236,0,2,-2,4,0,-6,4,0,18.2,29.6,-11.4,3,2,1,0
14186,14342,286,262,2,4,4,2,1,6,0,1,16,37,5,2,0,0,0,1,0,1,0,0,-156,24,-2,2,-5,0,-21,3,0,28.4,14.4,14,5,4,1,0
14885,14127,251,232,6,4,4,6,5,4,0,0,24,17,2,6,0,0,1,0,0,0,0,0,758,19,2,-2,1,0,7,-4,0,26.2,19.2,7,4,5,-1,1
13755,14762,256,276,2,3,3,2,5,6,0,0,39,17,2,4,0,0,1,0,0,0,0,0,-1007,-20,-1,1,-1,0,22,-2,0,37.6,18.4,19.2,4,4,0,0
15348,13407,288,274,4,2,2,4,6,0,1,0,16,17,2,2,2,0,1,0,1,0,0,0,1941,14,2,-2,6,0,-1,0,2,9.8,18.6,-8.8,3,4,-1,1
16300,16455,257,261,7,8,8,7,7,9,0,0,19,15,3,6,2,2,0,1,0,0,0,0,-155,-4,-1,1,-2,0,4,-3,0,124.8,8.6,116.2,4,4,0,0
12795,15670,236,275,1,7,7,1,0,3,0,1,53,20,7,3,0,1,0,1,0,1,0,0,-2875,-39,-6,6,-3,0,33,4,-1,29.8,11.4,18.4,3,2,1,0
14857,13899,306,276,3,1,1,4,2,1,0,1,17,17,1,4,1,0,1,0,0,1,0,0,958,30,2,-3,1,0,0,-3,1,13.2,8.2,5,4,4,0,0
13923,17678,265,304,2,7,7,3,3,11,0,0,15,34,1,1,0,0,0,1,0,0,0,0,-3755,-39,-5,4,-8,0,-19,0,0,52.2,36.6,15.6,5,3,2,0
14818,15068,251,232,6,6,7,6,3,8,0,0,14,34,3,2,0,2,1,0,0,0,0,0,-250,19,0,1,-5,0,-20,1,-2,48.8,40,8.8,4,3,1,1
15218,13961,291,266,4,2,2,4,9,3,0,1,18,15,6,5,1,0,1,0,0,1,0,0,1257,25,2,-2,6,0,3,1,1,20.6,12.6,8,4,4,0,1
14774,14422,228,259,6,2,2,7,5,2,0,0,17,15,2,5,0,0,1,0,0,0,0,0,352,-31,4,-5,3,0,2,-3,0,35.6,14,21.6,5,4,1,0
15282,14122,281,264,5,3,3,5,4,2,0,1,34,19,3,3,0,0,1,0,0,1,0,0,1160,17,2,-2,2,0,15,0,0,47,110.6,-63.6,5,5,0,1
15323,15789,274,272,5,6,6,5,4,11,0,1,16,39,6,4,0,0,1,0,0,1,0,0,-466,2,-1,1,-7,0,-23,2,0,11.2,14.6,-3.4,4,4,0,1
15082,15170,267,277,4,4,4,4,4,5,0,0,15,26,1,3,3,1,1,0,0,0,0,0,-88,-10,0,0,-1,0,-11,-2,2,11,10.8,0.2,3,3,0,1
13505,16766,261,272,2,9,9,2,1,7,0,0,15,18,4,3,0,1,0,1,0,0,0,0,-3261,-11,-7,7,-6,0,-3,1,-1,37,109.2,-72.2,5,3,2,0
15955,17715,243,277,7,10,10,7,8,8,0,0,26,15,5,6,1,4,0,1,0,0,0,0,-1760,-34,-3,3,0,0,11,-1,-3,38.8,18.2,20.6,5,3,2,0
14258,16912,281,259,2,10,10,3,3,15,0,1,17,16,3,4,0,0,0,1,0,1,0,0,-2654,22,-8,7,-12,0,1,-1,0,32.6,16.8,15.8,5,4,1,0
16803,14743,252,258,9,3,3,9,14,3,1,0,19,15,2,2,1,0,1,0,1,0,0,0,2060,-6,6,-6,11,0,4,0,1,30.2,62.6,-32.4,3,4,-1,1
16073,17251,249,251,8,11,11,8,10,16,0,1,16,38,4,3,0,0,1,0,0,1,0,0,-1178,-2,-3,3,-6,0,-22,1,0,11.6,136.6,-125,4,4,0,0
15948,17406,276,255,6,11,11,6,5,15,1,0,11,18,6,1,0,0,0,1,1,0,0,0,-1458,21,-5,5,-10,0,-7,5,0,8.8,15.2,-6.4,3,4,-1,0
15471,15204,272,263,5,5,5,5,8,4,0,0,18,38,4,3,0,0,1,0,0,0,0,0,267,9,0,0,4,0,-20,1,0,60.6,24.2,36.4,3,4,-1,0
13628,15583,261,256,2,8,8,2,1,7,0,0,14,19,4,3,1,0,1,0,0,0,0,0,-1955,5,-6,6,-6,0,-5,1,1,19.2,6.6,12.6,5,3,2,0
13918,15832,272,268,2,5,5,2,2,6,0,0,17,29,3,5,1,0,0,1,0,0,0,0,-1914,4,-3,3,-4,0,-12,-2,1,20.6,45.4,-24.8,4,5,-1,1
15686,16685,205,269,8,8,8,8,9,10,0,1,15,16,4,2,1,1,1,0,0,1,0,0,-999,-64,0,0,-1,0,-1,2,0,15.4,19.4,-4,4,2,2,0
15248,15204,243,209,7,8,8,7,5,8,0,0,13,50,4,1,0,1,0,1,0,0,0,0,44,34,-1,1,-3,0,-37,3,-1,36.6,17,19.6,4,5,-1,0
16121,16984,264,281,8,7,7,8,6,7,0,1,19,13,1,7,1,0,0,1,0,1,0,0,-863,-17,1,-1,-1,0,6,-6,1,15,36,-21,3,5,-2,0
13308,16079,262,281,1,6,6,1,1,9,0,0,17,20,2,1,0,1,1,0,0,0,0,0,-2771,-19,-5,5,-8,0,-3,1,-1,12,14.4,-2.4,3,4,-1,0
14821,15486,245,245,4,5,5,5,4,6,0,0,18,19,3,3,2,3,1,0,0,0,0,0,-665,0,-1,0,-2,0,-1,0,-1,15.8,20,-4.2,4,5,-1,0
14755,13579,294,243,4,2,2,4,1,3,0,0,19,36,2,6,0,0,1,0,0,0,0,0,1176,51,2,-2,-2,0,-17,-4,0,27,14.2,12.8,5,3,2,1
14948,17013,254,262,5,10,10,5,9,8,0,0,20,13,2,6,0,3,0,1,0,0,0,0,-2065,-8,-5,5,1,0,7,-4,-3,49.2,11.4,37.8,4,3,1,1
16624,14686,276,277,8,3,3,8,8,2,0,0,18,32,3,2,1,1,0,1,0,0,0,0,1938,-1,5,-5,6,0,-14,1,0,9,16.4,-7.4,2,3,-1,1
16382,15375,267,252,9,6,6,9,5,7,0,0,12,15,4,3,0,1,0,1,0,0,0,0,1007,15,3,-3,-2,0,-3,1,-1,71,28.2,42.8,4,4,0,1
14284,16523,236,285,4,8,9,4,4,5,0,1,12,22,2,3,1,1,0,1,0,1,0,0,-2239,-49,-4,5,-1,0,-10,-1,0,17.4,21.4,-4,5,4,1,0
15164,13135,272,258,5,1,1,5,3,2,0,1,17,15,2,4,1,0,1,0,0,1,0,0,2029,14,4,-4,1,0,2,-2,1,15.4,18.4,-3,4,4,0,1
13036,15921,249,262,1,8,8,1,1,5,0,0,26,24,4,2,0,1,0,1,0,0,0,0,-2885,-13,-7,7,-4,0,2,2,-1,103,51,52,4,5,-1,0
15125,16051,249,230,6,10,10,6,8,7,0,0,14,110,4,3,0,0,1,0,0,0,0,0,-926,19,-4,4,1,0,-96,1,0,12.2,6.8,5.4,4,3,1,0
15570,14132,281,274,4,2,3,4,6,2,1,0,20,16,1,3,2,0,0,1,1,0,0,0,1438,7,2,-1,4,0,4,-2,2,19.6,8.4,11.2,4,2,2,1
13062,14644,251,272,1,3,3,1,1,3,0,0,42,80,3,2,0,2,0,1,0,0,0,0,-1582,-21,-2,2,-2,0,-38,1,-2,20.2,30.2,-10,3,5,-2,1
13666,17144,236,300,2,8,9,2,3,9,0,0,36,19,7,4,1,1,0,1,0,0,0,0,-3478,-64,-6,7,-6,0,17,3,0,12.8,15.4,-2.6,4,4,0,0
15385,15261,271,255,5,5,5,5,10,8,0,0,16,16,1,2,1,0,1,0,0,0,0,0,124,16,0,0,2,0,0,-1,1,31.6,40.8,-9.2,5,4,1,1
16877,13903,262,263,10,3,3,10,7,0,0,0,17,15,1,0,1,0,1,0,0,0,0,0,2974,-1,7,-7,7,0,2,1,1,86.6,8.4,78.2,4,2,2,1
15422,16719,262,290,6,7,7,6,6,11,0,0,15,15,2,4,0,1,1,0,0,0,0,0,-1297,-28,-1,1,-5,0,0,-2,-1,98.8,112,-13.2,3,4,-1,0
17436,16393,277,253,9,9,9,9,13,10,0,0,31,15,3,5,0,1,1,0,0,0,0,0,1043,24,0,0,3,0,16,-2,-1,9.2,14.4,-5.2,3,4,-1,1
14088,15195,281,270,2,6,6,2,2,11,0,0,48,20,3,5,0,0,0,1,0,0,0,0,-1107,11,-4,4,-9,0,28,-2,0,21.8,24.2,-2.4,5,5,0,1
15268,15323,267,266,6,6,6,6,6,3,0,1,36,15,2,7,0,0,1,0,0,1,0,0,-55,1,0,0,3,0,21,-5,0,11.6,28.8,-17.2,2,5,-3,0
16415,14955,271,260,7,5,5,7,10,4,0,1,21,17,6,6,2,0,0,1,0,1,0,0,1460,11,2,-2,6,0,4,0,2,46.2,15,31.2,4,3,1,1
13879,17102,238,256,3,10,10,3,3,6,0,0,14,17,3,4,1,4,0,1,0,0,0,0,-3223,-18,-7,7,-3,0,-3,-1,-3,35.6,39.4,-3.8,4,3,1,0
15514,17514,217,252,8,12,12,8,4,8,0,0,49,35,3,4,0,2,0,1,0,0,0,0,-2000,-35,-4,4,-4,0,14,-1,-2,13,49.6,-36.6,3,5,-2,1
15323,14092,286,268,4,3,3,4,4,3,0,1,16,21,6,5,0,0,0,1,0,1,0,0,1231,18,1,-1,1,0,-5,1,0,8.4,14.6,-6.2,3,3,0,0
15599,16303,259,240,7,9,9,7,5,12,0,0,36,16,2,1,2,1,0,1,0,0,0,0,-704,19,-2,2,-7,0,20,1,1,50.6,19.6,31,4,2,2,0
14422,16581,243,268,4,8,8,4,6,12,0,0,17,38,3,5,1,1,1,0,0,0,0,0,-2159,-25,-4,4,-6,0,-21,-2,0,29.4,10.2,19.2,4,3,1,1
15825,16379,234,232,9,9,9,9,12,12,0,0,14,13,3,5,0,1,1,0,0,0,0,0,-554,2,0,0,0,0,1,-2,-1,10.8,67.8,-57,2,4,-2,1
16945,14812,275,266,8,4,4,8,8,6,0,0,15,15,3,1,1,0,0,1,0,0,0,0,2133,9,4,-4,2,0,0,2,1,51.2,19,32.2,3,4,-1,1
15026,16888,243,270,5,8,8,5,10,11,0,1,17,37,5,6,2,1,1,0,0,1,0,0,-1862,-27,-3,3,-1,0,-20,-1,1,24.8,49.8,-25,3,5,-2,0
13283,16821,244,284,3,8,8,3,2,12,0,0,14,35,4,2,0,1,1,0,0,0,0,0,-3538,-40,-5,5,-10,0,-21,2,-1,49.4,4.4,45,4,1,3,0
14763,16239,287,246,4,9,9,4,5,9,1,0,12,16,4,4,0,0,0,1,1,0,0,0,-1476,41,-5,5,-4,0,-4,0,0,151.6,35,116.6,4,3,1,0
16289,16124,260,232,9,8,8,9,6,7,0,0,15,14,1,1,1,1,0,1,0,0,0,0,165,28,1,-1,-1,0,1,0,0,45.4,44.4,1,5,4,1,0
13105,18358,212,287,3,13,13,3,2,9,0,0,22,174,0,2,0,1,0,1,0,0,0,0,-5253,-75,-10,10,-7,0,-152,-2,-1,55,70.6,-15.6,4,4,0,0
16541,15941,260,238,9,8,8,9,14,11,0,0,14,17,3,2,0,1,1,0,0,0,0,0,600,22,1,-1,3,0,-3,1,-1,67.2,109.2,-42,5,3,2,0
16209,15599,244,266,8,7,7,8,12,5,1,0,18,38,2,5,1,0,1,0,1,0,0,0,610,-22,1,-1,7,0,-20,-3,1,32.2,49.2,-17,4,2,2,1
2505,2515,0,0,0,0,0,0,0,0,0,0,2,1,0,0,0,0,0,0,0,0,0,0,-10,0,0,0,0,0,1,0,0,112.8,35.4,77.4,5,2,3,1
14924,17166,265,243,4,10,10,4,4,14,0,0,66,12,3,2,0,1,1,0,0,0,0,0,-2242,22,-6,6,-10,0,54,1,-1,72,75.4,-3.4,4,3,1,0
18122,13935,266,196,9,5,5,9,11,5,0,0,12,16,5,2,2,0,1,0,0,0,0,0,4187,70,4,-4,6,0,-4,3,2,20.4,19,1.4,3,2,1,1
14403,20436,223,294,6,14,14,6,6,20,0,1,10,13,1,1,0,2,0,1,0,1,0,0,-6033,-71,-8,8,-14,0,-3,0,-2,11.8,30.6,-18.8,3,3,0,0
14968,15259,259,260,5,5,6,5,6,7,0,1,15,18,8,1,1,0,1,0,0,1,0,0,-291,-1,0,1,-1,0,-3,7,1,37.2,23,14.2,5,4,1,1
14361,14959,234,284,5,4,4,5,5,5,1,0,16,22,5,2,0,0,1,0,1,0,0,0,-598,-50,1,-1,0,0,-6,3,0,27.4,27.4,0,3,3,0,0
14105,16718,226,281,4,8,8,4,6,9,0,0,18,22,5,6,0,0,1,0,0,0,0,0,-2613,-55,-4,4,-3,0,-4,-1,0,26,96.2,-70.2,3,3,0,0
15871,15088,270,247,8,8,8,8,3,4,0,1,13,17,2,1,0,0,0,1,0,1,0,0,783,23,0,0,-1,0,-4,1,0,32.6,54.6,-22,5,4,1,0
15943,14344,296,260,6,4,4,6,8,4,0,0,14,13,2,2,1,0,1,0,0,0,0,0,1599,36,2,-2,4,0,1,0,1,70,23.8,46.2,3,3,0,1
13754,13685,284,290,1,1,1,1,1,0,0,1,19,16,1,6,0,0,1,0,0,1,0,0,69,-6,0,0,1,0,3,-5,0,20.8,95.6,-74.8,5,5,0,1
13848,16067,259,292,2,4,4,2,2,9,0,0,25,20,3,2,1,1,0,1,0,0,0,0,-2219,-33,-2,2,-7,0,5,1,0,23.8,49.6,-25.8,2,4,-2,0
14530,13900,262,272,3,2,2,3,5,2,0,0,33,18,5,2,1,0,0,1,0,0,0,0,630,-10,1,-1,3,0,15,3,1,5.8,36.2,-30.4,2,4,-2,0
16023,14473,272,285,6,3,3,6,8,2,1,0,18,14,3,7,1,0,0,1,1,0,0,0,1550,-13,3,-3,6,0,4,-4,1,60,70.2,-10.2,3,4,-1,1
15605,17019,271,263,5,11,11,5,2,11,0,1,17,15,5,4,3,2,0,1,0,1,0,0,-1414,8,-6,6,-9,0,2,1,1,99.8,13.4,86.4,5,4,1,0
15943,14584,263,274,7,3,3,7,7,1,0,0,16,39,6,2,0,1,1,0,0,0,0,0,1359,-11,4,-4,6,0,-23,4,-1,42.4,15.4,27,5,3,2,1
16416,16699,281,274,5,7,7,5,9,10,0,1,13,18,6,2,0,3,1,0,0,1,0,0,-283,7,-2,2,-1,0,-5,4,-3,72,52.4,19.6,5,5,0,1
16447,17157,240,266,8,9,9,8,14,11,0,0,20,17,2,5,1,1,0,1,0,0,0,0,-710,-26,-1,1,3,0,3,-3,0,30.6,65,-34.4,3,5,-2,1
17300,13829,295,247,10,3,3,10,3,4,0,1,35,9,3,6,2,0,1,0,0,1,0,0,3471,48,7,-7,-1,0,26,-3,2,55,29.8,25.2,5,4,1,1
15123,15931,248,252,5,6,6,5,7,8,0,0,18,14,1,4,2,0,1,0,0,0,0,0,-808,-4,-1,1,-1,0,4,-3,2,60.8,33.8,27,5,3,2,1
14510,14159,285,262,2,3,3,2,3,2,0,0,19,13,3,5,2,0,0,1,0,0,0,0,351,23,-1,1,1,0,6,-2,2,39.8,51.6,-11.8,4,5,-1,1
15066,16238,249,269,5,9,9,5,5,7,0,1,38,11,1,4,0,0,0,1,0,1,0,0,-1172,-20,-4,4,-2,0,27,-3,0,30,20.8,9.2,2,2,0,0
13847,15755,263,268,2,6,6,2,2,5,0,0,18,15,4,5,0,1,0,1,0,0,0,0,-1908,-5,-4,4,-3,0,3,-1,-1,14.6,11.2,3.4,2,5,-3,1
15772,14350,271,252,5,4,4,5,7,5,0,1,18,44,4,4,2,0,1,0,0,1,0,0,1422,19,1,-1,2,0,-26,0,2,38.4,119.8,-81.4,4,4,0,1
14196,17852,272,290,3,10,10,4,2,16,0,0,18,15,4,5,0,0,0,1,0,0,0,0,-3656,-18,-7,6,-14,0,3,-1,0,52.6,39.8,12.8,5,3,2,0
14695,16081,258,257,5,8,8,5,6,5,0,0,17,25,2,2,0,0,0,1,0,0,0,0,-1386,1,-3,3,1,0,-8,0,0,12.8,56.6,-43.8,5,4,1,0
18268,15864,266,265,12,6,6,12,10,7,0,0,18,14,2,5,0,0,1,0,0,0,0,0,2404,1,6,-6,3,0,4,-3,0,39.6,119.8,-80.2,4,5,-1,1
17561,13613,280,214,10,4,4,10,9,6,1,0,14,38,3,2,0,0,0,1,1,0,0,0,3948,66,6,-6,3,0,-24,1,0,21.4,7.8,13.6,4,1,3,1
15430,15904,273,302,5,6,6,5,5,4,0,1,16,106,2,5,0,0,0,1,0,1,0,0,-474,-29,-1,1,1,0,-90,-3,0,30,20.8,9.2,3,4,-1,0
15947,14381,242,274,8,4,4,8,12,1,0,1,15,12,1,1,0,0,0,1,0,1,0,0,1566,-32,4,-4,11,0,3,0,0,33,16.2,16.8,3,3,0,1
15300,16437,249,258,6,8,8,6,5,14,0,0,25,18,4,5,1,0,1,0,0,0,0,0,-1137,-9,-2,2,-9,0,7,-1,1,24.2,16.8,7.4,3,5,-2,0
2567,2546,1,0,0,0,0,0,0,0,0,0,3,3,0,0,0,0,0,0,0,0,0,0,21,1,0,0,0,0,0,0,0,63.4,65.6,-2.2,4,3,1,0
14575,13819,283,266,3,2,2,3,2,1,0,0,16,15,3,1,0,0,1,0,0,0,0,0,756,17,1,-1,1,0,1,2,0,27.6,10,17.6,5,1,4,1
14804,14462,277,286,4,2,2,4,3,2,0,0,16,17,3,3,0,0,1,0,0,0,0,0,342,-9,2,-2,1,0,-1,0,0,49,12.8,36.2,3,4,-1,1
15326,13260,287,284,5,1,1,5,4,0,1,0,12,16,2,1,0,0,0,1,1,0,0,0,2066,3,4,-4,4,0,-4,1,0,11.4,16.8,-5.4,4,3,1,1
17031,15351,254,278,10,4,4,10,12,4,0,0,18,15,5,0,2,2,1,0,0,0,0,0,1680,-24,6,-6,8,0,3,5,0,12.4,5.6,6.8,2,2,0,1
15335,16817,267,265,5,7,7,5,3,11,0,1,14,18,2,2,1,1,0,1,0,1,0,0,-1482,2,-2,2,-8,0,-4,0,0,84.2,11.2,73,4,3,1,1
14872,15311,251,221,5,7,7,5,5,10,0,0,19,16,1,1,1,0,0,1,0,0,0,0,-439,30,-2,2,-5,0,3,0,1,9.2,30.4,-21.2,2,3,-1,1
19052,17152,261,287,13,8,8,13,16,11,0,1,10,16,4,1,0,0,0,1,0,1,0,0,1900,-26,5,-5,5,0,-6,3,0,43.2,21.8,21.4,3,4,-1,0
17391,14429,296,252,8,4,4,8,9,3,0,1,21,23,5,4,0,0,1,0,0,1,0,0,2962,44,4,-4,6,0,-2,1,0,22,9.8,12.2,5,2,3,0
16018,15712,244,255,6,8,8,6,9,10,0,0,11,33,4,1,0,0,0,1,0,0,0,0,306,-11,-2,2,-1,0,-22,3,0,7.2,8,-0.8,2,2,0,0
15860,16416,237,291,8,7,7,8,7,7,0,0,15,89,2,0,0,2,0,1,0,0,0,0,-556,-54,1,-1,0,0,-74,2,-2,61.4,14.8,46.6,4,3,1,0
16074,17449,254,266,8,11,11,8,11,16,0,1,15,16,4,3,1,1,0,1,0,1,0,0,-1375,-12,-3,3,-5,0,-1,1,0,21,15.6,5.4,4,4,0,0
13509,13741,237,223,3,3,3,3,3,4,0,1,25,35,2,2,1,0,1,0,0,1,0,0,-232,14,0,0,-1,0,-10,0,1,13,72.6,-59.6,5,5,0,0
13578,15113,276,308,1,4,4,1,1,1,0,1,15,11,3,2,1,1,0,1,0,1,0,0,-1535,-32,-3,3,0,0,4,1,0,45.4,35.8,9.6,4,4,0,0
16569,15640,291,247,6,7,7,6,7,10,0,0,18,16,4,0,3,1,1,0,0,0,0,0,929,44,-1,1,-3,0,2,4,2,20.6,29.2,-8.6,4,4,0,0
14720,14608,277,266,3,4,4,3,3,4,0,0,17,35,3,2,0,1,1,0,0,0,0,0,112,11,-1,1,-1,0,-18,1,-1,57.8,21,36.8,3,5,-2,1
15908,13668,264,247,7,2,2,7,7,3,0,0,13,15,3,0,1,0,1,0,0,0,0,0,2240,17,5,-5,4,0,-2,3,1,23.4,74.2,-50.8,2,4,-2,1
13836,17075,257,247,3,10,11,3,1,8,0,0,14,17,1,2,0,3,0,1,0,0,0,0,-3239,10,-7,8,-7,0,-3,-1,-3,37.6,28.8,8.8,4,5,-1,0
15566,15043,282,264,5,5,5,5,5,5,0,1,16,17,3,4,0,0,0,1,0,1,0,0,523,18,0,0,0,0,-1,-1,0,35.4,44.6,-9.2,3,5,-2,1
15919,14911,268,249,7,5,5,7,8,4,1,0,14,20,6,2,0,0,0,1,1,0,0,0,1008,19,2,-2,4,0,-6,4,0,17.2,6.2,11,4,2,2,1
13587,16712,235,274,3,9,9,3,2,3,0,1,15,18,5,2,0,3,0,1,0,1,0,0,-3125,-39,-6,6,-1,0,-3,3,-3,15.6,31.8,-16.2,4,4,0,1
13430,18599,240,290,2,14,14,2,3,10,0,1,33,17,4,3,0,3,0,1,0,1,0,0,-5169,-50,-12,12,-7,0,16,1,-3,67.4,29,38.4,4,4,0,0
16459,15813,244,238,11,6,6,11,6,12,0,0,16,19,3,2,1,1,1,0,0,0,0,0,646,6,5,-5,-6,0,-3,1,0,24.8,23.4,1.4,3,2,1,1
14990,14589,250,260,6,5,5,6,5,3,0,0,15,12,1,3,1,0,0,1,0,0,0,0,401,-10,1,-1,2,0,3,-2,1,60.8,25.2,35.6,3,4,-1,0
17646,15888,275,266,10,6,6,10,11,7,0,0,14,12,3,1,2,2,1,0,0,0,0,0,1758,9,4,-4,4,0,2,2,0,76.2,44.6,31.6,5,4,1,1
14578,14252,272,269,3,3,3,3,6,4,0,1,17,47,1,4,0,0,0,1,0,1,0,0,326,3,0,0,2,0,-30,-3,0,12.2,31,-18.8,2,3,-1,1
14471,18247,269,275,3,13,13,3,4,18,0,0,14,13,2,5,2,1,0,1,0,0,0,0,-3776,-6,-10,10,-14,0,1,-3,1,17.8,17.6,0.2,3,4,-1,0
17059,16065,227,250,12,9,9,12,11,8,0,0,13,20,3,2,1,0,0,1,0,0,0,0,994,-23,3,-3,3,0,-7,1,1,12.8,20.4,-7.6,4,3,1,0
13203,13893,221,236,3,4,4,3,1,2,0,1,14,14,3,4,0,1,0,1,0,1,0,0,-690,-15,-1,1,-1,0,0,-1,-1,51,92.8,-41.8,3,5,-2,0
14258,15713,214,244,4,9,9,4,5,12,0,1,15,16,3,2,0,0,0,1,0,1,0,0,-1455,-30,-5,5,-7,0,-1,1,0,24.4,76.4,-52,5,4,1,1
18387,16326,269,246,12,9,9,12,10,8,0,1,11,16,2,1,3,1,1,0,0,1,0,0,2061,23,3,-3,2,0,-5,1,2,13.6,18.8,-5.2,2,5,-3,0
15025,13983,261,252,5,3,3,5,6,4,0,0,15,18,5,6,2,0,1,0,0,0,0,0,1042,9,2,-2,2,0,-3,-1,2,13.2,13.4,-0.2,3,4,-1,0
14164,17244,244,281,4,8,8,4,4,11,0,1,18,35,1,7,0,1,0,1,0,1,0,0,-3080,-37,-4,4,-7,0,-17,-6,-1,68.8,28.6,40.2,5,4,1,0
15993,16753,220,258,10,9,9,10,12,9,0,0,32,13,3,5,0,0,1,0,0,0,0,0,-760,-38,1,-1,3,0,19,-2,0,33.8,7.6,26.2,3,2,1,0
16318,16185,242,252,8,8,8,8,11,7,0,0,15,13,4,3,0,2,0,1,0,0,0,0,133,-10,0,0,4,0,2,1,-2,37.8,30,7.8,2,2,0,0
14797,15030,288,285,3,4,4,3,3,4,0,1,15,12,2,1,0,0,0,1,0,1,0,0,-233,3,-1,1,-1,0,3,1,0,18.8,9.6,9.2,3,4,-1,1
15111,14970,253,229,6,6,6,6,3,6,1,0,16,30,3,3,1,0,1,0,1,0,0,0,141,24,0,0,-3,0,-14,0,1,24.8,35.6,-10.8,2,3,-1,1
15159,16115,277,280,5,8,8,5,5,7,0,1,14,16,2,3,0,1,1,0,0,1,0,0,-956,-3,-3,3,-2,0,-2,-1,-1,24.4,28.6,-4.2,4,5,-1,0
15477,15101,236,265,6,5,5,6,17,6,1,0,13,13,0,4,1,1,0,1,1,0,0,0,376,-29,1,-1,11,0,0,-4,0,32.6,24.4,8.2,4,2,2,1
14333,15582,250,282,4,6,7,4,5,5,0,1,17,23,1,2,0,0,0,1,0,1,0,0,-1249,-32,-2,3,0,0,-6,-1,0,7.2,12,-4.8,2,3,-1,0
15227,16174,233,273,6,8,8,6,8,6,0,0,14,15,6,2,1,0,0,1,0,0,0,0,-947,-40,-2,2,2,0,-1,4,1,64.4,32.4,32,4,4,0,0
14504,16128,245,290,5,5,5,5,7,9,1,0,50,14,2,5,0,2,1,0,1,0,0,0,-1624,-45,0,0,-2,0,36,-3,-2,129.4,17.6,111.8,4,2,2,0
15874,14758,242,221,7,5,5,7,10,5,0,0,30,15,5,1,0,1,1,0,0,0,0,0,1116,21,2,-2,5,0,15,4,-1,42.8,14.4,28.4,4,4,0,0
15040,16337,263,277,5,6,6,7,5,7,0,0,54,16,6,2,1,2,1,0,0,0,0,0,-1297,-14,-1,-1,-2,0,38,4,-1,22.6,21.8,0.8,4,3,1,1
17706,17037,226,258,13,9,9,13,12,5,1,0,16,15,1,4,0,0,1,0,1,0,0,0,669,-32,4,-4,7,0,1,-3,0,72,13.4,58.6,4,5,-1,0
15005,13440,238,268,7,1,1,7,10,0,0,0,50,111,6,3,0,0,1,0,0,0,0,0,1565,-30,6,-6,10,0,-61,3,0,160.4,61,99.4,4,4,0,1
13902,14909,310,293,1,3,3,1,0,6,1,0,13,109,2,0,0,1,0,1,1,0,0,0,-1007,17,-2,2,-6,0,-96,2,-1,54.8,11,43.8,5,4,1,0
15864,16172,257,245,6,6,6,6,7,16,1,0,14,14,3,4,2,1,1,0,1,0,0,0,-308,12,0,0,-9,0,0,-1,1,18.4,91.8,-73.4,3,5,-2,1
16775,13440,327,275,5,1,1,5,7,1,0,0,20,12,5,5,3,0,1,0,0,0,0,0,3335,52,4,-4,6,0,8,0,3,114,49.4,64.6,4,5,-1,1
16345,17428,241,254,8,10,10,8,10,13,0,1,16,16,2,4,0,1,0,1,0,1,0,0,-1083,-13,-2,2,-3,0,0,-2,-1,29.2,60.2,-31,3,3,0,1
14883,12848,271,242,5,1,1,5,4,0,0,0,76,33,2,2,0,0,1,0,0,0,0,0,2035,29,4,-4,4,0,43,0,0,98.6,13.6,85,2,3,-1,0
14662,13907,279,215,3,5,6,3,3,4,1,0,15,20,6,2,2,0,0,1,1,0,0,0,755,64,-2,3,-1,0,-5,4,2,22.2,17.2,5,5,3,2,1
17924,16701,226,270,14,8,8,14,16,7,0,0,19,16,1,4,1,2,0,1,0,0,0,0,1223,-44,6,-6,9,0,3,-3,-1,43,27.2,15.8,3,5,-2,1
16117,15637,282,269,5,6,6,5,7,7,1,0,17,116,8,6,0,1,0,1,1,0,0,0,480,13,-1,1,0,0,-99,2,-1,50.2,88.2,-38,4,5,-1,1
15181,14358,296,265,4,3,3,5,3,2,0,0,35,16,2,1,1,1,1,0,0,0,0,0,823,31,1,-2,1,0,19,1,0,90.8,21.6,69.2,5,3,2,0
14487,15080,275,259,3,5,5,3,3,8,0,1,14,18,2,3,1,0,1,0,0,1,0,0,-593,16,-2,2,-5,0,-4,-1,1,41.2,127.6,-86.4,4,3,1,1
17238,14970,272,257,8,5,5,8,10,5,0,0,11,97,1,1,0,0,0,1,0,0,0,0,2268,15,3,-3,5,0,-86,0,0,16.8,19.2,-2.4,4,4,0,1
14629,17859,236,223,4,12,12,4,9,14,0,0,16,15,2,3,1,3,0,1,0,0,0,0,-3230,13,-8,8,-5,0,1,-1,-2,12.4,118.4,-106,4,3,1,0
16377,15378,275,233,7,6,6,7,5,12,0,0,15,46,4,3,1,0,0,1,0,0,0,0,999,42,1,-1,-7,0,-31,1,1,45,76.2,-31.2,4,2,2,1
16562,13433,257,267,9,1,1,9,10,0,1,0,20,21,4,3,2,0,1,0,1,0,0,0,3129,-10,8,-8,10,0,-1,1,2,12.6,12.2,0.4,4,2,2,1
16506,15453,254,268,7,6,6,7,11,7,1,0,15,16,5,3,0,0,1,0,1,0,0,0,1053,-14,1,-1,4,0,-1,2,0,78.4,36.2,42.2,5,4,1,1
17220,17656,225,289,11,10,10,11,23,14,0,0,45,19,4,4,0,1,1,0,0,0,0,0,-436,-64,1,-1,9,0,26,0,-1,17,20.6,-3.6,4,5,-1,0
17988,17002,265,247,11,9,9,11,19,9,1,0,27,14,2,4,3,0,0,1,1,0,0,0,986,18,2,-2,10,0,13,-2,3,22.6,25.6,-3,5,3,2,0
14168,15813,228,275,4,6,6,4,4,4,0,0,13,13,0,2,0,2,0,1,0,0,0,0,-1645,-47,-2,2,0,0,0,-2,-2,30.8,7.4,23.4,4,4,0,1
15363,13796,257,239,6,3,3,6,5,3,0,0,42,18,4,3,0,1,1,0,0,0,0,0,1567,18,3,-3,2,0,24,1,-1,39.6,60.2,-20.6,2,5,-3,0
15121,16625,259,274,4,8,8,4,6,8,0,0,13,26,3,2,1,0,1,0,0,0,0,0,-1504,-15,-4,4,-2,0,-13,1,1,34.4,82.8,-48.4,3,3,0,1
15844,14878,269,282,5,4,4,6,5,3,0,0,15,15,5,2,2,0,1,0,0,0,0,0,966,-13,1,-2,2,0,0,3,2,4.4,53.4,-49,1,4,-3,1
15563,17017,210,234,7,11,11,7,9,14,0,0,16,17,0,5,1,0,0,1,0,0,0,0,-1454,-24,-4,4,-5,0,-1,-5,1,20.6,108,-87.4,3,4,-1,1
15580,14934,271,255,6,5,5,6,6,4,1,0,15,38,7,2,0,1,1,0,1,0,0,0,646,16,1,-1,2,0,-23,5,-1,39,62.6,-23.6,5,4,1,1
13247,15398,245,273,2,5,5,2,4,8,1,0,19,17,4,3,0,2,1,0,1,0,0,0,-2151,-28,-3,3,-4,0,2,1,-2,25.2,33.6,-8.4,2,4,-2,0
14657,16974,245,266,4,9,9,4,5,11,0,1,14,15,4,4,0,3,0,1,0,1,0,0,-2317,-21,-5,5,-6,0,-1,0,-3,46.6,101.4,-54.8,5,3,2,0
16205,16949,266,241,7,11,11,8,8,9,0,0,21,17,3,7,0,0,1,0,0,0,0,0,-744,25,-4,3,-1,0,4,-4,0,35.4,15.6,19.8,2,4,-2,1
15519,15079,261,284,6,4,5,6,8,5,0,0,15,14,5,3,1,1,0,1,0,0,0,0,440,-23,2,-1,3,0,1,2,0,92.2,22,70.2,3,3,0,0
16057,17130,249,247,7,10,10,7,9,17,0,1,34,13,3,2,4,0,0,1,0,1,0,0,-1073,2,-3,3,-8,0,21,1,4,45.6,108.4,-62.8,3,2,1,0
16533,13992,249,254,9,3,3,9,10,2,0,0,22,16,5,2,3,1,1,0,0,0,0,0,2541,-5,6,-6,8,0,6,3,2,24.4,9.8,14.6,5,4,1,0
15172,15662,286,281,4,4,4,4,5,7,0,0,18,18,2,4,0,0,0,1,0,0,0,0,-490,5,0,0,-2,0,0,-2,0,14.6,26.6,-12,2,4,-2,0
17946,16186,250,256,12,6,6,12,18,10,0,0,103,21,6,1,2,1,0,1,0,0,0,0,1760,-6,6,-6,8,0,82,5,1,73.2,58,15.2,4,5,-1,1
15312,13132,262,237,6,2,2,7,10,1,0,0,17,17,3,5,0,0,0,1,0,0,0,0,2180,25,4,-5,9,0,0,-2,0,28.8,25,3.8,5,3,2,1
14849,16742,276,271,5,8,8,5,2,9,0,0,18,16,3,4,0,0,1,0,0,0,0,0,-1893,5,-3,3,-7,0,2,-1,0,28.4,50.4,-22,4,4,0,1
13783,15978,287,266,1,8,8,1,2,6,0,0,13,16,5,1,0,0,0,1,0,0,0,0,-2195,21,-7,7,-4,0,-3,4,0,57.8,24.8,33,4,2,2,1
15854,14830,306,269,5,3,3,5,2,3,0,1,16,17,1,4,1,0,1,0,0,1,0,0,1024,37,2,-2,-1,0,-1,-3,1,10.4,15.2,-4.8,3,3,0,1
16937,14474,284,272,8,3,3,8,6,1,1,0,18,17,3,4,4,1,1,0,1,0,0,0,2463,12,5,-5,5,0,1,-1,3,16.4,9.4,7,5,2,3,1
17024,14680,256,241,9,4,4,9,16,4,0,0,16,17,4,1,1,1,1,0,0,0,0,0,2344,15,5,-5,12,0,-1,3,0,111.8,115.2,-3.4,5,5,0,1
15411,17361,273,258,4,11,11,4,5,9,0,1,13,17,2,6,0,0,1,0,0,1,0,0,-1950,15,-7,7,-4,0,-4,-4,0,10,43.8,-33.8,4,3,1,0
15978,16114,241,257,7,8,8,7,12,9,0,1,115,17,0,4,0,0,1,0,0,1,0,0,-136,-16,-1,1,3,0,98,-4,0,76.2,46.2,30,3,4,-1,1
16259,13755,264,263,8,2,2,8,7,3,0,0,30,16,4,5,1,0,1,0,0,0,0,0,2504,1,6,-6,4,0,14,-1,1,45.8,76.8,-31,4,2,2,1
15356,16067,289,254,4,7,7,4,2,9,0,0,34,17,6,2,0,1,0,1,0,0,0,0,-711,35,-3,3,-7,0,17,4,-1,12.4,11,1.4,3,3,0,1
15901,14134,287,252,5,3,3,5,6,4,0,0,23,13,2,2,1,0,1,0,0,0,0,0,1767,35,2,-2,2,0,10,0,1,5.6,25.8,-20.2,1,5,-4,0
14038,15115,245,250,4,6,6,4,0,5,0,0,25,16,4,2,0,1,1,0,0,0,0,0,-1077,-5,-2,2,-5,0,9,2,-1,171.4,13,158.4,5,4,1,0
13274,15145,247,319,2,3,3,2,4,1,0,1,35,19,5,4,0,0,1,0,0,1,0,0,-1871,-72,-1,1,3,0,16,1,0,31,22.4,8.6,4,2,2,0
16704,15407,273,272,9,5,6,9,11,6,1,0,33,14,2,0,1,1,0,1,1,0,0,0,1297,1,4,-3,5,0,19,2,0,14.2,62.6,-48.4,2,5,-3,1
16088,16241,274,263,5,6,6,5,4,6,0,1,15,16,5,0,1,1,0,1,0,1,0,0,-153,11,-1,1,-2,0,-1,5,0,22,56.2,-34.2,4,4,0,1
19427,13250,277,259,16,1,1,16,12,0,1,0,19,36,5,3,3,0,1,0,1,0,0,0,6177,18,15,-15,12,0,-17,2,3,21.8,49.4,-27.6,3,3,0,1
14401,15561,275,266,3,5,5,3,3,9,0,0,15,18,4,3,0,0,1,0,0,0,0,0,-1160,9,-2,2,-6,0,-3,1,0,37.2,26.8,10.4,5,4,1,1
17886,14796,282,225,10,5,5,10,7,10,0,0,210,14,3,4,1,0,1,0,0,0,0,0,3090,57,5,-5,-3,0,196,-1,1,13,7.8,5.2,3,5,-2,1
15779,16286,217,245,8,9,9,8,7,7,0,1,9,14,1,1,0,1,0,1,0,1,0,0,-507,-28,-1,1,0,0,-5,0,-1,58.8,52.2,6.6,4,5,-1,0
18046,14104,281,168,10,6,6,10,6,8,0,0,112,17,3,2,4,0,0,1,0,0,0,0,3942,113,4,-4,-2,0,95,1,4,12.8,56,-43.2,4,3,1,1
14654,14939,279,298,4,3,3,4,7,2,0,1,15,109,6,4,0,1,1,0,0,1,0,0,-285,-19,1,-1,5,0,-94,2,-1,19,13.6,5.4,2,4,-2,0
16729,15075,262,280,9,5,5,9,7,6,0,0,36,17,5,7,0,0,0,1,0,0,0,0,1654,-18,4,-4,1,0,19,-2,0,9.2,53,-43.8,2,5,-3,1
15949,14386,249,258,7,4,4,8,8,3,0,0,14,18,4,3,2,0,0,1,0,0,0,0,1563,-9,3,-4,5,0,-4,1,2,68.6,84.4,-15.8,4,4,0,1
17980,14768,258,244,12,4,4,12,16,7,0,0,17,18,3,6,0,0,0,1,0,0,0,0,3212,14,8,-8,9,0,-1,-3,0,94.8,9,85.8,4,3,1,0
17046,13339,266,250,9,2,2,9,9,1,0,1,117,14,2,4,1,0,0,1,0,1,0,0,3707,16,7,-7,8,0,103,-2,1,15.8,23.6,-7.8,2,3,-1,1
15804,15901,293,290,4,5,5,4,3,6,0,0,20,18,5,2,0,2,0,1,0,0,0,0,-97,3,-1,1,-3,0,2,3,-2,23.4,15.4,8,5,4,1,1
16267,15628,265,295,7,4,4,7,9,2,0,0,107,13,3,6,2,0,1,0,0,0,0,0,639,-30,3,-3,7,0,94,-3,2,7.8,11.4,-3.6,2,3,-1,1
14912,15688,269,279,4,5,5,4,7,5,0,0,12,36,4,5,0,1,1,0,0,0,0,0,-776,-10,-1,1,2,0,-24,-1,-1,65.4,7.6,57.8,4,2,2,0
15729,14961,269,273,6,4,4,6,11,9,0,0,17,16,3,1,1,0,0,1,0,0,0,0,768,-4,2,-2,2,0,1,2,1,23,14.8,8.2,4,3,1,0
15709,15225,283,257,5,6,6,5,9,4,0,0,26,14,2,2,0,0,0,1,0,0,0,0,484,26,-1,1,5,0,12,0,0,67.2,61.2,6,5,5,0,1
16685,21319,226,277,10,18,18,11,11,24,0,0,14,12,0,2,0,2,0,1,0,0,0,0,-4634,-51,-8,7,-13,0,2,-2,-2,54,62.6,-8.6,4,5,-1,0
12762,16899,230,272,2,9,9,2,2,6,0,0,16,12,0,3,0,0,1,0,0,0,0,0,-4137,-42,-7,7,-4,0,4,-3,0,15.2,105,-89.8,3,4,-1,0
14304,14850,269,247,2,5,5,2,4,3,0,0,13,39,5,2,0,2,0,1,0,0,0,0,-546,22,-3,3,1,0,-26,3,-2,16.8,25.6,-8.8,3,4,-1,0
17734,14900,220,226,14,5,5,14,14,8,0,0,110,16,1,2,0,2,1,0,0,0,0,0,2834,-6,9,-9,6,0,94,-1,-2,44.8,12.4,32.4,4,4,0,1
13861,16573,253,258,3,8,8,3,3,13,0,0,10,16,4,2,1,3,0,1,0,0,0,0,-2712,-5,-5,5,-10,0,-6,2,-2,41.8,26.8,15,4,3,1,0
18366,15350,243,230,14,7,7,14,11,6,0,0,18,16,6,5,3,0,1,0,0,0,0,0,3016,13,7,-7,5,0,2,1,3,57.2,42,15.2,5,4,1,1
15150,14860,215,244,7,6,7,7,10,6,0,0,18,50,1,1,0,1,0,1,0,0,0,0,290,-29,1,0,4,0,-32,0,-1,30.8,29,1.8,4,4,0,0
15540,13754,260,259,6,2,2,6,9,1,0,0,16,10,2,1,0,0,1,0,0,0,0,0,1786,1,4,-4,8,0,6,1,0,9.4,8.2,1.2,4,3,1,1
18612,16720,231,244,14,9,9,14,28,20,0,0,18,18,3,2,0,0,1,0,0,0,0,0,1892,-13,5,-5,8,0,0,1,0,45.8,63,-17.2,4,2,2,1
16878,15151,235,212,12,6,6,12,6,5,0,0,33,13,0,2,1,1,1,0,0,0,0,0,1727,23,6,-6,1,0,20,-2,0,10.2,22.2,-12,3,5,-2,0
15526,16112,263,249,6,8,8,6,7,9,0,0,19,24,1,2,0,0,0,1,0,0,0,0,-586,14,-2,2,-2,0,-5,-1,0,49,66.4,-17.4,4,5,-1,0
16003,14217,272,234,7,5,5,7,5,3,0,0,44,14,1,1,0,0,1,0,0,0,0,0,1786,38,2,-2,2,0,30,0,0,12.4,25.2,-12.8,4,4,0,1
16173,15932,264,274,7,6,6,7,8,3,0,0,18,113,2,3,2,0,1,0,0,0,0,0,241,-10,1,-1,5,0,-95,-1,2,17,42.4,-25.4,4,5,-1,1
17303,14714,253,269,11,4,4,11,14,2,0,0,15,13,6,1,0,1,1,0,0,0,0,0,2589,-16,7,-7,12,0,2,5,-1,57.4,60.2,-2.8,3,3,0,1
16870,13699,280,246,8,3,3,8,4,1,1,0,15,16,6,3,1,0,0,1,1,0,0,0,3171,34,5,-5,3,0,-1,3,1,23.2,36.6,-13.4,5,4,1,1
14275,15373,228,228,6,6,6,6,3,8,1,0,12,13,2,0,1,0,0,1,1,0,0,0,-1098,0,0,0,-5,0,-1,2,1,169.4,57,112.4,4,3,1,1
14766,16928,242,279,6,9,9,6,4,10,1,0,13,113,4,3,0,0,1,0,1,0,0,0,-2162,-37,-3,3,-6,0,-100,1,0,36.2,19.4,16.8,3,3,0,0
15296,16863,292,294,4,9,9,4,2,6,0,0,15,16,0,3,0,1,0,1,0,0,0,0,-1567,-2,-5,5,-4,0,-1,-3,-1,16.2,35.6,-19.4,1,4,-3,0
16784,15309,270,256,11,6,6,11,7,7,0,0,16,10,2,4,0,0,1,0,0,0,0,0,1475,14,5,-5,0,0,6,-2,0,42.4,4.8,37.6,5,1,4,1
17304,16317,236,260,10,7,7,10,15,9,0,0,33,21,4,2,1,1,1,0,0,0,0,0,987,-24,3,-3,6,0,12,2,0,40,9.8,30.2,5,4,1,1
16313,14337,253,254,7,3,3,7,8,5,0,0,33,17,1,4,2,0,1,0,0,0,0,0,1976,-1,4,-4,3,0,16,-3,2,15.6,15.2,0.4,3,4,-1,1
16447,17022,226,262,8,8,9,8,15,19,0,0,53,35,3,5,0,0,1,0,0,0,0,0,-575,-36,0,1,-4,0,18,-2,0,103.8,12.6,91.2,3,4,-1,1
13805,14245,291,270,0,2,2,0,0,2,0,0,40,21,5,3,1,1,0,1,0,0,0,0,-440,21,-2,2,-2,0,19,2,0,41.2,42.2,-1,4,2,2,1
15055,16200,268,253,6,7,7,6,5,12,0,0,13,15,1,2,0,1,1,0,0,0,0,0,-1145,15,-1,1,-7,0,-2,-1,-1,51.8,44.2,7.6,3,3,0,1
15902,14853,267,257,7,4,4,7,5,5,0,1,19,19,6,5,2,1,1,0,0,1,0,0,1049,10,3,-3,0,0,0,1,1,17.8,67.2,-49.4,4,5,-1,0
14971,18322,218,259,6,12,12,6,7,15,0,0,19,19,2,0,0,1,0,1,0,0,0,0,-3351,-41,-6,6,-8,0,0,2,-1,178,36.6,141.4,3,5,-2,0
16586,14329,262,262,9,4,4,9,9,2,0,0,15,16,3,4,3,0,1,0,0,0,0,0,2257,0,5,-5,7,0,-1,-1,3,33.2,81.4,-48.2,3,3,0,0
16051,15289,255,244,8,6,6,8,8,5,0,0,95,20,4,4,2,0,1,0,0,0,0,0,762,11,2,-2,3,0,75,0,2,15.4,27,-11.6,5,5,0,1
16934,14319,276,251,9,4,4,9,8,4,0,0,16,113,4,1,2,0,0,1,0,0,0,0,2615,25,5,-5,4,0,-97,3,2,19.8,43.4,-23.6,4,4,0,1
15714,13764,235,280,8,1,1,8,10,1,0,0,20,17,2,3,2,2,1,0,0,0,0,0,1950,-45,7,-7,9,0,3,-1,0,45.2,42.4,2.8,3,5,-2,0
14128,17869,233,264,3,12,12,3,4,11,0,0,14,16,2,1,0,1,0,1,0,0,0,0,-3741,-31,-9,9,-7,0,-2,1,-1,4.8,6.4,-1.6,1,3,-2,0
13894,15494,282,272,1,6,6,1,2,3,0,0,16,21,4,1,0,2,0,1,0,0,0,0,-1600,10,-5,5,-1,0,-5,3,-2,15.8,12.2,3.6,3,3,0,1
14798,17531,279,312,3,8,8,3,3,13,0,0,16,103,2,3,0,1,0,1,0,0,0,0,-2733,-33,-5,5,-10,0,-87,-1,-1,72.4,12.8,59.6,3,5,-2,1
16821,15137,260,265,10,5,5,10,11,5,1,0,16,15,1,0,0,0,1,0,1,0,0,0,1684,-5,5,-5,6,0,1,1,0,16.8,7.8,9,4,2,2,1
13343,16720,184,237,5,12,12,5,7,8,0,0,12,15,4,2,1,0,0,1,0,0,0,0,-3377,-53,-7,7,-1,0,-3,2,1,8.6,34.4,-25.8,4,4,0,0
14968,16268,265,288,4,6,6,4,5,8,0,1,17,16,0,5,0,1,0,1,0,1,0,0,-1300,-23,-2,2,-3,0,1,-5,-1,9.4,10.6,-1.2,2,4,-2,1
16937,17565,223,245,10,11,11,10,14,16,0,0,13,14,2,0,1,1,1,0,0,0,0,0,-628,-22,-1,1,-2,0,-1,2,0,42.6,6.8,35.8,4,2,2,1
14352,16396,251,268,3,7,7,4,2,9,0,0,17,104,2,3,1,2,0,1,0,0,0,0,-2044,-17,-4,3,-7,0,-87,-1,-1,90.4,11.8,78.6,4,4,0,0
14545,17534,245,274,3,11,11,3,2,7,0,1,16,106,2,3,1,0,0,1,0,1,0,0,-2989,-29,-8,8,-5,0,-90,-1,1,32.2,86.8,-54.6,5,2,3,0
14137,16757,272,291,3,6,6,3,1,11,0,0,16,152,5,1,1,0,1,0,0,0,0,0,-2620,-19,-3,3,-10,0,-136,4,1,54,53,1,4,5,-1,0
13489,15631,243,244,2,8,8,2,3,16,0,1,16,17,3,4,0,0,0,1,0,1,0,0,-2142,-1,-6,6,-13,0,-1,-1,0,15.4,13.4,2,4,5,-1,0
14333,16385,255,313,4,4,4,4,3,4,0,1,17,110,3,6,0,2,1,0,0,1,0,0,-2052,-58,0,0,-1,0,-93,-3,-2,27.4,11.2,16.2,4,5,-1,0
14001,15518,238,265,4,7,7,4,3,7,0,0,36,15,3,1,0,0,0,1,0,0,0,0,-1517,-27,-3,3,-4,0,21,2,0,114,19,95,4,4,0,0
14608,16011,245,257,3,8,8,4,7,8,0,0,31,52,2,2,1,0,0,1,0,0,0,0,-1403,-12,-5,4,-1,0,-21,0,1,20,14.6,5.4,4,5,-1,0
16059,17353,215,232,10,13,13,10,10,7,0,1,59,15,0,3,2,4,1,0,0,1,0,0,-1294,-17,-3,3,3,0,44,-3,-2,9.8,37.2,-27.4,1,4,-3,0
14281,14570,265,254,3,5,5,3,1,4,0,0,17,18,4,2,2,0,1,0,0,0,0,0,-289,11,-2,2,-3,0,-1,2,2,84.8,14.8,70,5,3,2,1
17732,17841,252,259,10,12,12,10,16,13,0,1,23,17,3,4,1,2,1,0,0,1,0,0,-109,-7,-2,2,3,0,6,-1,-1,133.4,11.8,121.6,3,3,0,0
15837,15898,275,264,7,5,5,7,8,6,1,0,37,37,6,4,0,2,1,0,1,0,0,0,-61,11,2,-2,2,0,0,2,-2,11.8,31.6,-19.8,2,3,-1,0
16664,16299,271,240,7,8,8,7,8,13,0,1,16,18,5,4,5,2,0,1,0,1,0,0,365,31,-1,1,-5,0,-2,1,3,20.6,22.8,-2.2,3,3,0,0
14680,14364,265,261,4,4,4,4,4,2,0,0,12,17,2,2,1,0,1,0,0,0,0,0,316,4,0,0,2,0,-5,0,1,19.2,25.2,-6,4,4,0,0
15524,15745,290,280,5,5,5,5,3,8,0,0,18,51,8,1,0,1,0,1,0,0,0,0,-221,10,0,0,-5,0,-33,7,-1,31.4,12.2,19.2,3,3,0,0
14347,16963,252,257,4,9,9,4,7,12,0,0,16,18,2,3,0,0,1,0,0,0,0,0,-2616,-5,-5,5,-5,0,-2,-1,0,22.8,44.8,-22,4,5,-1,0
15901,17423,258,270,8,9,9,8,6,9,0,0,14,32,2,2,1,1,0,1,0,0,0,0,-1522,-12,-1,1,-3,0,-18,0,0,7,67.8,-60.8,2,5,-3,0
15869,14873,282,295,5,2,2,5,9,2,1,0,20,17,0,1,0,3,1,0,1,0,0,0,996,-13,3,-3,7,0,3,-1,-3,33.8,29.6,4.2,5,3,2,0
13850,15345,277,275,1,4,4,1,3,7,0,0,19,113,0,5,0,1,0,1,0,0,0,0,-1495,2,-3,3,-4,0,-94,-5,-1,11,26,-15,5,3,2,0
13495,15091,240,278,2,4,4,2,3,4,0,0,15,13,1,5,0,1,0,1,0,0,0,0,-1596,-38,-2,2,-1,0,2,-4,-1,6,12.2,-6.2,3,2,1,0
17074,15241,297,239,8,7,7,8,6,7,0,0,15,14,1,3,2,0,1,0,0,0,0,0,1833,58,1,-1,-1,0,1,-2,2,11.8,47.8,-36,4,4,0,1
16094,14664,267,229,7,6,6,7,8,3,0,0,14,14,3,2,0,0,1,0,0,0,0,0,1430,38,1,-1,5,0,0,1,0,16.6,118.2,-101.6,4,5,-1,0
14881,15685,281,211,4,9,9,4,5,8,0,1,175,12,0,4,0,0,0,1,0,1,0,0,-804,70,-5,5,-3,0,163,-4,0,29.4,43.2,-13.8,4,5,-1,0
17513,13584,262,290,11,0,1,11,13,0,0,0,16,17,4,5,1,1,1,0,0,0,0,0,3929,-28,11,-10,13,0,-1,-1,0,10.8,14.8,-4,2,3,-1,1
17108,15673,251,239,10,9,9,11,13,3,0,0,15,125,4,2,0,1,1,0,0,0,0,0,1435,12,1,-2,10,0,-110,2,-1,14.6,12.2,2.4,5,2,3,1
13506,15473,219,271,3,5,5,3,5,8,0,1,14,20,3,5,0,1,0,1,0,1,0,0,-1967,-52,-2,2,-3,0,-6,-2,-1,87,6.6,80.4,3,2,1,0
16969,14187,294,280,7,2,2,7,10,4,0,0,40,14,3,5,1,1,0,1,0,0,0,0,2782,14,5,-5,6,0,26,-2,0,28,18,10,3,4,-1,1
15575,16504,250,276,6,8,8,6,5,12,0,1,17,14,1,9,1,0,1,0,0,1,0,0,-929,-26,-2,2,-7,0,3,-8,1,7.4,7.2,0.2,2,3,-1,0
15369,15597,282,280,5,5,5,5,10,6,0,0,13,15,2,5,0,0,0,1,0,0,0,0,-228,2,0,0,4,0,-2,-3,0,66,33,33,3,4,-1,0
14982,14717,269,261,5,4,4,5,3,4,0,1,32,15,0,6,1,2,1,0,0,1,0,0,265,8,1,-1,-1,0,17,-6,-1,35,14.4,20.6,4,4,0,0
15244,13876,268,261,4,2,2,4,4,1,1,0,42,13,2,2,3,0,1,0,1,0,0,0,1368,7,2,-2,3,0,29,0,3,28.2,17.6,10.6,4,4,0,1
16855,14802,293,259,6,5,5,6,8,5,0,1,121,16,4,2,1,0,0,1,0,1,0,0,2053,34,1,-1,3,0,105,2,1,33.6,92.6,-59,5,3,2,1
15164,15634,288,282,4,5,5,4,2,6,0,0,23,35,4,3,0,1,1,0,0,0,0,0,-470,6,-1,1,-4,0,-12,1,-1,32,13.6,18.4,4,3,1,0
13737,15854,220,277,4,6,6,4,4,6,0,0,14,44,4,4,0,0,0,1,0,0,0,0,-2117,-57,-2,2,-2,0,-30,0,0,15.8,8.8,7,3,4,-1,0
15982,14595,276,267,6,3,3,6,8,4,0,0,17,15,0,0,1,0,0,1,0,0,0,0,1387,9,3,-3,4,0,2,0,1,27.8,74,-46.2,4,5,-1,1
17725,17622,285,265,11,10,10,11,10,10,0,0,18,18,4,7,0,0,1,0,0,0,0,0,103,20,1,-1,0,0,0,-3,0,27.4,34.8,-7.4,4,3,1,0
14207,14862,256,280,3,3,3,3,5,2,0,1,13,34,1,2,1,1,0,1,0,1,0,0,-655,-24,0,0,3,0,-21,-1,0,12.2,15.4,-3.2,3,3,0,0
15378,15847,249,244,7,6,6,7,3,8,0,0,16,21,3,4,1,3,1,0,0,0,0,0,-469,5,1,-1,-5,0,-5,-1,-2,22,22,0,5,3,2,1
16011,15230,295,291,5,5,5,5,9,4,1,0,33,15,4,6,2,0,1,0,1,0,0,0,781,4,0,0,5,0,18,-2,2,77.6,46.2,31.4,5,3,2,0
15632,16272,260,249,7,7,7,7,5,14,0,1,20,21,4,4,0,1,1,0,0,1,0,0,-640,11,0,0,-9,0,-1,0,-1,74.2,42,32.2,4,5,-1,0
16425,15497,246,234,9,6,6,9,8,9,1,0,36,15,2,2,2,1,0,1,1,0,0,0,928,12,3,-3,-1,0,21,0,1,12.4,22.2,-9.8,4,4,0,1
15995,15374,287,295,6,4,4,6,5,6,0,0,19,19,8,3,1,0,1,0,0,0,0,0,621,-8,2,-2,-1,0,0,5,1,52.4,24.6,27.8,3,3,0,0
16612,14120,297,253,7,2,2,7,10,4,0,1,20,17,4,2,0,0,1,0,0,1,0,0,2492,44,5,-5,6,0,3,2,0,13.8,25,-11.2,4,4,0,1
14810,13891,293,250,3,3,3,3,2,3,0,0,19,33,3,3,0,0,0,1,0,0,0,0,919,43,0,0,-1,0,-14,0,0,14.4,33.8,-19.4,3,5,-2,0
15507,13177,271,249,6,2,3,6,10,1,0,0,121,13,2,7,0,0,1,0,0,0,0,0,2330,22,4,-3,9,0,108,-5,0,62,6.2,55.8,5,2,3,1
14538,16290,264,251,5,8,8,5,6,7,0,0,15,15,4,6,0,0,1,0,0,0,0,0,-1752,13,-3,3,-1,0,0,-2,0,14,13.6,0.4,3,3,0,0
14775,17132,240,282,5,9,9,5,2,9,0,0,106,17,1,1,0,1,0,1,0,0,0,0,-2357,-42,-4,4,-7,0,89,0,-1,19.6,16.8,2.8,4,5,-1,0
15378,14715,283,274,5,3,3,5,4,4,0,0,36,16,4,7,1,0,1,0,0,0,0,0,663,9,2,-2,0,0,20,-3,1,22,15.4,6.6,3,5,-2,0
15106,14804,238,247,6,5,5,6,5,8,0,1,15,26,6,2,0,1,1,0,0,1,0,0,302,-9,1,-1,-3,0,-11,4,-1,8.4,20.2,-11.8,3,5,-2,0
15150,14492,294,262,3,4,4,3,2,4,0,1,15,12,1,2,0,0,0,1,0,1,0,0,658,32,-1,1,-2,0,3,-1,0,5.6,82.8,-77.2,2,5,-3,0
15808,15420,276,281,7,4,4,7,6,3,1,0,14,20,2,6,0,2,1,0,1,0,0,0,388,-5,3,-3,3,0,-6,-4,-2,27.4,59.8,-32.4,5,5,0,0
17065,15295,256,286,10,3,3,10,14,2,0,0,19,13,5,0,1,1,1,0,0,0,0,0,1770,-30,7,-7,12,0,6,5,0,22.2,22.2,0,2,5,-3,0
14650,15285,225,275,6,4,4,6,6,4,1,0,34,34,3,2,0,1,1,0,1,0,0,0,-635,-50,2,-2,2,0,0,1,-1,42.2,25,17.2,3,4,-1,1
14556,15193,276,272,3,6,6,3,6,4,0,0,25,11,2,3,0,0,0,1,0,0,0,0,-637,4,-3,3,2,0,14,-1,0,137,31.6,105.4,5,5,0,0
13735,14026,245,265,3,3,4,3,3,3,0,0,12,35,20,2,0,0,1,0,0,0,0,0,-291,-20,0,1,0,0,-23,18,0,14,11,3,3,2,1,1
15168,15380,250,285,6,4,4,6,9,8,0,0,16,21,1,5,0,0,0,1,0,0,0,0,-212,-35,2,-2,1,0,-5,-4,0,13,22.2,-9.2,3,5,-2,1
13650,17861,227,276,4,11,11,4,2,8,0,0,38,107,1,2,0,1,0,1,0,0,0,0,-4211,-49,-7,7,-6,0,-69,-1,-1,19.2,14,5.2,5,3,2,0
15846,15451,264,242,7,7,7,7,8,12,0,0,13,17,1,1,2,0,1,0,0,0,0,0,395,22,0,0,-4,0,-4,0,2,16,8.6,7.4,2,4,-2,0
14241,16943,252,288,4,8,8,4,2,8,0,0,116,28,3,3,0,2,0,1,0,0,0,0,-2702,-36,-4,4,-6,0,88,0,-2,77.2,20,57.2,5,4,1,0
16253,15724,276,251,6,7,7,6,7,8,0,0,20,29,7,4,0,0,0,1,0,0,0,0,529,25,-1,1,-1,0,-9,3,0,8.4,42.2,-33.8,4,3,1,1
15265,14587,297,296,4,2,2,5,5,3,0,0,15,14,2,5,0,1,1,0,0,0,0,0,678,1,2,-3,2,0,1,-3,-1,9,7,2,2,2,0,1
16943,14566,251,256,10,5,5,10,7,4,0,0,16,101,0,2,3,0,0,1,0,0,0,0,2377,-5,5,-5,3,0,-85,-2,3,124.2,20.2,104,5,4,1,1
16458,17740,247,256,7,11,11,7,9,9,0,1,14,20,5,0,1,2,0,1,0,1,0,0,-1282,-9,-4,4,0,0,-6,5,-1,36.4,78.6,-42.2,4,4,0,0
18706,13256,268,250,13,1,1,13,16,1,0,1,20,35,2,2,3,0,1,0,0,1,0,0,5450,18,12,-12,15,0,-15,0,3,74,42.8,31.2,4,4,0,1
13013,16462,201,222,2,12,12,2,3,9,0,0,20,9,2,3,0,2,0,1,0,0,0,0,-3449,-21,-10,10,-6,0,11,-1,-2,6.6,9.4,-2.8,1,2,-1,0
14996,14994,267,279,4,5,5,4,4,4,0,1,19,40,3,1,0,0,0,1,0,1,0,0,2,-12,-1,1,0,0,-21,2,0,30.6,13.2,17.4,4,4,0,0
15747,15440,262,260,6,6,6,6,4,9,0,0,31,18,3,7,2,0,1,0,0,0,0,0,307,2,0,0,-5,0,13,-4,2,100,15,85,3,3,0,0
16667,15211,269,248,8,5,5,8,7,7,0,0,20,16,4,4,1,0,1,0,0,0,0,0,1456,21,3,-3,0,0,4,0,1,15.2,65.2,-50,4,4,0,1
14620,16279,236,252,5,7,7,5,5,7,0,0,144,12,1,5,1,1,0,1,0,0,0,0,-1659,-16,-2,2,-2,0,132,-4,0,9.2,39,-29.8,3,2,1,0
15442,15627,222,271,8,6,6,8,7,7,0,0,17,15,2,2,0,1,1,0,0,0,0,0,-185,-49,2,-2,0,0,2,0,-1,9,13.4,-4.4,3,5,-2,0
16572,16055,263,282,8,5,5,8,11,8,0,0,104,40,2,4,0,1,0,1,0,0,0,0,517,-19,3,-3,3,0,64,-2,-1,38.2,14.6,23.6,4,3,1,1
16473,14248,259,258,10,3,3,10,9,3,0,0,35,15,1,0,1,1,1,0,0,0,0,0,2225,1,7,-7,6,0,20,1,0,12.8,28.4,-15.6,4,4,0,1
16240,14801,266,284,7,2,2,7,7,3,0,0,16,19,2,4,2,0,0,1,0,0,0,0,1439,-18,5,-5,4,0,-3,-2,2,36.4,15.6,20.8,5,3,2,1
14693,13882,280,278,4,2,2,4,4,0,0,0,110,17,5,4,0,1,1,0,0,0,0,0,811,2,2,-2,4,0,93,1,-1,18,19,-1,2,2,0,0
14261,14756,271,286,3,3,3,3,3,5,0,0,27,103,5,2,0,0,1,0,0,0,0,0,-495,-15,0,0,-2,0,-76,3,0,19.6,20.4,-0.8,3,4,-1,0
15139,14352,295,290,4,2,2,4,5,1,0,0,18,16,3,1,1,0,1,0,0,0,0,0,787,5,2,-2,4,0,2,2,1,13.2,21,-7.8,5,4,1,1
14397,15460,242,271,5,5,5,5,2,6,0,0,22,14,1,3,2,1,1,0,0,0,0,0,-1063,-29,0,0,-4,0,8,-2,1,16.8,15.6,1.2,4,2,2,0
15453,16667,259,261,5,8,8,5,6,14,0,0,20,13,0,4,1,1,1,0,0,0,0,0,-1214,-2,-3,3,-8,0,7,-4,0,22.4,13.4,9,5,4,1,1
16713,14588,263,271,10,4,4,10,13,2,1,0,13,15,4,2,0,1,1,0,1,0,0,0,2125,-8,6,-6,11,0,-2,2,-1,25.6,12.2,13.4,4,2,2,1
16903,17313,234,259,9,10,10,9,13,8,0,0,18,17,0,2,0,2,1,0,0,0,0,0,-410,-25,-1,1,5,0,1,-2,-2,15,55.8,-40.8,3,4,-1,0
17263,15403,266,224,8,8,8,8,10,8,0,0,17,16,6,2,1,0,0,1,0,0,0,0,1860,42,0,0,2,0,1,4,1,20.4,12.8,7.6,3,3,0,1
16231,13851,282,297,7,1,1,7,9,2,0,0,17,16,6,4,1,0,1,0,0,0,0,0,2380,-15,6,-6,7,0,1,2,1,58,29,29,4,4,0,0
14513,18415,245,252,5,13,13,5,3,18,1,0,154,143,1,4,0,1,0,1,1,0,0,0,-3902,-7,-8,8,-15,0,11,-3,-1,54.2,57.6,-3.4,4,4,0,0
16512,15456,294,275,6,6,6,6,6,9,0,0,31,15,3,3,2,1,0,1,0,0,0,0,1056,19,0,0,-3,0,16,0,1,14,67.4,-53.4,2,4,-2,1
17759,14134,240,218,15,4,4,15,8,5,0,0,14,12,0,0,0,0,1,0,0,0,0,0,3625,22,11,-11,3,0,2,0,0,51.8,21.8,30,5,4,1,1
14810,16928,252,262,6,9,9,6,5,14,0,1,11,19,1,3,2,2,1,0,0,1,0,0,-2118,-10,-3,3,-9,0,-8,-2,0,11.6,67.2,-55.6,2,4,-2,0
16332,14523,310,292,6,2,2,6,8,4,1,0,19,17,7,3,0,0,0,1,1,0,0,0,1809,18,4,-4,4,0,2,4,0,33.2,10.8,22.4,3,4,-1,1
15784,13543,266,262,6,2,2,6,7,1,0,1,14,16,2,3,0,0,0,1,0,1,0,0,2241,4,4,-4,6,0,-2,-1,0,40.8,22.8,18,3,5,-2,0
15021,13909,271,226,4,4,4,4,5,6,0,0,26,14,0,5,3,0,0,1,0,0,0,0,1112,45,0,0,-1,0,12,-5,3,13.6,22.8,-9.2,3,4,-1,1
14865,17148,248,264,6,9,9,6,4,9,0,0,34,19,6,2,0,2,0,1,0,0,0,0,-2283,-16,-3,3,-5,0,15,4,-2,17.2,19.2,-2,4,3,1,0
15429,13841,274,234,5,4,4,5,3,3,0,0,30,10,4,3,1,0,0,1,0,0,0,0,1588,40,1,-1,0,0,20,1,1,28.6,16.8,11.8,3,5,-2,1
16557,15952,298,273,6,7,7,6,6,4,1,0,19,26,4,5,0,2,0,1,1,0,0,0,605,25,-1,1,2,0,-7,-1,-2,26,27.6,-1.6,5,3,2,1
18568,17679,302,289,10,9,9,10,19,8,0,1,15,35,5,0,1,1,1,0,0,1,0,0,889,13,1,-1,11,0,-20,5,0,16.4,164,-147.6,4,5,-1,1
17648,14562,265,238,11,4,4,11,8,2,0,0,18,12,3,1,1,1,1,0,0,0,0,0,3086,27,7,-7,6,0,6,2,0,72,11.2,60.8,5,3,2,1
15009,15905,264,228,5,8,9,5,8,8,0,0,13,17,2,2,0,0,1,0,0,0,0,0,-896,36,-3,4,0,0,-4,0,0,27.8,57.4,-29.6,3,5,-2,0
14316,14889,275,259,3,5,5,3,3,6,0,1,13,17,3,4,0,0,1,0,0,1,0,0,-573,16,-2,2,-3,0,-4,-1,0,36.8,37.8,-1,4,4,0,0
14253,14680,230,262,4,4,4,4,5,7,0,0,14,14,5,3,0,0,0,1,0,0,0,0,-427,-32,0,0,-2,0,0,2,0,40,12.4,27.6,3,4,-1,0
15476,14425,248,274,6,3,3,6,9,5,0,1,13,19,2,2,0,0,1,0,0,1,0,0,1051,-26,3,-3,4,0,-6,0,0,17.2,20,-2.8,4,5,-1,0
16004,16133,236,209,8,9,9,8,9,13,1,0,17,31,1,2,1,1,0,1,1,0,0,0,-129,27,-1,1,-4,0,-14,-1,0,50.2,49.8,0.4,3,4,-1,0
16823,13681,264,257,10,2,2,10,12,2,0,0,23,221,2,1,2,0,1,0,0,0,0,0,3142,7,8,-8,10,0,-198,1,2,85.6,51.4,34.2,4,5,-1,1
16389,15374,252,243,8,7,7,8,11,5,0,1,15,13,4,2,2,3,0,1,0,1,0,0,1015,9,1,-1,6,0,2,2,-1,11.6,18,-6.4,3,4,-1,1
16763,17216,260,269,8,10,10,8,11,16,0,1,16,27,5,4,0,0,0,1,0,1,0,0,-453,-9,-2,2,-5,0,-11,1,0,30.2,63,-32.8,3,4,-1,1
2719,2619,6,2,0,0,0,0,0,0,0,0,1,3,0,0,0,0,0,0,0,0,0,0,100,4,0,0,0,0,-2,0,0,7.333,33.2,-25.867,2,4,-2,1
14548,17204,197,263,6,14,14,7,9,7,0,0,9,16,4,1,1,2,0,1,0,0,0,0,-2656,-66,-8,7,2,0,-7,3,-1,59.6,35.4,24.2,5,5,0,0
16383,13174,305,256,6,1,1,6,6,2,1,0,17,18,8,3,1,0,1,0,1,0,0,0,3209,49,5,-5,4,0,-1,5,1,16,17.8,-1.8,3,5,-2,1
14899,16142,251,252,5,8,8,5,5,4,0,0,13,30,1,3,1,2,1,0,0,0,0,0,-1243,-1,-3,3,1,0,-17,-2,-1,20,61.4,-41.4,5,4,1,0
15242,14250,229,246,8,3,3,8,9,3,0,0,32,12,2,1,0,1,0,1,0,0,0,0,992,-17,5,-5,6,0,20,1,-1,16,41.8,-25.8,3,5,-2,1
15079,15843,239,243,6,7,7,6,12,11,0,1,14,13,2,3,0,1,0,1,0,1,0,0,-764,-4,-1,1,1,0,1,-1,-1,22.6,72.4,-49.8,3,5,-2,0
14769,15037,278,237,4,6,6,4,3,6,0,0,16,19,2,3,0,0,0,1,0,0,0,0,-268,41,-2,2,-3,0,-3,-1,0,10.4,16.2,-5.8,4,4,0,0
14606,15841,204,285,6,6,6,6,6,4,0,0,13,19,3,2,0,0,1,0,0,0,0,0,-1235,-81,0,0,2,0,-6,1,0,14.4,47.6,-33.2,4,2,2,1
15588,14754,299,270,4,4,4,4,4,3,0,1,16,9,2,3,2,0,0,1,0,1,0,0,834,29,0,0,1,0,7,-1,2,38.6,48.2,-9.6,5,4,1,0
14358,16371,265,248,3,7,7,3,2,13,1,0,16,17,2,7,1,0,0,1,1,0,0,0,-2013,17,-4,4,-11,0,-1,-5,1,32.6,28.4,4.2,3,2,1,0
15949,15692,260,220,5,10,10,5,9,8,0,0,15,15,3,2,2,1,0,1,0,0,0,0,257,40,-5,5,1,0,0,1,1,53.2,30.6,22.6,4,2,2,0
15842,15581,279,260,6,5,5,6,9,8,0,0,15,13,2,3,2,1,1,0,0,0,0,0,261,19,1,-1,1,0,2,-1,1,84,17,67,4,3,1,1
12863,16019,234,264,1,6,6,1,1,6,0,1,11,14,2,2,0,2,0,1,0,1,0,0,-3156,-30,-5,5,-5,0,-3,0,-2,112.4,9.2,103.2,5,3,2,0
14972,14144,253,220,5,4,4,5,4,8,1,0,59,14,3,3,1,0,1,0,1,0,0,0,828,33,1,-1,-4,0,45,0,1,8.6,19.6,-11,2,2,0,1
14229,16081,272,265,2,8,8,2,2,7,0,0,13,14,3,3,1,0,0,1,0,0,0,0,-1852,7,-6,6,-5,0,-1,0,1,7.6,26.2,-18.6,2,4,-2,0
14165,16785,242,269,3,8,8,3,3,8,0,1,14,24,1,3,0,2,0,1,0,1,0,0,-2620,-27,-5,5,-5,0,-10,-2,-2,16.8,51.8,-35,4,4,0,0
13611,17207,224,277,3,8,8,4,5,10,0,1,18,44,5,1,0,0,1,0,0,1,0,0,-3596,-53,-5,4,-5,0,-26,4,0,25.8,70.4,-44.6,2,4,-2,0
15243,14768,253,250,5,5,5,5,9,3,0,0,12,33,5,1,0,1,0,1,0,0,0,0,475,3,0,0,6,0,-21,4,-1,13.6,57.6,-44,2,5,-3,1
2920,2530,0,1,1,0,0,1,3,0,0,0,2,1,0,1,0,0,1,0,0,0,0,0,390,-1,1,-1,3,0,1,-1,0,102.8,62.4,40.4,5,3,2,1
13912,13783,266,262,2,2,2,2,4,2,0,0,16,12,2,2,0,0,0,1,0,0,0,0,129,4,0,0,2,0,4,0,0,14.2,51.6,-37.4,5,4,1,0
16557,17133,256,246,9,8,8,9,7,9,0,1,16,16,2,3,0,2,1,0,0,1,0,0,-576,10,1,-1,-2,0,0,-1,-2,22.2,52,-29.8,4,4,0,1
14872,15039,240,264,5,6,6,5,7,4,0,0,14,15,4,5,1,1,1,0,0,0,0,0,-167,-24,-1,1,3,0,-1,-1,0,19.4,10.4,9,4,3,1,0
16671,15116,244,232,10,6,6,10,9,10,0,0,44,15,2,2,1,0,1,0,0,0,0,0,1555,12,4,-4,-1,0,29,0,1,102.8,15.2,87.6,5,4,1,1
15028,13823,250,265,5,2,2,5,7,1,1,0,17,11,2,2,2,1,1,0,1,0,0,0,1205,-15,3,-3,6,0,6,0,1,27.8,8.8,19,3,2,1,1
15086,14482,257,268,4,3,3,4,5,6,0,1,15,56,1,2,1,0,0,1,0,1,0,0,604,-11,1,-1,-1,0,-41,-1,1,13,9.4,3.6,2,4,-2,1
16181,14729,254,238,8,6,6,8,8,10,0,0,21,38,6,3,2,0,1,0,0,0,0,0,1452,16,2,-2,-2,0,-17,3,2,33.6,87.6,-54,3,4,-1,0
15458,13512,265,243,7,3,3,7,7,2,0,1,21,15,0,3,0,0,1,0,0,1,0,0,1946,22,4,-4,5,0,6,-3,0,77,12.6,64.4,4,4,0,1
14713,15210,298,258,3,5,5,3,0,5,0,0,24,20,7,5,1,0,1,0,0,0,0,0,-497,40,-2,2,-5,0,4,2,1,30.2,58.2,-28,5,4,1,1
15992,13967,236,251,9,3,3,9,12,2,1,0,23,21,2,4,0,2,0,1,1,0,0,0,2025,-15,6,-6,10,0,2,-2,-2,115,26.4,88.6,4,2,2,1
17743,13269,290,254,10,1,1,10,19,2,0,0,15,37,5,2,2,0,1,0,0,0,0,0,4474,36,9,-9,17,0,-22,3,2,38.2,34.4,3.8,5,3,2,1
14141,16069,274,247,2,9,9,2,4,8,0,1,24,14,3,6,0,1,0,1,0,1,0,0,-1928,27,-7,7,-4,0,10,-3,-1,17.2,26.8,-9.6,4,4,0,0
17041,16632,242,245,12,9,9,13,8,9,0,0,9,17,3,0,2,0,0,1,0,0,0,0,409,-3,3,-4,-1,0,-8,3,2,84.4,9.6,74.8,4,4,0,1
15559,14783,259,234,6,6,6,6,5,6,0,0,17,14,0,3,1,0,0,1,0,0,0,0,776,25,0,0,-1,0,3,-3,1,12,17,-5,3,3,0,1
15025,16177,282,281,3,8,8,3,3,4,0,1,18,18,1,0,1,0,1,0,0,1,0,0,-1152,1,-5,5,-1,0,0,1,1,36.6,6.6,30,3,1,2,0
14622,14510,249,262,5,4,4,5,5,2,0,0,16,11,1,2,0,1,0,1,0,0,0,0,112,-13,1,-1,3,0,5,-1,-1,42.8,26.6,16.2,4,3,1,0
15332,17938,231,272,7,10,10,7,9,10,0,0,18,114,3,2,0,3,0,1,0,0,0,0,-2606,-41,-3,3,-1,0,-96,1,-3,5.2,81.8,-76.6,1,3,-2,0
15526,14803,312,294,4,3,3,4,4,3,0,0,18,17,6,6,1,0,0,1,0,0,0,0,723,18,1,-1,1,0,1,0,1,15.2,13.4,1.8,4,3,1,1
15813,15045,248,255,8,6,6,8,9,1,0,1,16,18,2,3,1,4,1,0,0,1,0,0,768,-7,2,-2,8,0,-2,-1,-3,14.6,18.4,-3.8,3,4,-1,1
14293,19872,248,296,5,14,14,6,3,17,1,0,12,19,3,1,0,5,0,1,1,0,0,0,-5579,-48,-9,8,-14,0,-7,2,-5,33.8,26.6,7.2,2,4,-2,0
13754,14488,247,260,2,4,4,2,1,6,0,1,14,22,2,3,1,1,0,1,0,1,0,0,-734,-13,-2,2,-5,0,-8,-1,0,28,86,-58,4,5,-1,0
15373,15133,275,265,6,5,5,6,5,6,0,0,18,16,4,2,2,1,1,0,0,0,0,0,240,10,1,-1,-1,0,2,2,1,8,9.8,-1.8,2,2,0,1
15395,13757,262,263,6,2,2,6,7,2,0,0,16,13,3,5,0,0,0,1,0,0,0,0,1638,-1,4,-4,5,0,3,-2,0,64.6,14.4,50.2,4,4,0,1
14857,14327,266,277,4,3,3,4,8,4,0,1,12,15,4,2,0,0,0,1,0,1,0,0,530,-11,1,-1,4,0,-3,2,0,17.4,25.4,-8,2,4,-2,1
14497,14182,244,263,4,3,3,4,6,4,0,0,14,35,2,1,1,1,1,0,0,0,0,0,315,-19,1,-1,2,0,-21,1,0,46,22,24,4,3,1,1
15247,13841,280,286,4,1,1,4,6,2,0,0,36,16,3,5,1,0,1,0,0,0,0,0,1406,-6,3,-3,4,0,20,-2,1,16.8,7,9.8,4,1,3,1
14700,15704,271,284,3,6,6,3,6,11,0,1,15,14,3,5,0,1,0,1,0,1,0,0,-1004,-13,-3,3,-5,0,1,-2,-1,49.2,104,-54.8,3,4,-1,0
16174,13766,252,225,8,4,4,8,5,3,0,0,22,17,1,0,3,0,1,0,0,0,0,0,2408,27,4,-4,2,0,5,1,3,32.6,4.2,28.4,3,1,2,1
15650,15780,268,281,6,6,6,6,5,10,0,0,16,16,4,2,1,0,0,1,0,0,0,0,-130,-13,0,0,-5,0,0,2,1,88,24,64,4,5,-1,0
16182,13827,270,229,6,4,4,6,5,8,0,1,131,34,3,2,0,0,1,0,0,1,0,0,2355,41,2,-2,-3,0,97,1,0,18,24,-6,4,5,-1,0
13772,14472,293,280,1,3,3,1,0,3,0,0,24,16,5,7,0,0,0,1,0,0,0,0,-700,13,-2,2,-3,0,8,-2,0,20.8,16.4,4.4,4,3,1,1
16409,15230,270,245,8,6,6,8,10,10,0,0,14,15,3,5,0,0,1,0,0,0,0,0,1179,25,2,-2,0,0,-1,-2,0,42.6,44.4,-1.8,4,5,-1,0
15149,15931,242,265,6,6,7,6,6,8,0,0,17,26,3,3,0,0,1,0,0,0,0,0,-782,-23,0,1,-2,0,-9,0,0,64,22.8,41.2,5,4,1,1
14238,13815,301,296,2,1,1,2,1,1,0,1,17,15,3,3,0,0,1,0,0,1,0,0,423,5,1,-1,0,0,2,0,0,10.8,14.2,-3.4,3,4,-1,1
13557,16141,243,244,2,8,8,2,3,15,0,1,15,17,3,2,0,1,1,0,0,1,0,0,-2584,-1,-6,6,-12,0,-2,1,-1,13,35.4,-22.4,4,4,0,0
14505,16105,264,273,3,6,6,3,4,6,1,0,15,36,5,3,0,1,0,1,1,0,0,0,-1600,-9,-3,3,-2,0,-21,2,-1,48.2,20,28.2,4,5,-1,0
15643,14054,283,254,4,3,3,4,3,8,0,1,15,30,2,1,1,0,0,1,0,1,0,0,1589,29,1,-1,-5,0,-15,1,1,72.8,97.2,-24.4,3,5,-2,0
13564,16629,214,272,3,9,9,3,1,6,0,1,9,22,0,1,0,1,0,1,0,1,0,0,-3065,-58,-6,6,-5,0,-13,-1,-1,7,8.2,-1.2,4,3,1,0
14803,13763,286,260,4,3,3,4,2,2,0,0,41,16,4,4,1,0,0,1,0,0,0,0,1040,26,1,-1,0,0,25,0,1,13,23.4,-10.4,4,5,-1,1
15081,16285,214,289,8,6,6,8,12,6,1,0,18,27,4,3,1,1,1,0,1,0,0,0,-1204,-75,2,-2,6,0,-9,1,0,101.4,8.6,92.8,5,3,2,0
14403,14723,319,257,1,5,5,1,1,3,1,0,18,12,2,3,0,0,0,1,1,0,0,0,-320,62,-4,4,-2,0,6,-1,0,29.6,20.2,9.4,2,3,-1,1
15998,14168,288,253,5,3,3,5,9,2,0,1,35,38,3,4,0,1,0,1,0,1,0,0,1830,35,2,-2,7,0,-3,-1,-1,38.4,76.6,-38.2,4,4,0,1
15452,15719,249,247,6,7,7,6,3,10,0,1,86,15,2,7,0,0,0,1,0,1,0,0,-267,2,-1,1,-7,0,71,-5,0,36,96.2,-60.2,4,4,0,0
13374,16222,212,247,4,10,10,4,3,7,0,1,14,16,2,2,1,2,1,0,0,1,0,0,-2848,-35,-6,6,-4,0,-2,0,-1,11.8,81,-69.2,2,3,-1,0
14952,15476,283,268,4,4,4,4,3,7,0,0,19,17,2,4,2,1,1,0,0,0,0,0,-524,15,0,0,-4,0,2,-2,1,18.4,20.2,-1.8,5,5,0,1
16022,15287,226,245,10,6,6,10,11,3,0,0,15,13,2,2,0,2,1,0,0,0,0,0,735,-19,4,-4,8,0,2,0,-2,41,78.8,-37.8,4,4,0,1
16383,14687,270,284,7,3,3,7,8,7,0,0,17,18,5,4,1,0,1,0,0,0,0,0,1696,-14,4,-4,1,0,-1,1,1,69,8.2,60.8,2,2,0,1
15693,13608,283,277,6,1,1,6,5,1,0,0,18,18,3,6,1,0,1,0,0,0,0,0,2085,6,5,-5,4,0,0,-3,1,52.8,9.4,43.4,4,3,1,1
16834,13088,260,238,10,2,2,10,8,2,0,1,15,15,3,5,0,0,1,0,0,1,0,0,3746,22,8,-8,6,0,0,-2,0,54.2,28.4,25.8,5,5,0,1
15962,15328,269,246,7,7,7,7,4,7,0,1,18,12,4,5,1,0,0,1,0,1,0,0,634,23,0,0,-3,0,6,-1,1,24.8,77.4,-52.6,3,4,-1,1
14482,14797,251,258,6,4,4,6,1,6,0,0,16,17,3,3,0,2,1,0,0,0,0,0,-315,-7,2,-2,-5,0,-1,0,-2,34.6,79.8,-45.2,3,4,-1,0
14812,18090,249,240,4,13,13,4,7,17,0,0,20,18,0,4,1,1,0,1,0,0,0,0,-3278,9,-9,9,-10,0,2,-4,0,19.4,35,-15.6,3,4,-1,0
12915,14279,225,272,2,3,3,2,2,2,0,1,16,131,2,5,0,0,1,0,0,1,0,0,-1364,-47,-1,1,0,0,-115,-3,0,37.6,87.2,-49.6,3,4,-1,0
15493,16443,243,291,7,8,8,7,11,5,0,1,13,16,5,2,1,2,0,1,0,1,0,0,-950,-48,-1,1,6,0,-3,3,-1,10.2,28.6,-18.4,3,5,-2,0
15094,16094,257,248,6,9,9,6,5,10,0,0,80,15,2,2,1,0,0,1,0,0,0,0,-1000,9,-3,3,-5,0,65,0,1,27.4,16.4,11,4,4,0,0
16248,14427,242,222,10,6,6,10,8,1,0,0,13,12,3,1,0,1,0,1,0,0,0,0,1821,20,4,-4,7,0,1,2,-1,6.8,71,-64.2,2,3,-1,1
14677,15338,273,269,3,6,6,3,3,6,0,1,21,16,1,5,2,1,0,1,0,1,0,0,-661,4,-3,3,-3,0,5,-4,1,7.6,29,-21.4,3,4,-1,0
15133,16365,277,260,5,8,8,6,4,8,0,1,14,20,3,4,0,0,1,0,0,1,0,0,-1232,17,-3,2,-4,0,-6,-1,0,11,16.4,-5.4,4,4,0,1
16968,17570,239,258,9,11,11,9,13,12,0,1,34,27,2,0,0,1,0,1,0,1,0,0,-602,-19,-2,2,1,0,7,2,-1,34.4,41.6,-7.2,4,5,-1,0
13992,15623,255,280,3,6,6,3,4,3,0,1,15,26,1,4,1,1,0,1,0,1,0,0,-1631,-25,-3,3,1,0,-11,-3,0,42.2,25.6,16.6,3,3,0,0
13977,15699,261,269,2,6,6,2,4,10,0,0,15,15,1,3,1,0,1,0,0,0,0,0,-1722,-8,-4,4,-6,0,0,-2,1,65.4,38,27.4,3,5,-2,0
17001,15874,272,233,10,8,8,10,10,10,1,0,38,35,3,2,1,0,1,0,1,0,0,0,1127,39,2,-2,0,0,3,1,1,27.4,42.6,-15.2,4,3,1,1
15625,15290,266,288,6,4,4,6,4,3,0,1,37,39,2,0,0,1,0,1,0,1,0,0,335,-22,2,-2,1,0,-2,2,-1,49.4,22.8,26.6,3,5,-2,1
18707,16584,258,221,13,10,10,14,13,9,0,0,15,15,2,2,2,2,1,0,0,0,0,0,2123,37,3,-4,4,0,0,0,0,97.4,13.4,84,5,4,1,0
14455,16502,249,311,4,6,6,5,3,6,0,1,17,14,1,4,0,2,0,1,0,1,0,0,-2047,-62,-2,1,-3,0,3,-3,-2,73.4,24.2,49.2,4,4,0,1
14917,17726,267,276,4,10,10,4,5,15,0,0,15,17,4,4,0,0,0,1,0,0,0,0,-2809,-9,-6,6,-10,0,-2,0,0,50.8,66.6,-15.8,4,5,-1,0
14870,15636,288,256,3,6,6,3,3,5,0,0,20,21,2,4,1,1,1,0,0,0,0,0,-766,32,-3,3,-2,0,-1,-2,0,37.4,82.8,-45.4,3,5,-2,0
15254,15769,251,237,6,7,7,6,4,10,0,0,15,17,5,2,1,1,0,1,0,0,0,0,-515,14,-1,1,-6,0,-2,3,0,50.2,24.2,26,4,3,1,1
14337,16367,240,247,3,9,9,3,3,8,0,0,13,13,1,0,0,1,0,1,0,0,0,0,-2030,-7,-6,6,-5,0,0,1,-1,4.2,17.6,-13.4,0,3,-3,1
14746,15253,253,280,5,4,4,5,6,5,0,0,35,16,3,2,1,2,0,1,0,0,0,0,-507,-27,1,-1,1,0,19,1,-1,26,19.2,6.8,4,4,0,0
17233,15229,264,258,9,5,5,9,12,5,0,0,19,12,0,3,3,0,0,1,0,0,0,0,2004,6,4,-4,7,0,7,-3,3,43.8,33,10.8,4,4,0,1
14814,17106,242,290,6,9,9,6,5,6,0,0,12,115,4,1,0,1,0,1,0,0,0,0,-2292,-48,-3,3,-1,0,-103,3,-1,18,10.4,7.6,4,4,0,0
13739,17473,253,265,2,10,10,2,2,8,0,0,34,118,4,1,0,1,0,1,0,0,0,0,-3734,-12,-8,8,-6,0,-84,3,-1,5.4,40.2,-34.8,1,3,-2,0
14823,15424,271,293,4,4,4,4,5,3,0,1,17,17,4,2,0,0,1,0,0,1,0,0,-601,-22,0,0,2,0,0,2,0,10.2,15,-4.8,4,3,1,0
13878,16084,263,284,2,5,5,2,1,5,0,0,15,17,2,3,0,3,0,1,0,0,0,0,-2206,-21,-3,3,-4,0,-2,-1,-3,21.4,23.2,-1.8,4,3,1,1
14527,14287,256,245,5,5,5,5,4,3,0,1,20,17,2,2,0,0,1,0,0,1,0,0,240,11,0,0,1,0,3,0,0,10.6,53.8,-43.2,2,5,-3,0
13506,16013,257,296,2,5,5,2,1,4,0,1,19,16,2,3,1,3,0,1,0,1,0,0,-2507,-39,-3,3,-3,0,3,-1,-2,48.4,35.2,13.2,5,4,1,0
14439,14632,251,275,4,4,4,4,8,6,0,1,25,12,1,5,0,0,0,1,0,1,0,0,-193,-24,0,0,2,0,13,-4,0,24,43,-19,3,3,0,0
16371,15858,264,277,7,6,6,7,7,7,0,0,24,12,0,7,0,1,1,0,0,0,0,0,513,-13,1,-1,0,0,12,-7,-1,47.8,17.2,30.6,3,3,0,1
15376,15644,213,238,7,7,7,7,10,8,0,1,20,23,2,2,0,2,0,1,0,1,0,0,-268,-25,0,0,2,0,-3,0,-2,73.2,17.6,55.6,4,3,1,1
17147,15884,260,257,10,6,6,10,11,9,0,1,17,15,2,4,0,1,0,1,0,1,0,0,1263,3,4,-4,2,0,2,-2,-1,19.4,48,-28.6,5,4,1,1
14312,13901,255,253,4,4,4,4,8,4,1,0,12,15,3,0,1,1,0,1,1,0,0,0,411,2,0,0,4,0,-3,3,0,33.6,8.2,25.4,3,2,1,0
15188,15596,305,277,3,6,6,3,4,6,0,0,33,34,7,6,0,0,0,1,0,0,0,0,-408,28,-3,3,-2,0,-1,1,0,10.8,23.2,-12.4,3,5,-2,0
15278,14710,276,263,5,3,3,5,4,6,0,0,12,17,1,1,0,1,0,1,0,0,0,0,568,13,2,-2,-2,0,-5,0,-1,22.8,13.8,9,5,3,2,0
16092,14598,273,269,7,4,4,7,11,5,1,0,48,15,1,2,2,0,1,0,1,0,0,0,1494,4,3,-3,6,0,33,-1,2,19.8,51,-31.2,5,5,0,0
14918,14257,281,238,3,4,4,3,3,5,0,0,17,15,2,3,0,1,0,1,0,0,0,0,661,43,-1,1,-2,0,2,-1,-1,11.8,58.2,-46.4,4,4,0,0
14984,15938,274,254,5,7,7,5,4,8,1,0,24,24,7,3,0,0,0,1,1,0,0,0,-954,20,-2,2,-4,0,0,4,0,46.2,22.4,23.8,3,4,-1,0
15080,17807,292,284,3,12,12,3,2,11,0,0,15,39,6,5,0,0,0,1,0,0,0,0,-2727,8,-9,9,-9,0,-24,1,0,24.4,52.8,-28.4,5,3,2,0
15583,14000,285,238,6,4,4,6,5,7,0,0,21,17,3,9,2,0,0,1,0,0,0,0,1583,47,2,-2,-2,0,4,-6,2,15.2,27,-11.8,3,2,1,1
13977,14985,255,290,3,4,4,3,6,6,0,0,16,16,0,3,0,0,0,1,0,0,0,0,-1008,-35,-1,1,0,0,0,-3,0,27.2,48,-20.8,4,4,0,0
14169,15001,239,282,4,4,4,4,3,4,0,1,14,15,0,1,0,2,1,0,0,1,0,0,-832,-43,0,0,-1,0,-1,-1,-2,11.4,89.8,-78.4,4,5,-1,1
17002,14100,256,254,9,4,4,9,13,2,1,0,17,12,4,5,1,1,1,0,1,0,0,0,2902,2,5,-5,11,0,5,-1,0,11.4,9.4,2,3,2,1,1
16781,14549,260,289,9,3,3,9,15,2,0,1,38,11,2,4,1,0,1,0,0,1,0,0,2232,-29,6,-6,13,0,27,-2,1,79.4,15.4,64,5,5,0,1
14372,15380,260,236,4,8,8,4,3,6,0,1,14,43,2,3,0,1,1,0,0,1,0,0,-1008,24,-4,4,-3,0,-29,-1,-1,12.6,88.6,-76,3,3,0,1
14835,14257,254,236,5,4,4,5,6,5,0,1,11,12,0,1,0,1,0,1,0,1,0,0,578,18,1,-1,1,0,-1,-1,-1,4.8,6.2,-1.4,1,2,-1,1
14611,18573,271,281,3,13,13,3,4,15,0,0,14,14,0,0,1,1,1,0,0,0,0,0,-3962,-10,-10,10,-11,0,0,0,0,55.6,41,14.6,4,4,0,1
15494,14959,249,274,5,4,4,5,9,6,0,0,11,17,5,0,1,0,0,1,0,0,0,0,535,-25,1,-1,3,0,-6,5,1,33,25.8,7.2,3,4,-1,1
13820,17018,255,263,3,11,11,3,2,10,0,0,19,17,3,2,1,1,0,1,0,0,0,0,-3198,-8,-8,8,-8,0,2,1,0,10.4,88.8,-78.4,2,5,-3,0
16622,14895,283,263,7,5,5,7,9,6,0,0,25,18,1,3,1,0,0,1,0,0,0,0,1727,20,2,-2,3,0,7,-2,1,59.2,27.4,31.8,5,5,0,1
17315,17229,242,260,10,10,10,10,8,14,0,0,17,37,7,6,0,0,0,1,0,0,0,0,86,-18,0,0,-6,0,-20,1,0,20.2,17.4,2.8,4,4,0,1
15010,14976,252,264,5,4,4,5,7,4,0,0,19,20,2,3,0,0,1,0,0,0,0,0,34,-12,1,-1,3,0,-1,-1,0,20.2,51.4,-31.2,4,5,-1,1
13416,15450,234,250,3,8,8,3,4,2,0,0,24,17,2,3,0,0,0,1,0,0,0,0,-2034,-16,-5,5,2,0,7,-1,0,22.6,12,10.6,4,2,2,0
16020,16647,253,264,8,8,8,8,7,9,0,0,13,20,0,2,3,0,0,1,0,0,0,0,-627,-11,0,0,-2,0,-7,-2,3,20.4,87.2,-66.8,3,4,-1,0
15071,15181,272,280,3,4,4,3,6,5,0,0,15,14,2,4,1,1,1,0,0,0,0,0,-110,-8,-1,1,1,0,1,-2,0,44.6,25,19.6,5,4,1,0
15230,15321,286,270,4,5,5,4,3,8,0,0,20,15,2,3,1,1,1,0,0,0,0,0,-91,16,-1,1,-5,0,5,-1,0,36.6,16,20.6,5,3,2,1
17509,14929,267,255,11,4,4,11,11,3,0,0,19,15,2,7,1,0,1,0,0,0,0,0,2580,12,7,-7,8,0,4,-5,1,35.4,15.8,19.6,5,4,1,1
15258,14454,257,249,7,4,4,7,6,5,0,0,18,15,2,3,0,0,0,1,0,0,0,0,804,8,3,-3,1,0,3,-1,0,36.6,35.6,1,3,2,1,1
16406,14554,242,247,8,5,5,8,10,3,0,1,57,16,4,3,1,1,0,1,0,1,0,0,1852,-5,3,-3,7,0,41,1,0,81.6,7.8,73.8,5,3,2,1
14631,16566,224,258,6,9,9,6,10,16,0,0,16,16,1,2,1,1,1,0,0,0,0,0,-1935,-34,-3,3,-6,0,0,-1,0,14.4,63.6,-49.2,3,5,-2,0
15666,17733,214,243,8,13,13,8,12,12,0,0,29,16,3,5,0,0,1,0,0,0,0,0,-2067,-29,-5,5,0,0,13,-2,0,72.4,43.6,28.8,4,3,1,0
14271,15505,256,263,3,5,5,3,3,5,0,1,17,17,1,4,0,3,0,1,0,1,0,0,-1234,-7,-2,2,-2,0,0,-3,-3,12.2,35,-22.8,3,4,-1,1
14328,17127,231,262,4,8,8,5,7,11,0,0,37,15,2,3,1,0,0,1,0,0,0,0,-2799,-31,-4,3,-4,0,22,-1,1,12.8,51.6,-38.8,3,3,0,0
15028,13524,286,214,4,3,3,4,3,4,0,0,15,23,4,2,1,0,0,1,0,0,0,0,1504,72,1,-1,-1,0,-8,2,1,22.8,25.2,-2.4,5,4,1,1
16862,12541,270,245,10,0,0,10,16,0,1,0,18,31,4,3,0,0,1,0,1,0,0,0,4321,25,10,-10,16,0,-13,1,0,66,58.8,7.2,5,4,1,1
16080,15163,282,254,7,5,5,7,7,6,1,0,13,17,2,2,1,2,1,0,1,0,0,0,917,28,2,-2,1,0,-4,0,-1,25.6,104.6,-79,4,5,-1,0
14600,14344,223,248,6,4,4,6,11,7,1,0,17,17,2,1,0,0,1,0,1,0,0,0,256,-25,2,-2,4,0,0,1,0,78,19.4,58.6,4,3,1,0
13464,14068,270,261,1,3,3,1,1,2,0,0,13,36,3,1,1,1,0,1,0,0,0,0,-604,9,-2,2,-1,0,-23,2,0,79,49.4,29.6,4,5,-1,1
13938,16149,254,284,3,7,7,3,5,5,0,1,16,16,3,4,0,2,0,1,0,1,0,0,-2211,-30,-4,4,0,0,0,-1,-2,19.2,24.6,-5.4,5,4,1,0
14616,15186,273,259,4,4,4,4,0,7,1,0,20,18,5,3,1,1,0,1,1,0,0,0,-570,14,0,0,-7,0,2,2,0,85.8,22.2,63.6,3,3,0,1
14232,16864,281,297,3,6,6,3,1,10,0,0,36,16,2,2,0,2,0,1,0,0,0,0,-2632,-16,-3,3,-9,0,20,0,-2,23.2,87.8,-64.6,2,5,-3,1
15961,15438,230,267,9,6,6,9,8,3,0,0,13,38,3,0,0,1,1,0,0,0,0,0,523,-37,3,-3,5,0,-25,3,-1,58,43.6,14.4,5,4,1,1
15049,13640,259,277,6,1,1,6,9,0,0,0,37,16,2,4,0,0,1,0,0,0,0,0,1409,-18,5,-5,9,0,21,-2,0,16.6,17.6,-1,3,3,0,0
15961,15404,273,263,6,5,6,6,9,8,0,0,15,15,2,3,0,2,0,1,0,0,0,0,557,10,1,0,1,0,0,-1,-2,31.4,52.2,-20.8,4,3,1,0
17056,16114,246,227,11,9,9,11,8,13,0,1,11,18,4,1,0,0,1,0,0,1,0,0,942,19,2,-2,-5,0,-7,3,0,56.2,55.4,0.8,3,4,-1,1
15420,16377,247,242,5,9,9,5,5,9,0,0,20,42,4,3,2,0,0,1,0,0,0,0,-957,5,-4,4,-4,0,-22,1,2,12,43.6,-31.6,4,5,-1,0
13859,14961,268,280,2,4,4,2,2,2,1,0,14,13,1,2,0,1,0,1,1,0,0,0,-1102,-12,-2,2,0,0,1,-1,-1,118.6,64.4,54.2,3,4,-1,0
16791,16173,283,258,9,8,8,9,6,10,0,0,17,27,6,1,2,1,0,1,0,0,0,0,618,25,1,-1,-4,0,-10,5,1,7.2,14,-6.8,3,4,-1,0
16357,15942,255,263,9,6,8,9,10,5,0,0,34,15,3,2,1,0,1,0,0,0,0,0,415,-8,3,-1,5,0,19,1,1,81.6,8.4,73.2,3,2,1,1
16327,17056,269,251,8,10,10,8,7,12,0,0,23,14,4,3,0,0,1,0,0,0,0,0,-729,18,-2,2,-5,0,9,1,0,82.6,32.4,50.2,4,4,0,1
15389,14013,280,257,6,3,3,6,3,1,0,0,20,16,3,3,0,0,1,0,0,0,0,0,1376,23,3,-3,2,0,4,0,0,42,40.8,1.2,4,4,0,1
14957,14725,271,262,4,4,4,4,3,7,0,0,13,36,4,2,1,1,1,0,0,0,0,0,232,9,0,0,-4,0,-23,2,0,30.4,6.8,23.6,3,2,1,1
15927,14136,265,247,8,4,4,8,7,4,0,1,15,12,4,1,1,0,0,1,0,1,0,0,1791,18,4,-4,3,0,3,3,1,24.8,34.4,-9.6,3,5,-2,1
15388,16135,254,264,6,8,8,6,5,7,0,1,18,34,2,4,0,0,1,0,0,1,0,0,-747,-10,-2,2,-2,0,-16,-2,0,8.2,68.6,-60.4,3,4,-1,0
16377,16467,257,262,8,7,7,8,11,10,0,0,20,38,3,4,0,0,0,1,0,0,0,0,-90,-5,1,-1,1,0,-18,-1,0,82.2,37,45.2,5,4,1,0
14687,13575,271,270,4,2,2,4,4,1,0,1,14,16,1,2,0,0,1,0,0,1,0,0,1112,1,2,-2,3,0,-2,-1,0,148.4,35.2,113.2,5,4,1,1
16878,16109,238,250,11,8,8,11,8,10,0,0,21,36,5,3,0,0,0,1,0,0,0,0,769,-12,3,-3,-2,0,-15,2,0,23.6,39,-15.4,5,3,2,1
16017,14395,300,268,5,3,3,5,7,5,0,0,23,20,4,4,0,0,1,0,0,0,0,0,1622,32,2,-2,2,0,3,0,0,37.2,7.6,29.6,4,4,0,1
16765,14314,283,278,8,2,2,8,9,2,0,1,18,16,4,3,1,1,1,0,0,1,0,0,2451,5,6,-6,7,0,2,1,0,36.8,18,18.8,5,5,0,1
16372,15857,287,270,7,7,7,7,7,5,0,0,17,25,2,5,0,0,0,1,0,0,0,0,515,17,0,0,2,0,-8,-3,0,26.4,30.4,-4,4,5,-1,1
13589,16844,242,238,2,10,10,2,3,15,1,0,14,20,1,3,1,1,0,1,1,0,0,0,-3255,4,-8,8,-12,0,-6,-2,0,28.2,88.6,-60.4,4,5,-1,1
14826,13653,255,264,5,2,2,6,4,4,0,0,19,31,3,2,0,0,0,1,0,0,0,0,1173,-9,3,-4,0,0,-12,1,0,13.8,35.4,-21.6,2,3,-1,1
15786,13678,292,276,5,2,2,5,5,0,0,0,16,32,3,3,1,0,1,0,0,0,0,0,2108,16,3,-3,5,0,-16,0,1,16,5,11,3,2,1,1
15123,14533,291,265,4,4,4,4,3,3,0,1,17,19,5,4,1,0,1,0,0,1,0,0,590,26,0,0,0,0,-2,1,1,12.6,20,-7.4,4,5,-1,0
14733,16789,242,257,5,10,10,5,4,7,0,0,17,33,4,1,2,1,1,0,0,0,0,0,-2056,-15,-5,5,-3,0,-16,3,1,71,27.2,43.8,3,4,-1,0
15242,16135,234,242,6,10,10,6,7,9,0,0,14,16,4,3,1,0,1,0,0,0,0,0,-893,-8,-4,4,-2,0,-2,1,1,75.8,15.6,60.2,4,3,1,0
16797,16994,261,243,8,9,9,8,7,11,0,1,14,28,2,2,1,2,0,1,0,1,0,0,-197,18,-1,1,-4,0,-14,0,-1,32,23.2,8.8,3,3,0,1
15047,16394,242,277,6,7,7,6,3,9,0,0,24,41,6,5,0,0,0,1,0,0,0,0,-1347,-35,-1,1,-6,0,-17,1,0,41,23.6,17.4,4,4,0,0
15459,16134,258,230,6,10,10,6,3,14,0,0,174,30,5,2,1,0,0,1,0,0,0,0,-675,28,-4,4,-11,0,144,3,1,28.4,35.8,-7.4,2,3,-1,1
15014,14029,288,251,4,3,3,4,3,1,0,0,37,16,8,4,0,0,0,1,0,0,0,0,985,37,1,-1,2,0,21,4,0,17.8,104,-86.2,4,5,-1,0
15777,15842,261,265,7,8,8,7,8,6,0,0,20,15,0,4,0,1,1,0,0,0,0,0,-65,-4,-1,1,2,0,5,-4,-1,48.8,11.2,37.6,4,3,1,1
16075,15730,266,265,7,7,7,7,9,5,1,0,13,14,3,2,0,2,1,0,1,0,0,0,345,1,0,0,4,0,-1,1,-2,92.6,49.8,42.8,5,4,1,1
17313,17064,258,264,11,8,8,11,16,8,0,1,16,29,2,1,0,0,1,0,0,1,0,0,249,-6,3,-3,8,0,-13,1,0,16,17.2,-1.2,4,5,-1,0
15551,15461,259,281,5,5,5,5,8,7,0,0,35,29,5,6,1,0,0,1,0,0,0,0,90,-22,0,0,1,0,6,-1,1,10,45.6,-35.6,2,5,-3,0
15505,16010,217,240,8,9,9,9,6,8,0,1,13,16,1,2,2,1,1,0,0,1,0,0,-505,-23,-1,0,-2,0,-3,-1,1,47.4,66.4,-19,3,2,1,0
13325,16743,238,292,2,8,8,2,2,7,0,0,16,36,2,3,0,2,0,1,0,0,0,0,-3418,-54,-6,6,-5,0,-20,-1,-2,12.6,33,-20.4,4,5,-1,0
15564,16722,260,271,6,10,10,6,9,17,0,0,10,11,0,1,0,1,0,1,0,0,0,0,-1158,-11,-4,4,-8,0,-1,-1,-1,9,20.8,-11.8,1,2,-1,0
14237,17276,254,316,3,8,8,3,3,6,0,0,16,26,4,5,0,0,0,1,0,0,0,0,-3039,-62,-5,5,-3,0,-10,-1,0,31.2,24.2,7,3,3,0,0
14369,16393,294,276,2,8,8,2,3,10,0,1,16,28,1,4,0,0,0,1,0,1,0,0,-2024,18,-6,6,-7,0,-12,-3,0,15.6,87.6,-72,3,5,-2,0
15675,14713,271,270,5,4,4,5,11,6,0,1,22,107,3,4,0,1,1,0,0,1,0,0,962,1,1,-1,5,0,-85,-1,-1,26.2,104.6,-78.4,4,5,-1,0
16261,13750,282,248,6,3,3,6,8,2,0,0,16,32,5,4,2,0,1,0,0,0,0,0,2511,34,3,-3,6,0,-16,1,2,22.4,46.4,-24,3,4,-1,1
13658,15182,249,271,2,6,6,2,2,4,0,1,34,22,2,3,1,1,0,1,0,1,0,0,-1524,-22,-4,4,-2,0,12,-1,0,37.8,7.4,30.4,4,3,1,0
16058,16120,250,274,9,7,7,9,4,8,0,0,18,21,3,3,1,1,0,1,0,0,0,0,-62,-24,2,-2,-4,0,-3,0,0,36.4,50.2,-13.8,3,4,-1,1
17543,14584,259,266,11,4,4,11,15,4,0,0,19,19,3,4,2,0,1,0,0,0,0,0,2959,-7,7,-7,11,0,0,-1,2,10,8.2,1.8,2,3,-1,1
15513,14659,251,256,5,4,4,5,6,6,0,1,12,18,5,3,0,0,1,0,0,1,0,0,854,-5,1,-1,0,0,-6,2,0,167,108.8,58.2,4,4,0,1
15509,14366,286,286,5,3,3,5,6,2,0,1,14,26,5,3,0,0,1,0,0,1,0,0,1143,0,2,-2,4,0,-12,2,0,27.4,64.8,-37.4,4,4,0,1
16668,14690,274,276,8,4,4,8,6,3,0,0,16,11,2,7,0,0,0,1,0,0,0,0,1978,-2,4,-4,3,0,5,-5,0,13.8,11.2,2.6,2,4,-2,1
16914,16489,262,250,10,8,9,10,9,10,0,0,16,12,4,3,1,1,1,0,0,0,0,0,425,12,2,-1,-1,0,4,1,0,68.2,103.2,-35,5,5,0,1
18179,13861,267,214,12,4,5,12,17,4,0,0,23,16,6,4,2,0,1,0,0,0,0,0,4318,53,8,-7,13,0,7,2,2,143.8,109.8,34,3,5,-2,1
16764,14969,272,255,8,6,6,8,7,4,0,0,25,16,3,3,1,0,1,0,0,0,0,0,1795,17,2,-2,3,0,9,0,1,13.8,17.4,-3.6,4,4,0,1
14566,15280,265,264,4,5,5,4,3,7,0,1,21,19,2,5,1,0,1,0,0,1,0,0,-714,1,-1,1,-4,0,2,-3,1,14.8,16,-1.2,5,5,0,0
19152,13900,295,229,13,3,3,13,12,4,0,0,16,17,3,1,0,0,1,0,0,0,0,0,5252,66,10,-10,8,0,-1,2,0,17.2,33.4,-16.2,5,4,1,1
16936,15876,256,281,8,6,7,8,13,4,0,0,19,105,3,5,1,3,1,0,0,0,0,0,1060,-25,2,-1,9,0,-86,-2,-2,18.4,24.4,-6,5,5,0,0
14917,15183,280,282,4,4,4,4,6,3,1,0,16,33,2,2,0,0,0,1,1,0,0,0,-266,-2,0,0,3,0,-17,0,0,22.8,81.8,-59,5,5,0,0
17389,16230,287,279,9,5,5,9,8,9,0,0,19,18,1,5,3,0,1,0,0,0,0,0,1159,8,4,-4,-1,0,1,-4,3,47.2,13.6,33.6,3,5,-2,1
15452,15570,279,296,5,4,4,5,5,5,0,0,18,18,5,6,1,1,0,1,0,0,0,0,-118,-17,1,-1,0,0,0,-1,0,11.6,10.6,1,3,3,0,1
16159,16354,215,212,9,9,9,9,6,8,0,0,12,17,1,2,0,0,0,1,0,0,0,0,-195,3,0,0,-2,0,-5,-1,0,74.6,13.6,61,4,3,1,0
17449,16120,279,269,9,8,8,9,12,4,0,0,13,13,3,4,0,0,1,0,0,0,0,0,1329,10,1,-1,8,0,0,-1,0,41.8,53.2,-11.4,3,5,-2,1
16704,14328,267,253,8,5,5,8,11,1,1,0,17,16,4,4,0,1,1,0,1,0,0,0,2376,14,3,-3,10,0,1,0,-1,37.2,16.6,20.6,3,5,-2,1
15912,14854,284,265,6,4,4,6,8,2,0,0,20,15,4,4,0,0,1,0,0,0,0,0,1058,19,2,-2,6,0,5,0,0,7,11.6,-4.6,1,4,-3,0
14687,15080,274,276,4,5,5,4,3,5,0,0,22,18,5,3,0,0,0,1,0,0,0,0,-393,-2,-1,1,-2,0,4,2,0,14.4,65.4,-51,5,4,1,0
16427,14480,257,255,10,4,4,10,5,6,0,0,12,40,4,0,1,0,1,0,0,0,0,0,1947,2,6,-6,-1,0,-28,4,1,16,25.8,-9.8,3,4,-1,0
15457,14902,266,246,6,4,4,6,10,6,0,0,14,19,3,4,0,1,1,0,0,0,0,0,555,20,2,-2,4,0,-5,-1,-1,19.6,37.2,-17.6,5,5,0,1
15615,14423,270,257,6,4,4,6,6,3,0,0,107,36,3,4,2,0,0,1,0,0,0,0,1192,13,2,-2,3,0,71,-1,2,13.4,18.2,-4.8,4,3,1,1
14881,14785,284,302,4,2,2,4,3,4,1,0,11,25,2,6,0,1,0,1,1,0,0,0,96,-18,2,-2,-1,0,-14,-4,-1,16.6,38.8,-22.2,5,4,1,0
15276,17414,261,265,5,9,10,5,4,7,0,0,53,22,5,4,0,2,0,1,0,0,0,0,-2138,-4,-4,5,-3,0,31,1,-2,17,44,-27,3,4,-1,1
16872,14255,259,264,9,3,4,9,15,3,0,0,37,109,6,1,2,0,1,0,0,0,0,0,2617,-5,6,-5,12,0,-72,5,2,16.2,24.2,-8,3,3,0,1
13504,15699,252,302,2,5,5,2,3,1,0,0,14,15,3,3,0,1,1,0,0,0,0,0,-2195,-50,-3,3,2,0,-1,0,-1,56.8,51.2,5.6,5,4,1,0
15285,14373,238,275,7,3,3,7,6,1,0,1,12,18,4,4,2,2,1,0,0,1,0,0,912,-37,4,-4,5,0,-6,0,0,81.4,10.6,70.8,4,3,1,1
14976,15364,259,261,5,6,6,5,2,4,0,1,17,18,4,1,0,1,0,1,0,1,0,0,-388,-2,-1,1,-2,0,-1,3,-1,33,22.4,10.6,3,5,-2,0
18311,13154,287,238,12,2,2,12,15,1,0,0,19,29,3,0,0,0,1,0,0,0,0,0,5157,49,10,-10,14,0,-10,3,0,9.2,8.8,0.4,3,2,1,1
15998,15611,251,241,8,7,7,8,6,10,0,0,10,113,1,0,1,1,0,1,0,0,0,0,387,10,1,-1,-4,0,-103,1,0,16,29,-13,4,5,-1,0
16167,17296,256,273,7,7,7,7,6,8,0,0,15,14,4,2,1,3,1,0,0,0,0,1,-1129,-17,0,0,-2,0,1,2,-2,30.8,6.6,24.2,4,2,2,0
15925,18204,239,243,7,14,14,7,7,17,0,0,17,27,2,4,0,0,1,0,0,0,0,0,-2279,-4,-7,7,-10,0,-10,-2,0,10.8,6.6,4.2,4,3,1,1
17161,15090,259,238,11,6,6,11,8,5,1,0,14,34,2,1,1,2,1,0,1,0,0,0,2071,21,5,-5,3,0,-20,1,-1,31.8,46.2,-14.4,5,5,0,0
15965,14896,268,272,7,4,4,7,7,4,0,1,20,13,1,3,0,0,1,0,0,1,0,0,1069,-4,3,-3,3,0,7,-2,0,17.6,33.8,-16.2,2,5,-3,0
17793,14092,247,221,12,4,4,12,13,3,0,0,19,35,4,3,2,0,1,0,0,0,0,0,3701,26,8,-8,10,0,-16,1,2,16.8,19.8,-3,3,5,-2,1
18886,13014,277,243,14,2,2,14,14,1,0,0,113,14,2,3,3,0,1,0,0,0,1,0,5872,34,12,-12,13,0,99,-1,3,35,15.2,19.8,5,4,1,1
14991,15651,232,282,5,5,5,5,8,5,0,0,20,80,3,3,1,3,0,1,0,0,0,0,-660,-50,0,0,3,0,-60,0,-2,44.8,13.4,31.4,5,4,1,1
14394,14177,273,266,4,3,3,4,1,3,0,1,18,15,3,3,0,1,0,1,0,1,0,0,217,7,1,-1,-2,0,3,0,-1,11.6,54.8,-43.2,3,5,-2,0
16355,14992,268,274,7,4,4,7,9,5,0,1,112,23,6,5,0,1,0,1,0,1,0,0,1363,-6,3,-3,4,0,89,1,-1,11.2,63.2,-52,2,4,-2,1
14962,16558,255,291,5,7,7,5,2,9,0,0,20,16,1,2,0,0,0,1,0,0,0,0,-1596,-36,-2,2,-7,0,4,-1,0,11,16,-5,2,4,-2,0
14405,16590,237,257,4,9,9,4,5,9,0,0,15,32,2,3,0,0,0,1,0,0,0,0,-2185,-20,-5,5,-4,0,-17,-1,0,16.8,16.4,0.4,4,4,0,1
14155,15678,267,268,2,6,6,2,2,5,0,0,12,15,2,2,0,1,1,0,0,0,0,0,-1523,-1,-4,4,-3,0,-3,0,-1,38.8,13.2,25.6,5,1,4,0
16636,14120,247,235,9,4,4,9,6,4,0,0,18,14,1,1,1,0,1,0,0,0,0,0,2516,12,5,-5,2,0,4,0,1,107,16.6,90.4,5,5,0,1
15513,16235,252,235,8,9,9,9,7,12,0,0,26,18,5,5,1,1,1,0,0,0,0,0,-722,17,-1,0,-5,0,8,0,0,11.6,10.6,1,2,3,-1,0
15376,18141,243,262,8,13,13,8,4,13,1,0,17,17,3,6,0,0,0,1,1,0,0,0,-2765,-19,-5,5,-9,0,0,-3,0,17,60,-43,3,5,-2,0
15358,16629,222,238,6,9,9,6,7,6,0,0,28,12,0,0,0,1,0,1,0,0,0,0,-1271,-16,-3,3,1,0,16,0,-1,40.8,28.6,12.2,2,2,0,0
14322,17827,292,279,2,9,9,3,0,9,0,0,14,14,2,1,3,3,0,1,0,0,0,0,-3505,13,-7,6,-9,0,0,1,0,57,8.4,48.6,2,2,0,0
15668,14449,280,243,6,5,5,6,2,4,0,0,15,20,1,2,1,0,0,1,0,0,0,0,1219,37,1,-1,-2,0,-5,-1,1,9,7,2,2,2,0,1
17347,12409,269,206,10,2,2,10,13,2,0,0,16,11,5,3,3,0,1,0,0,0,0,0,4938,63,8,-8,11,0,5,2,3,62.4,6,56.4,4,3,1,1
14477,15735,230,263,5,7,7,5,3,2,1,0,10,16,2,2,0,4,1,0,1,0,0,0,-1258,-33,-2,2,1,0,-6,0,-4,9.4,10.6,-1.2,2,1,1,0
15438,13584,253,266,7,2,2,7,6,2,0,0,19,20,4,1,0,0,1,0,0,0,0,0,1854,-13,5,-5,4,0,-1,3,0,32.4,5.4,27,4,3,1,1
15212,13391,276,241,6,3,3,6,4,7,0,1,20,12,2,3,1,0,0,1,0,1,0,0,1821,35,3,-3,-3,0,8,-1,1,29.8,58,-28.2,3,3,0,1
15989,15096,231,244,8,5,5,8,11,3,0,0,18,16,1,1,2,1,1,0,0,0,0,0,893,-13,3,-3,8,0,2,0,1,5.8,18.6,-12.8,2,4,-2,1
15740,13400,245,208,8,5,5,8,5,2,0,0,10,15,4,1,0,0,1,0,0,0,0,0,2340,37,3,-3,3,0,-5,3,0,24,9.2,14.8,3,3,0,1
13951,13422,272,250,1,2,2,1,0,2,0,0,12,25,5,4,1,0,1,0,0,0,0,0,529,22,-1,1,-2,0,-13,1,1,5.6,3,2.6,1,0,1,1
15747,19446,246,310,6,14,14,6,6,15,0,0,14,18,1,4,0,2,0,1,0,0,0,0,-3699,-64,-8,8,-9,0,-4,-3,-2,23.8,24.8,-1,3,3,0,0
16708,15481,253,236,10,5,5,10,14,13,1,0,18,11,2,3,3,0,0,1,1,0,0,0,1227,17,5,-5,1,0,7,-1,3,37.6,9.4,28.2,4,3,1,1
17693,16340,218,236,15,9,9,15,12,10,0,0,14,13,1,0,0,2,0,1,0,0,0,0,1353,-18,6,-6,2,0,1,1,-2,4,6.6,-2.6,1,2,-1,1
17271,14144,224,209,10,6,6,10,13,6,0,0,20,16,1,4,3,0,0,1,0,0,0,0,3127,15,4,-4,7,0,4,-3,3,11.2,39,-27.8,2,5,-3,1
15997,15304,245,241,9,5,5,10,11,8,1,0,15,11,1,3,2,0,1,0,1,0,0,0,693,4,4,-5,3,0,4,-2,2,29.6,24.2,5.4,4,3,1,1
6033,4778,71,46,2,0,0,2,0,0,0,0,5,6,0,0,0,0,1,0,0,0,0,0,1255,25,2,-2,0,0,-1,0,0,4.8,56,-51.2,1,4,-3,1
13077,14691,237,266,2,5,5,2,2,2,0,0,21,17,1,2,0,0,1,0,0,0,0,0,-1614,-29,-3,3,0,0,4,-1,0,31.4,9.4,22,3,4,-1,0
15175,13393,273,250,7,2,2,8,3,6,0,0,20,12,4,4,0,0,1,0,0,0,0,0,1782,23,5,-6,-3,0,8,0,0,11.2,33.2,-22,3,3,0,0
14461,16487,246,241,5,8,8,5,9,13,0,0,19,14,2,4,0,0,1,0,0,0,0,0,-2026,5,-3,3,-4,0,5,-2,0,41.4,37.2,4.2,3,3,0,0
17466,17307,291,269,9,7,7,10,11,11,0,0,16,17,3,2,0,1,1,0,0,0,0,0,159,22,2,-3,0,0,-1,1,-1,52,27,25,5,4,1,1
14297,15546,216,243,6,8,8,6,4,11,1,0,37,21,5,5,0,1,0,1,1,0,0,0,-1249,-27,-2,2,-7,0,16,0,-1,12,10.2,1.8,3,3,0,0
14262,14819,261,269,4,3,3,4,2,4,0,0,14,37,9,3,0,0,1,0,0,0,0,0,-557,-8,1,-1,-2,0,-23,6,0,11.2,100,-88.8,2,5,-3,0
14563,16223,267,241,4,9,9,4,2,13,0,1,15,15,3,2,0,2,0,1,0,1,0,0,-1660,26,-5,5,-11,0,0,1,-2,5.8,10.2,-4.4,3,3,0,1
14896,14779,243,265,6,5,5,6,5,5,1,0,10,19,0,1,0,0,1,0,1,0,0,0,117,-22,1,-1,0,0,-9,-1,0,49.6,34.6,15,3,5,-2,1
14187,16982,239,287,5,9,9,5,4,6,0,0,35,13,2,5,0,2,0,1,0,0,0,0,-2795,-48,-4,4,-2,0,22,-3,-2,34,97.2,-63.2,4,3,1,0
16394,18238,234,246,10,12,12,10,6,10,0,0,11,42,3,2,2,1,0,1,0,0,0,0,-1844,-12,-2,2,-4,0,-31,1,1,18.6,60.6,-42,3,4,-1,1
14774,17330,258,300,4,9,11,4,5,6,0,0,16,12,1,3,0,1,0,1,0,0,0,0,-2556,-42,-5,7,-1,0,4,-2,-1,7.6,10.4,-2.8,2,2,0,0
16191,15175,264,270,9,4,4,9,8,6,0,0,16,59,0,4,2,0,1,0,0,0,0,0,1016,-6,5,-5,2,0,-43,-4,2,79,42,37,3,3,0,1
16612,13173,261,239,9,2,2,9,11,2,0,0,18,13,1,2,0,0,0,1,0,0,0,0,3439,22,7,-7,9,0,5,-1,0,48.2,28,20.2,4,3,1,1
17052,14214,287,252,8,5,5,8,11,5,0,0,34,36,1,1,1,0,1,0,0,0,0,0,2838,35,3,-3,6,0,-2,0,1,41,17.2,23.8,3,4,-1,1
15211,15111,248,239,6,6,6,6,2,5,0,0,12,11,2,1,1,0,0,1,0,0,0,0,100,9,0,0,-3,0,1,1,1,15.4,49.8,-34.4,2,4,-2,0
14786,14389,226,272,6,3,3,6,5,2,1,0,17,13,0,3,0,0,1,0,1,0,0,0,397,-46,3,-3,3,0,4,-3,0,32,33.8,-1.8,4,3,1,0
15050,16499,238,259,6,10,10,6,6,9,0,1,10,13,1,2,0,1,0,1,0,1,0,0,-1449,-21,-4,4,-3,0,-3,-1,-1,53.6,13.4,40.2,3,3,0,0
16028,14385,273,261,7,3,3,7,6,4,0,0,35,19,6,1,1,3,1,0,0,0,0,0,1643,12,4,-4,2,0,16,5,-2,45.2,20.6,24.6,4,2,2,0
16770,16051,255,275,8,8,8,8,10,4,0,1,20,16,3,5,0,0,1,0,0,1,0,0,719,-20,0,0,6,0,4,-2,0,42.2,78.8,-36.6,4,4,0,0
17071,14998,273,262,12,5,5,12,7,7,1,0,23,16,3,6,0,0,1,0,1,0,0,0,2073,11,7,-7,0,0,7,-3,0,59.8,27.4,32.4,2,4,-2,1
14066,15202,241,250,4,5,5,4,4,8,0,1,12,110,1,3,0,0,0,1,0,1,0,0,-1136,-9,-1,1,-4,0,-98,-2,0,27.4,48.4,-21,3,4,-1,0
16489,16515,255,294,8,6,6,8,12,4,1,0,107,14,1,2,0,2,0,1,1,0,0,0,-26,-39,2,-2,8,0,93,-1,-2,31.4,16.6,14.8,5,4,1,1
14059,16436,272,274,3,8,8,3,2,10,0,0,14,42,3,5,0,1,0,1,0,0,0,0,-2377,-2,-5,5,-8,0,-28,-2,-1,35.6,31.2,4.4,5,5,0,0
14867,16465,270,269,4,8,8,4,3,9,0,0,33,16,5,3,2,0,1,0,0,0,0,0,-1598,1,-4,4,-6,0,17,2,2,31.2,46,-14.8,3,3,0,1
16192,17261,268,249,7,10,10,7,9,15,0,1,18,17,0,5,2,0,0,1,0,1,0,0,-1069,19,-3,3,-6,0,1,-5,2,14.8,53,-38.2,3,5,-2,1
15247,16647,243,246,6,8,8,6,6,9,0,0,16,20,7,3,0,3,0,1,0,0,0,0,-1400,-3,-2,2,-3,0,-4,4,-3,8.2,20.8,-12.6,3,5,-2,0
14104,14716,242,247,4,5,5,4,3,3,0,0,17,145,3,1,0,2,1,0,0,0,0,0,-612,-5,-1,1,0,0,-128,2,-2,34.8,15.8,19,3,2,1,0
16250,14758,271,267,7,4,4,7,7,3,0,1,15,27,3,2,1,0,1,0,0,1,0,0,1492,4,3,-3,4,0,-12,1,1,121.2,30.4,90.8,3,4,-1,0
15710,16111,261,240,6,9,9,6,2,6,0,1,15,15,3,0,2,1,0,1,0,1,0,0,-401,21,-3,3,-4,0,0,3,1,21.6,68.2,-46.6,4,5,-1,0
15269,14581,293,296,4,2,2,4,3,3,0,0,114,16,6,3,1,0,1,0,0,0,0,0,688,-3,2,-2,0,0,98,3,1,12.8,35.4,-22.6,4,4,0,0
15416,13961,273,258,6,4,4,6,4,2,0,0,29,15,2,2,1,0,1,0,0,0,0,0,1455,15,2,-2,2,0,14,0,1,22.6,32.6,-10,3,4,-1,1
15027,15819,254,225,3,8,8,3,5,13,0,1,12,17,3,1,1,1,0,1,0,1,0,0,-792,29,-5,5,-8,0,-5,2,0,46.4,51.4,-5,3,4,-1,0
16017,15751,275,255,7,7,7,7,8,8,0,1,16,13,4,6,1,0,0,1,0,1,0,0,266,20,0,0,0,0,3,-2,1,75.8,43.2,32.6,4,4,0,0
15062,13416,266,257,5,2,2,5,8,1,0,0,16,36,1,6,1,0,0,1,0,0,0,0,1646,9,3,-3,7,0,-20,-5,1,16.8,143,-126.2,4,5,-1,1
15780,15663,288,257,5,5,5,6,6,9,0,0,109,13,3,2,1,2,1,0,0,0,0,0,117,31,0,-1,-3,0,96,1,-1,14.6,29,-14.4,4,3,1,1
17632,16163,260,255,10,7,7,10,11,10,0,0,38,18,4,3,2,1,1,0,0,0,0,0,1469,5,3,-3,1,0,20,1,1,5.8,103.6,-97.8,1,4,-3,1
15722,13573,241,258,8,2,2,8,10,3,0,0,50,16,3,2,0,3,1,0,0,0,0,0,2149,-17,6,-6,7,0,34,1,-3,11.6,7.8,3.8,3,1,2,1
17113,15710,269,252,9,6,6,10,8,8,0,1,14,14,1,0,2,0,1,0,0,1,0,0,1403,17,3,-4,0,0,0,1,2,8.2,42.6,-34.4,2,4,-2,1
14770,13592,232,253,5,2,3,5,5,1,0,1,16,12,3,3,1,1,1,0,0,1,0,0,1178,-21,3,-2,4,0,4,0,0,32.6,63,-30.4,4,4,0,1
13983,14793,243,299,3,3,3,3,3,2,0,0,16,21,3,3,0,1,1,0,0,0,0,0,-810,-56,0,0,1,0,-5,0,-1,87.8,23.8,64,4,5,-1,1
13565,19676,174,274,5,17,17,5,3,13,0,0,15,19,3,3,0,0,0,1,0,0,0,0,-6111,-100,-12,12,-10,0,-4,0,0,6.2,70.4,-64.2,2,4,-2,0
14338,14899,288,295,2,4,4,2,0,5,0,1,16,50,2,5,1,0,0,1,0,1,0,0,-561,-7,-2,2,-5,0,-34,-3,1,60.2,31.6,28.6,4,4,0,1
14903,15026,262,286,5,4,4,6,2,5,0,0,39,17,6,7,0,0,0,1,0,0,0,0,-123,-24,1,-2,-3,0,22,-1,0,24,34.8,-10.8,2,5,-3,0
14845,14179,263,281,3,2,2,3,5,1,0,0,23,86,5,6,1,0,1,0,0,0,0,0,666,-18,1,-1,4,0,-63,-1,1,149.4,13.8,135.6,4,3,1,0
17288,16537,238,261,10,7,7,10,11,8,0,0,40,19,8,5,0,0,1,0,0,0,0,0,751,-23,3,-3,3,0,21,3,0,68.4,29.6,38.8,4,3,1,1
15851,15771,274,264,6,6,6,6,5,7,0,0,14,15,3,0,0,1,0,1,0,0,0,0,80,10,0,0,-2,0,-1,3,-1,18.4,39.2,-20.8,3,4,-1,0
15948,14846,259,289,7,4,4,7,6,1,0,1,17,12,0,4,0,3,1,0,0,1,0,0,1102,-30,3,-3,5,0,5,-4,-3,16.2,9,7.2,4,3,1,0
15710,13705,272,259,6,2,2,6,5,3,0,1,25,23,0,6,3,0,1,0,0,1,0,0,2005,13,4,-4,2,0,2,-6,3,31.2,47.6,-16.4,5,3,2,1
14832,15632,248,242,5,8,8,5,3,4,0,0,16,45,4,6,3,1,0,1,0,0,0,0,-800,6,-3,3,-1,0,-29,-2,2,25,142.4,-117.4,4,5,-1,1
14925,15665,250,234,5,7,7,5,4,6,0,0,19,23,3,1,1,0,1,0,0,0,0,0,-740,16,-2,2,-2,0,-4,2,1,36.2,8,28.2,3,2,1,0
13763,15807,260,251,3,7,7,3,0,8,0,0,19,29,2,5,1,2,0,1,0,0,0,0,-2044,9,-4,4,-8,0,-10,-3,-1,38.4,12.6,25.8,3,4,-1,0
13713,13551,209,277,6,1,1,6,2,1,0,1,16,13,0,2,1,2,1,0,0,1,0,0,162,-68,5,-5,1,0,3,-2,-1,25.6,18,7.6,2,3,-1,0
14702,14304,285,293,4,2,2,4,4,2,0,0,14,15,2,0,0,0,1,0,0,0,0,0,398,-8,2,-2,2,0,-1,2,0,62,32.6,29.4,4,5,-1,1
13146,13684,243,253,1,3,3,1,1,0,0,1,13,11,2,5,0,0,0,1,0,1,0,0,-538,-10,-2,2,1,0,2,-3,0,8.2,10.4,-2.2,2,2,0,1
16535,14544,283,259,7,4,4,7,11,7,0,0,19,23,4,5,0,0,1,0,0,0,0,0,1991,24,3,-3,4,0,-4,-1,0,31,50,-19,4,2,2,1
15476,16297,253,242,6,10,10,6,5,8,0,0,38,17,4,4,0,0,0,1,0,0,0,0,-821,11,-4,4,-3,0,21,0,0,13.2,14.2,-1,5,4,1,0
14369,16861,290,301,2,6,6,2,4,5,0,1,14,15,3,2,1,2,0,1,0,1,0,0,-2492,-11,-4,4,-1,0,-1,1,-1,46.2,55.8,-9.6,5,5,0,0
15680,15206,267,267,6,4,5,6,6,4,0,0,21,11,0,3,2,0,0,1,0,0,0,0,474,0,2,-1,2,0,10,-3,2,45.2,38.2,7,4,5,-1,0
16331,13526,237,244,9,2,2,9,10,1,0,0,16,58,17,2,1,0,1,0,0,0,0,0,2805,-7,7,-7,9,0,-42,15,1,31.2,125.2,-94,3,4,-1,1
15511,15842,229,247,8,7,8,8,7,6,0,1,12,13,2,1,0,2,0,1,0,1,0,0,-331,-18,1,0,1,0,-1,1,-2,34.4,82.2,-47.8,4,4,0,1
14712,15865,264,294,4,5,5,4,5,3,0,1,25,20,4,2,0,2,1,0,0,1,0,0,-1153,-30,-1,1,2,0,5,2,-2,15.8,10.8,5,2,2,0,1
17846,12844,257,248,12,1,1,12,17,1,0,0,15,18,5,0,0,0,1,0,0,0,0,0,5002,9,11,-11,16,0,-3,5,0,4.6,9.8,-5.2,1,2,-1,1
15682,14974,234,280,7,4,4,7,12,1,0,0,13,71,1,0,2,3,1,0,0,0,0,0,708,-46,3,-3,11,0,-58,1,-1,17.6,35,-17.4,3,2,1,1
15876,16303,256,239,7,8,8,7,9,8,0,0,14,38,5,2,1,0,1,0,0,0,0,0,-427,17,-1,1,1,0,-24,3,1,20.8,25.6,-4.8,4,2,2,0
16139,16789,286,271,8,8,8,8,8,10,0,0,15,33,1,2,1,1,0,1,0,0,0,0,-650,15,0,0,-2,0,-18,-1,0,23.4,30.4,-7,4,4,0,1
15129,13043,260,254,6,1,1,6,4,2,0,1,12,14,2,3,0,0,1,0,0,1,0,0,2086,6,5,-5,2,0,-2,-1,0,63.4,5.4,58,4,1,3,1
17080,16017,265,291,8,5,5,8,10,8,0,1,16,12,3,4,3,0,0,1,0,1,0,0,1063,-26,3,-3,2,0,4,-1,3,40.6,99.4,-58.8,4,4,0,1
15347,13741,277,276,5,2,2,5,6,1,0,1,14,12,2,3,0,0,1,0,0,1,0,0,1606,1,3,-3,5,0,2,-1,0,8.2,100.4,-92.2,1,5,-4,1
10720,12918,183,229,1,4,4,1,0,2,0,1,12,18,1,2,0,1,0,1,0,1,0,0,-2198,-46,-3,3,-2,0,-6,-1,-1,36.2,59.8,-23.6,5,5,0,0
14923,14284,241,230,6,5,5,6,4,5,0,0,13,17,3,0,0,0,1,0,0,0,0,0,639,11,1,-1,-1,0,-4,3,0,109,17.6,91.4,4,4,0,1
17151,14990,277,256,9,5,5,9,10,6,0,0,13,37,3,3,2,0,1,0,0,0,0,0,2161,21,4,-4,4,0,-24,0,2,32.6,3.6,29,4,0,4,1
14058,17531,253,281,4,8,8,4,2,9,0,1,16,17,5,4,0,3,0,1,0,1,0,0,-3473,-28,-4,4,-7,0,-1,1,-3,18.6,4,14.6,3,0,3,0
16251,15881,254,247,9,8,8,9,8,10,0,0,27,13,4,5,0,0,1,0,0,0,0,0,370,7,1,-1,-2,0,14,-1,0,6.8,15.4,-8.6,2,2,0,1
15981,14334,247,246,9,4,4,9,6,4,0,1,14,22,1,2,0,1,1,0,0,1,0,0,1647,1,5,-5,2,0,-8,-1,-1,14,8.6,5.4,4,2,2,1
15308,15461,256,275,6,5,5,6,8,5,0,1,19,19,2,4,0,0,1,0,0,1,0,0,-153,-19,1,-1,3,0,0,-2,0,13.6,8.6,5,3,4,-1,1
14509,15107,247,284,4,4,4,5,4,2,0,1,17,15,3,4,1,0,0,1,0,1,0,0,-598,-37,0,-1,2,0,2,-1,1,32.6,69.6,-37,4,5,-1,0
14815,15010,256,266,5,4,4,5,7,5,0,1,14,12,1,4,0,1,1,0,0,1,0,0,-195,-10,1,-1,2,0,2,-3,-1,19.2,6.6,12.6,2,3,-1,0
15837,16859,242,268,8,9,9,8,10,12,0,0,26,20,4,5,0,1,0,1,0,0,0,0,-1022,-26,-1,1,-2,0,6,-1,-1,84.4,9,75.4,4,2,2,1
17621,16346,258,267,8,7,7,8,11,9,0,0,21,14,1,2,0,3,0,1,0,0,0,0,1275,-9,1,-1,2,0,7,-1,-3,98.4,10.6,87.8,4,3,1,1
14694,15308,284,255,3,7,7,3,3,10,0,1,15,12,2,3,1,0,1,0,0,1,0,0,-614,29,-4,4,-7,0,3,-1,1,14,21,-7,2,2,0,1
16378,16445,232,250,10,9,9,10,9,8,0,0,16,16,2,2,0,0,1,0,0,0,0,0,-67,-18,1,-1,1,0,0,0,0,22.4,14.8,7.6,4,3,1,1
16013,13614,297,295,5,0,1,5,7,0,1,0,26,18,4,3,2,0,1,0,1,0,0,0,2399,2,5,-4,7,0,8,1,2,50.4,12.4,38,5,4,1,1
15428,15626,258,264,5,6,6,5,8,9,0,1,19,12,3,2,0,0,0,1,0,1,0,0,-198,-6,-1,1,-1,0,7,1,0,21,5.8,15.2,3,2,1,0
16202,15942,280,237,7,8,8,7,10,10,0,0,14,13,2,1,0,1,1,0,0,0,0,0,260,43,-1,1,0,0,1,1,-1,8.8,7.4,1.4,2,4,-2,1
15614,13496,235,243,7,3,3,7,7,1,0,1,19,14,3,4,0,1,0,1,0,1,0,0,2118,-8,4,-4,6,0,5,-1,-1,37.4,13.4,24,2,3,-1,0
19842,14878,302,231,13,6,6,13,14,6,0,1,18,27,4,3,4,0,1,0,0,1,0,0,4964,71,7,-7,8,0,-9,1,4,14.8,15.6,-0.8,4,3,1,1
15357,14337,263,250,6,3,3,6,3,2,0,1,14,15,1,4,0,3,1,0,0,1,0,0,1020,13,3,-3,1,0,-1,-3,-3,7.2,4.2,3,3,1,2,1
16119,13392,254,273,7,1,1,7,11,0,0,0,17,12,3,4,2,0,1,0,0,0,0,0,2727,-19,6,-6,11,0,5,-1,2,36.2,5,31.2,4,2,2,1
13871,17239,213,252,4,10,10,4,4,14,0,0,16,15,1,4,0,2,0,1,0,0,0,0,-3368,-39,-6,6,-10,0,1,-3,-2,36.4,59,-22.6,5,4,1,0
15150,14594,242,255,6,4,4,6,7,6,0,1,18,17,4,3,0,0,0,1,0,1,0,0,556,-13,2,-2,1,0,1,1,0,193,19.2,173.8,5,3,2,1
17529,14369,247,247,12,3,3,12,9,4,0,0,16,21,3,3,0,0,1,0,0,0,0,0,3160,0,9,-9,5,0,-5,0,0,35.2,13.2,22,3,5,-2,1
15935,14536,264,275,7,3,3,7,7,2,0,0,16,99,2,0,3,2,1,0,0,0,0,0,1399,-11,4,-4,5,0,-83,2,1,27.8,61.8,-34,3,5,-2,1
16958,16924,279,278,9,8,8,9,8,8,0,0,17,30,1,3,0,1,1,0,0,0,0,0,34,1,1,-1,0,0,-13,-2,-1,10.8,13,-2.2,4,4,0,0
13904,18659,215,247,4,15,15,4,7,14,0,0,9,14,2,0,0,1,0,1,0,0,0,0,-4755,-32,-11,11,-7,0,-5,2,-1,12.4,14.4,-2,4,4,0,0
15966,13679,258,261,7,2,2,7,11,4,0,1,17,11,2,6,0,1,1,0,0,1,0,0,2287,-3,5,-5,7,0,6,-4,-1,13.6,15.6,-2,3,3,0,1
14719,13221,274,256,4,1,1,4,4,1,0,1,15,17,4,3,0,1,0,1,0,1,0,0,1498,18,3,-3,3,0,-2,1,-1,3.8,6.4,-2.6,0,2,-2,0
12766,14682,245,256,1,5,5,1,0,2,0,0,108,24,5,3,0,1,0,1,0,0,0,0,-1916,-11,-4,4,-2,0,84,2,-1,83.2,21,62.2,3,5,-2,0
15802,14745,246,255,7,5,5,7,5,8,0,1,13,19,3,1,0,0,0,1,0,1,0,0,1057,-9,2,-2,-3,0,-6,2,0,15.2,22.8,-7.6,3,2,1,1
13878,17262,240,274,3,8,8,3,3,13,0,0,26,19,1,0,0,1,0,1,0,0,0,0,-3384,-34,-5,5,-10,0,7,1,-1,143,12.8,130.2,4,3,1,0
15628,14645,287,270,5,3,3,5,6,2,0,0,13,18,4,2,0,0,1,0,0,0,0,0,983,17,2,-2,4,0,-5,2,0,149.4,21.6,127.8,5,5,0,1
15602,16110,242,227,8,10,10,8,7,12,1,0,14,16,4,1,0,1,1,0,1,0,0,0,-508,15,-2,2,-5,0,-2,3,-1,99,25.6,73.4,4,5,-1,0
15174,15712,244,231,6,8,8,6,8,9,0,0,32,15,1,4,0,0,0,1,0,0,0,0,-538,13,-2,2,-1,0,17,-3,0,25.4,106,-80.6,5,4,1,1
12627,17228,259,258,0,9,9,0,0,20,0,1,18,17,3,4,0,3,0,1,0,1,0,0,-4601,1,-9,9,-20,0,1,-1,-3,4.8,4,0.8,1,1,0,0
16241,14952,273,243,7,4,4,7,9,4,0,0,37,15,0,1,0,2,1,0,0,0,0,0,1289,30,3,-3,5,0,22,-1,-2,11,26.6,-15.6,2,3,-1,0
15195,13561,262,266,5,1,1,5,4,1,0,0,13,18,4,0,1,0,1,0,0,0,0,0,1634,-4,4,-4,3,0,-5,4,1,36.4,60,-23.6,5,3,2,1
14163,17131,227,267,5,9,9,5,7,11,0,0,159,18,3,5,0,0,0,1,0,0,0,0,-2968,-40,-4,4,-4,0,141,-2,0,37.8,12.4,25.4,5,2,3,0
15805,16939,284,295,4,8,8,4,8,8,0,0,15,16,3,6,1,1,0,1,0,0,0,0,-1134,-11,-4,4,0,0,-1,-3,0,26.8,60.6,-33.8,5,5,0,1
13579,17099,210,259,3,11,11,3,4,7,0,0,18,16,3,4,0,2,0,1,0,0,0,0,-3520,-49,-8,8,-3,0,2,-1,-2,5.2,36.2,-31,1,4,-3,1
15916,15343,276,244,8,6,6,8,5,7,1,0,18,23,2,5,0,2,0,1,1,0,0,0,573,32,2,-2,-2,0,-5,-3,-2,18,17.4,0.6,4,3,1,1
16061,15429,294,277,6,5,5,6,6,4,0,0,17,37,3,4,1,0,0,1,0,0,0,0,632,17,1,-1,2,0,-20,-1,1,74.6,40.6,34,5,3,2,1
14392,15019,236,259,4,5,5,4,5,8,0,0,15,15,3,4,1,1,0,1,0,0,0,0,-627,-23,-1,1,-3,0,0,-1,0,64.4,37.8,26.6,3,2,1,0
15468,14572,253,242,7,5,5,7,10,6,0,1,17,23,2,2,0,0,1,0,0,1,0,0,896,11,2,-2,4,0,-6,0,0,39.8,34,5.8,4,5,-1,0
15663,15973,273,233,5,8,9,5,6,9,1,0,42,33,1,11,2,1,0,1,1,0,0,0,-310,40,-3,4,-3,0,9,-10,1,144,60.8,83.2,4,3,1,1
13991,14170,258,248,3,4,4,3,4,7,1,0,16,15,2,6,0,0,1,0,1,0,0,0,-179,10,-1,1,-3,0,1,-4,0,13.2,58.6,-45.4,2,5,-3,1
16295,14527,278,272,8,3,3,8,5,1,0,0,13,15,2,2,1,0,1,0,0,0,0,0,1768,6,5,-5,4,0,-2,0,1,19,19.6,-0.6,2,5,-3,0
16565,16915,257,267,9,9,9,9,10,12,0,0,15,18,6,3,1,1,1,0,0,0,0,0,-350,-10,0,0,-2,0,-3,3,0,71.6,47.8,23.8,3,4,-1,0
16601,16369,245,262,9,7,7,9,8,10,0,0,12,16,3,2,1,0,1,0,0,0,0,0,232,-17,2,-2,-2,0,-4,1,1,24.4,10,14.4,3,2,1,0
15333,14224,277,290,5,3,3,5,5,1,0,0,36,18,1,2,0,0,1,0,0,0,0,0,1109,-13,2,-2,4,0,18,-1,0,26.4,11,15.4,5,2,3,1
14723,14603,261,277,4,3,3,4,4,3,0,0,31,45,23,1,1,0,0,1,0,0,0,0,120,-16,1,-1,1,0,-14,22,1,32,13.6,18.4,5,4,1,1
15353,16512,246,255,6,9,9,6,5,9,0,1,11,13,3,3,0,1,0,1,0,1,0,0,-1159,-9,-3,3,-4,0,-2,0,-1,70.8,56.8,14,3,5,-2,1
15807,15395,250,247,6,6,6,6,8,13,0,1,12,15,4,2,0,1,0,1,0,1,0,0,412,3,0,0,-5,0,-3,2,-1,64.6,7,57.6,5,2,3,1
14288,14834,297,296,2,2,2,2,2,2,1,0,13,26,4,1,0,2,1,0,1,0,0,0,-546,1,0,0,0,0,-13,3,-2,10,32,-22,3,5,-2,0
15825,12942,284,272,5,0,0,5,8,0,0,0,14,29,2,2,1,0,1,0,0,0,0,0,2883,12,5,-5,8,0,-15,0,1,17.2,30.8,-13.6,3,2,1,1
15725,15998,252,238,6,8,8,6,13,9,0,0,29,15,1,1,0,0,0,1,0,0,0,0,-273,14,-2,2,4,0,14,0,0,30.2,82.6,-52.4,2,5,-3,0
13383,18299,220,253,4,14,14,4,2,16,0,0,12,32,3,1,0,0,1,0,0,0,0,0,-4916,-33,-10,10,-14,0,-20,2,0,57.6,59.6,-2,4,5,-1,0
18211,16558,270,272,11,7,7,11,9,4,0,0,12,11,2,1,0,3,0,1,0,0,0,0,1653,-2,4,-4,5,0,1,1,-3,81.8,20,61.8,4,3,1,1
16054,16636,278,244,6,8,8,6,8,7,0,0,16,124,1,4,2,3,1,0,0,0,0,0,-582,34,-2,2,1,0,-108,-3,-1,71,17.4,53.6,2,3,-1,1
14961,17080,226,231,5,11,11,5,9,12,0,1,35,25,3,4,0,0,0,1,0,1,0,0,-2119,-5,-6,6,-3,0,10,-1,0,33.4,33.8,-0.4,3,4,-1,1
16463,15825,298,241,5,8,8,5,3,8,0,1,34,28,3,15,3,0,0,1,0,1,0,0,638,57,-3,3,-5,0,6,-12,3,24,60.4,-36.4,3,5,-2,0
15392,13874,276,293,5,1,1,5,3,2,1,0,14,15,3,5,0,0,1,0,1,0,0,0,1518,-17,4,-4,1,0,-1,-2,0,88.6,12.4,76.2,4,3,1,1
14793,14839,265,276,4,4,4,4,6,4,0,0,19,17,3,4,1,0,0,1,0,0,0,0,-46,-11,0,0,2,0,2,-1,1,16.4,11.2,5.2,5,4,1,0
16495,14690,276,252,7,4,4,7,4,9,0,0,19,18,4,4,3,1,0,1,0,0,0,0,1805,24,3,-3,-5,0,1,0,2,30.4,11.4,19,4,4,0,1
14722,13138,255,252,5,1,1,5,3,2,0,0,15,29,4,3,2,1,1,0,0,0,0,0,1584,3,4,-4,1,0,-14,1,1,37,16.4,20.6,2,5,-3,1
15841,14869,301,261,5,4,4,5,4,5,1,0,35,127,3,2,2,0,1,0,1,0,0,0,972,40,1,-1,-1,0,-92,1,2,45.8,66.8,-21,3,3,0,1
15672,16181,260,275,7,7,7,7,6,6,0,0,14,22,3,3,1,2,1,0,0,0,0,0,-509,-15,0,0,0,0,-8,0,-1,30,70.2,-40.2,3,3,0,0
15433,14491,248,255,6,4,5,6,6,5,0,0,20,18,3,7,1,1,1,0,0,0,0,0,942,-7,2,-1,1,0,2,-4,0,21.2,41.4,-20.2,4,3,1,1
18199,18879,252,276,11,14,14,11,11,10,0,1,18,16,1,2,0,0,0,1,0,1,0,0,-680,-24,-3,3,1,0,2,-1,0,17.6,43,-25.4,3,4,-1,1
14649,15688,210,236,6,7,7,6,6,11,0,0,15,48,5,5,0,2,1,0,0,0,0,0,-1039,-26,-1,1,-5,0,-33,0,-2,34.4,78.6,-44.2,4,3,1,1
16145,13535,312,260,6,2,2,6,2,1,1,0,26,97,2,5,0,0,1,0,1,0,0,0,2610,52,4,-4,1,0,-71,-3,0,69.2,48.8,20.4,4,4,0,1
15044,15434,255,291,6,4,4,6,6,3,1,0,15,16,2,3,0,2,0,1,1,0,0,0,-390,-36,2,-2,3,0,-1,-1,-2,49,35.8,13.2,4,5,-1,0
15832,15294,238,268,7,5,5,7,15,6,0,1,18,16,4,3,1,0,1,0,0,1,0,0,538,-30,2,-2,9,0,2,1,1,61,19,42,2,4,-2,0
13225,14453,267,294,1,3,3,1,1,1,0,0,13,13,2,6,0,2,1,0,0,0,0,0,-1228,-27,-2,2,0,0,0,-4,-2,30.4,37.6,-7.2,5,5,0,0
15482,16852,240,264,7,10,10,7,6,8,0,0,16,12,2,1,0,0,1,0,0,0,0,0,-1370,-24,-3,3,-2,0,4,1,0,18.2,28.8,-10.6,3,5,-2,1
15867,14994,272,294,6,4,4,6,8,2,0,1,17,201,4,2,0,0,1,0,0,1,0,0,873,-22,2,-2,6,0,-184,2,0,105,61.8,43.2,2,4,-2,0
14167,16444,257,259,3,7,7,3,3,9,0,0,13,36,8,1,0,0,0,1,0,0,0,0,-2277,-2,-4,4,-6,0,-23,7,0,12.2,73.2,-61,3,5,-2,0
19640,16903,252,232,15,11,11,15,12,9,0,0,15,16,0,3,1,0,0,1,0,0,0,0,2737,20,4,-4,3,0,-1,-3,1,32.8,12.6,20.2,4,3,1,0
16637,16466,210,248,9,8,8,9,20,8,0,0,17,19,3,5,0,0,0,1,0,0,0,0,171,-38,1,-1,12,0,-2,-2,0,14,18.6,-4.6,4,3,1,1
14865,12987,296,239,3,2,2,3,4,0,0,0,16,47,5,2,0,0,1,0,0,0,0,0,1878,57,1,-1,4,0,-31,3,0,27.6,28,-0.4,5,2,3,1
16289,15331,253,266,9,6,6,9,10,5,0,0,29,16,2,3,1,1,1,0,0,0,0,0,958,-13,3,-3,5,0,13,-1,0,39.6,28.8,10.8,4,3,1,0
14520,14787,257,272,4,5,5,4,5,3,0,1,14,15,3,3,0,1,0,1,0,1,0,0,-267,-15,-1,1,2,0,-1,0,-1,10,20,-10,3,3,0,0
13708,13934,255,278,3,2,2,3,4,3,1,0,13,17,1,3,0,0,1,0,1,0,0,0,-226,-23,1,-1,1,0,-4,-2,0,36.6,41.4,-4.8,4,3,1,1
16994,15294,262,256,9,5,5,9,14,10,0,1,13,42,4,0,0,1,1,0,0,1,0,0,1700,6,4,-4,4,0,-29,4,-1,71.4,76.4,-5,4,2,2,0
13726,12917,230,255,4,0,0,4,6,0,0,0,136,16,4,2,0,1,1,0,0,0,0,0,809,-25,4,-4,6,0,120,2,-1,75.2,15.4,59.8,4,3,1,1
14840,13779,265,261,4,2,2,4,8,3,0,0,15,31,4,4,0,1,0,1,0,0,0,0,1061,4,2,-2,5,0,-16,0,-1,26.8,40.2,-13.4,4,5,-1,1
17142,16519,236,234,10,9,9,10,9,14,0,0,14,21,3,2,4,1,1,0,0,0,0,0,623,2,1,-1,-5,0,-7,1,3,77.8,28.2,49.6,4,3,1,1
14692,16401,236,278,5,8,8,5,4,6,0,0,24,14,2,1,1,1,1,0,0,0,0,0,-1709,-42,-3,3,-2,0,10,1,0,35.4,16,19.4,3,4,-1,0
14940,17671,250,251,6,11,11,6,4,17,0,1,250,14,2,2,0,1,0,1,0,1,0,0,-2731,-1,-5,5,-13,0,236,0,-1,32.4,56.4,-24,4,5,-1,0
16139,13495,240,237,9,2,2,9,12,3,0,0,20,24,4,2,1,0,1,0,0,0,0,0,2644,3,7,-7,9,0,-4,2,1,78,26.6,51.4,3,3,0,1
14496,13557,261,253,4,3,3,4,4,4,0,1,189,13,1,2,2,0,1,0,0,1,0,0,939,8,1,-1,0,0,176,-1,2,54,54.6,-0.6,4,5,-1,1
16978,17124,236,232,9,13,13,9,12,16,0,1,12,17,4,1,0,0,0,1,0,1,0,0,-146,4,-4,4,-4,0,-5,3,0,11,44.8,-33.8,4,5,-1,0
16143,16365,278,240,5,8,8,5,7,10,0,0,13,16,4,3,4,0,1,0,0,0,0,0,-222,38,-3,3,-3,0,-3,1,4,37.2,64,-26.8,5,5,0,0
14531,12786,263,265,4,0,0,5,3,0,0,0,23,28,4,2,0,0,1,0,0,0,0,0,1745,-2,4,-5,3,0,-5,2,0,19.8,30.8,-11,3,3,0,0
16463,13577,240,265,8,1,1,8,10,1,0,0,21,34,2,6,1,1,1,0,0,0,0,0,2886,-25,7,-7,9,0,-13,-4,0,63,17.4,45.6,5,4,1,1
14575,15544,252,233,4,6,7,4,2,9,0,0,19,14,0,5,2,0,0,1,0,0,0,0,-969,19,-2,3,-7,0,5,-5,2,21.2,58.6,-37.4,1,5,-4,0
16454,16187,247,240,9,7,7,9,12,7,1,0,16,10,0,1,1,0,1,0,1,0,0,0,267,7,2,-2,5,0,6,-1,1,20.6,68,-47.4,4,5,-1,1
15762,15592,241,258,8,6,6,8,7,4,0,0,19,28,5,3,0,0,1,0,0,0,0,0,170,-17,2,-2,3,0,-9,2,0,54.4,45,9.4,4,4,0,1
15744,11874,248,221,8,0,0,8,7,0,0,0,13,15,2,2,2,0,1,0,0,0,0,0,3870,27,8,-8,7,0,-2,0,2,30.8,10.2,20.6,5,2,3,0
14515,16349,269,292,5,6,6,5,0,5,0,0,15,22,6,2,1,2,0,1,0,0,0,0,-1834,-23,-1,1,-5,0,-7,4,-1,30.8,61.6,-30.8,5,5,0,1
16308,16489,285,282,6,7,7,6,6,8,0,1,26,17,2,1,0,2,1,0,0,1,0,0,-181,3,-1,1,-2,0,9,1,-2,25.4,43.6,-18.2,4,3,1,1
16667,16194,251,235,9,8,8,9,12,11,0,0,20,24,5,3,0,1,0,1,0,0,0,0,473,16,1,-1,1,0,-4,2,-1,13.6,48,-34.4,4,4,0,1
16559,14469,248,277,9,3,3,9,9,2,0,1,20,10,2,3,0,0,1,0,0,1,0,0,2090,-29,6,-6,7,0,10,-1,0,84.2,47.8,36.4,5,4,1,0
16407,13973,283,276,7,2,3,7,9,1,0,0,18,22,2,3,0,0,1,0,0,0,0,0,2434,7,5,-4,8,0,-4,-1,0,40,26.8,13.2,4,3,1,1
16783,15838,257,244,8,7,8,8,8,11,0,0,54,20,2,5,2,0,1,0,0,0,0,0,945,13,1,0,-3,0,34,-3,2,56,59.2,-3.2,3,4,-1,1
15360,15792,260,272,6,5,5,6,8,6,0,0,35,35,2,2,0,2,1,0,0,0,0,0,-432,-12,1,-1,2,0,0,0,-2,34.2,25.4,8.8,5,4,1,1
14700,15480,227,256,6,8,8,6,8,3,0,0,13,15,6,1,0,1,0,1,0,0,0,0,-780,-29,-2,2,5,0,-2,5,-1,15.6,27.2,-11.6,3,4,-1,0
14776,16297,249,260,4,7,7,5,4,9,0,0,15,32,2,2,1,0,0,1,0,0,0,0,-1521,-11,-3,2,-5,0,-17,0,1,26,80.8,-54.8,4,5,-1,0
17139,15487,273,244,9,7,7,9,8,5,0,1,20,24,3,5,2,0,1,0,0,1,0,0,1652,29,2,-2,3,0,-4,-2,2,21.4,14.4,7,4,3,1,1
16510,13918,262,251,7,3,3,7,7,5,0,0,16,14,4,4,1,0,1,0,0,0,0,0,2592,11,4,-4,2,0,2,0,1,9.6,65.4,-55.8,3,4,-1,1
14928,15291,266,245,5,7,7,5,3,6,0,0,15,19,2,2,1,0,1,0,0,0,0,0,-363,21,-2,2,-3,0,-4,0,1,33.8,23.6,10.2,5,3,2,0
17854,14955,270,235,11,5,5,12,9,7,0,0,20,19,4,3,0,0,1,0,0,0,0,0,2899,35,6,-7,2,0,1,1,0,14.4,65.6,-51.2,5,4,1,1
15407,15456,272,243,5,8,8,5,3,8,0,1,17,110,2,6,1,0,0,1,0,1,0,0,-49,29,-3,3,-5,0,-93,-4,1,21,12.4,8.6,4,2,2,0
13951,15902,225,268,4,7,7,4,6,5,0,0,14,24,4,0,0,2,1,0,0,0,0,0,-1951,-43,-3,3,1,0,-10,4,-2,16.6,13.8,2.8,4,3,1,0
17981,12769,284,224,10,2,2,10,14,0,0,0,17,22,5,1,1,0,1,0,0,0,0,0,5212,60,8,-8,14,0,-5,4,1,10.8,16.2,-5.4,3,4,-1,1
15953,14700,274,264,6,4,5,6,7,5,0,1,16,18,1,1,1,0,0,1,0,1,0,0,1253,10,2,-1,2,0,-2,0,1,49.8,19.4,30.4,3,5,-2,0
15085,17957,255,249,6,11,11,6,7,15,0,0,13,35,4,3,0,1,1,0,0,0,0,0,-2872,6,-5,5,-8,0,-22,1,-1,16.8,11.6,5.2,3,3,0,0
16606,14289,271,285,9,2,2,9,9,2,0,1,16,12,3,4,1,1,1,0,0,1,0,0,2317,-14,7,-7,7,0,4,-1,0,13.4,32.8,-19.4,4,4,0,0
15945,15603,261,256,6,7,7,6,9,6,1,0,140,21,4,2,0,1,0,1,1,0,0,0,342,5,-1,1,3,0,119,2,-1,31,18.2,12.8,5,5,0,1
16396,15791,293,268,7,7,7,7,5,9,0,0,33,28,4,3,0,0,0,1,0,0,0,0,605,25,0,0,-4,0,5,1,0,54.8,33.2,21.6,5,4,1,1
13641,14159,256,258,2,3,3,2,2,2,0,1,17,12,3,4,0,1,1,0,0,1,0,0,-518,-2,-1,1,0,0,5,-1,-1,16.8,24.8,-8,3,5,-2,0
14966,14833,293,272,3,5,5,3,4,5,0,1,13,14,3,3,0,0,0,1,0,1,0,0,133,21,-2,2,-1,0,-1,0,0,10,7.8,2.2,2,3,-1,1
15261,15282,293,265,3,5,5,3,4,3,0,0,34,135,2,0,1,0,0,1,0,0,0,0,-21,28,-2,2,1,0,-101,2,1,28.6,94,-65.4,3,5,-2,1
15341,15349,284,264,4,7,7,4,4,4,0,0,14,13,1,1,1,0,1,0,0,0,0,0,-8,20,-3,3,0,0,1,0,1,16,24.4,-8.4,4,4,0,0
15519,14301,215,232,8,4,4,8,10,4,0,1,39,22,4,6,0,1,1,0,0,1,0,0,1218,-17,4,-4,6,0,17,-2,-1,65.8,44,21.8,5,4,1,1
14947,16785,270,284,3,7,7,3,5,6,1,0,32,18,6,1,2,1,0,1,1,0,0,0,-1838,-14,-4,4,-1,0,14,5,1,29.8,16.6,13.2,3,3,0,0
14333,15320,308,280,2,5,5,2,1,2,1,0,16,34,3,1,0,1,0,1,1,0,0,0,-987,28,-3,3,-1,0,-18,2,-1,13.8,55.8,-42,4,4,0,0
14865,15227,289,268,4,5,5,4,1,5,0,0,16,15,3,1,0,0,1,0,0,0,0,0,-362,21,-1,1,-4,0,1,2,0,65.2,48.8,16.4,5,3,2,0
16391,17146,217,226,10,13,13,10,8,12,0,0,19,34,2,2,1,1,1,0,0,0,0,0,-755,-9,-3,3,-4,0,-15,0,0,28.8,85.4,-56.6,4,3,1,1
16034,16102,241,252,8,7,8,8,10,9,0,0,14,20,2,2,0,2,1,0,0,0,0,0,-68,-11,1,0,1,0,-6,0,-2,39.6,41.8,-2.2,2,5,-3,0
15007,15359,230,235,7,7,8,7,6,5,0,0,185,23,3,5,0,1,1,0,0,0,0,0,-352,-5,0,1,1,0,162,-2,-1,39.6,13,26.6,4,3,1,1
15393,15122,293,255,5,5,5,5,6,9,1,0,26,110,8,5,0,0,1,0,1,0,0,0,271,38,0,0,-3,0,-84,3,0,13.2,44.6,-31.4,4,3,1,1
16523,15014,287,288,8,4,4,8,8,3,0,1,14,15,4,2,0,0,0,1,0,1,0,0,1509,-1,4,-4,5,0,-1,2,0,18.8,31.2,-12.4,2,3,-1,1
13566,16684,238,268,4,8,9,4,1,8,1,0,15,18,1,4,0,3,0,1,1,0,0,0,-3118,-30,-4,5,-7,0,-3,-3,-3,72,27.4,44.6,5,4,1,0
14767,13912,273,288,4,1,1,4,5,1,0,1,15,16,5,2,0,0,1,0,0,1,0,0,855,-15,3,-3,4,0,-1,3,0,7.8,27.2,-19.4,3,5,-2,1
15655,16050,252,244,6,9,9,6,7,5,0,0,17,20,3,6,0,1,1,0,0,0,0,0,-395,8,-3,3,2,0,-3,-3,-1,27.6,37.4,-9.8,2,5,-3,1
16225,14496,246,255,8,3,3,8,7,4,0,0,12,18,3,4,1,1,1,0,0,0,0,0,1729,-9,5,-5,3,0,-6,-1,0,13.2,71.6,-58.4,5,3,2,1
15221,15959,260,261,6,7,7,6,4,6,0,0,140,12,2,1,2,1,0,1,0,0,0,0,-738,-1,-1,1,-2,0,128,1,1,27,14.8,12.2,3,3,0,1
15658,14085,299,294,5,2,2,5,6,1,0,0,16,16,4,2,0,0,0,1,0,0,0,0,1573,5,3,-3,5,0,0,2,0,109.8,14.6,95.2,4,4,0,1
17645,15639,230,239,13,6,6,13,18,7,0,0,19,16,3,6,0,0,1,0,0,0,0,0,2006,-9,7,-7,11,0,3,-3,0,8.8,11.4,-2.6,3,5,-2,0
13817,16512,272,285,2,7,7,2,0,7,0,0,19,17,3,3,0,1,0,1,0,0,0,0,-2695,-13,-5,5,-7,0,2,0,-1,24,9.6,14.4,3,4,-1,0
16480,15501,268,275,7,5,5,7,10,11,0,0,86,13,2,4,3,0,1,0,0,0,0,0,979,-7,2,-2,-1,0,73,-2,3,43.8,20.2,23.6,4,4,0,1
14814,14031,259,280,3,2,2,3,4,1,0,0,23,19,0,3,1,0,1,0,0,0,0,0,783,-21,1,-1,3,0,4,-3,1,23.8,61.4,-37.6,2,3,-1,1
18867,15644,258,247,12,6,6,12,19,7,0,0,17,36,2,1,2,0,0,1,0,0,0,0,3223,11,6,-6,12,0,-19,1,2,34.2,8.2,26,3,3,0,1
15005,15139,278,273,3,5,6,3,4,7,1,0,154,18,2,3,0,0,1,0,1,0,0,0,-134,5,-2,3,-3,0,136,-1,0,33.8,139,-105.2,4,4,0,1
18694,16126,280,221,12,6,6,12,11,9,0,0,12,22,2,0,0,2,1,0,0,0,0,0,2568,59,6,-6,2,0,-10,2,-2,13,57.2,-44.2,4,5,-1,1
15467,13728,296,283,4,1,1,4,5,0,0,1,14,22,5,0,0,0,1,0,0,1,0,0,1739,13,3,-3,5,0,-8,5,0,11.8,12.4,-0.6,4,3,1,0
14921,15288,256,234,5,7,7,5,1,9,0,0,11,38,3,1,0,0,0,1,0,0,0,0,-367,22,-2,2,-8,0,-27,2,0,5.8,93.2,-87.4,1,3,-2,0
14571,14903,244,256,5,4,4,5,3,4,0,0,37,17,2,1,0,0,0,1,0,0,0,0,-332,-12,1,-1,-1,0,20,1,0,110.8,10.6,100.2,4,5,-1,1
15149,15327,293,271,4,5,5,4,3,7,0,1,13,13,2,1,0,0,0,1,0,1,0,0,-178,22,-1,1,-4,0,0,1,0,28.4,9.6,18.8,5,3,2,0
15645,14507,253,230,6,5,5,7,5,3,1,0,17,37,2,5,2,1,1,0,1,0,0,0,1138,23,1,-2,2,0,-20,-3,1,69,50.6,18.4,3,5,-2,1
16281,14097,278,258,8,3,3,8,5,2,0,1,18,17,2,1,0,1,1,0,0,1,0,0,2184,20,5,-5,3,0,1,1,-1,15.2,6.8,8.4,4,1,3,1
15926,16136,229,290,8,7,7,8,9,5,0,0,31,27,4,4,1,2,0,1,0,0,0,0,-210,-61,1,-1,4,0,4,0,-1,32,83.6,-51.6,4,4,0,1
13980,17707,213,243,4,12,12,4,3,14,0,0,14,17,2,2,0,0,0,1,0,0,0,0,-3727,-30,-8,8,-11,0,-3,0,0,32.4,22.2,10.2,4,4,0,0
16423,14877,249,246,9,6,6,9,6,4,0,0,16,15,0,1,3,1,1,0,0,0,0,0,1546,3,3,-3,2,0,1,-1,2,35.4,8.6,26.8,5,3,2,1
19925,14557,248,237,17,4,4,17,21,4,1,0,15,17,3,3,2,1,1,0,1,0,0,0,5368,11,13,-13,17,0,-2,0,1,11,7.4,3.6,4,2,2,1
15309,15660,264,260,5,6,6,5,6,5,0,0,19,19,1,6,0,0,0,1,0,0,0,0,-351,4,-1,1,1,0,0,-5,0,18,85.6,-67.6,4,4,0,0
14405,17306,252,235,4,11,11,4,4,19,0,0,16,34,1,4,1,0,0,1,0,0,0,0,-2901,17,-7,7,-15,0,-18,-3,1,20.4,45.2,-24.8,5,5,0,0
16904,16070,257,210,9,10,10,10,11,8,0,0,64,16,3,0,3,2,0,1,0,0,0,0,834,47,-1,0,3,0,48,3,1,9.4,18.4,-9,3,3,0,0
15955,14903,252,251,6,5,5,6,10,6,0,0,17,34,4,2,3,1,1,0,0,0,0,0,1052,1,1,-1,4,0,-17,2,2,31.8,51,-19.2,2,3,-1,0
15717,16912,256,255,6,9,9,6,5,10,1,0,17,17,5,6,1,0,0,1,1,0,0,0,-1195,1,-3,3,-5,0,0,-1,1,57,10.2,46.8,3,4,-1,0
15349,16234,253,247,3,8,8,3,7,10,0,0,31,16,3,1,1,1,0,1,0,0,0,0,-885,6,-5,5,-3,0,15,2,0,19.4,46.8,-27.4,5,3,2,1
15384,16070,223,265,7,7,7,7,7,7,0,0,13,11,1,3,1,0,0,1,0,0,0,0,-686,-42,0,0,0,0,2,-2,1,25.8,18,7.8,4,2,2,1
15165,13732,312,255,3,2,2,3,3,4,1,0,17,35,4,1,0,1,0,1,1,0,0,0,1433,57,1,-1,-1,0,-18,3,-1,28.6,72.4,-43.8,3,5,-2,0
12904,18276,236,269,1,11,11,1,1,12,0,0,102,15,1,4,0,2,0,1,0,0,0,0,-5372,-33,-10,10,-11,0,87,-3,-2,31.2,23.4,7.8,2,4,-2,0
15836,13867,252,242,8,3,3,8,9,4,0,0,19,18,6,3,1,0,1,0,0,0,0,0,1969,10,5,-5,5,0,1,3,1,25,72.6,-47.6,4,4,0,1
18627,18916,227,213,14,16,16,14,13,25,0,0,16,25,1,2,1,0,0,1,0,0,0,0,-289,14,-2,2,-12,0,-9,-1,1,44,11.2,32.8,4,4,0,1
16151,14640,287,296,7,3,3,7,6,3,0,0,142,16,3,4,0,0,1,0,0,0,0,0,1511,-9,4,-4,3,0,126,-1,0,25.2,9.8,15.4,4,4,0,1
17756,14585,268,245,11,5,5,11,20,4,1,0,19,121,4,5,2,0,1,0,1,0,0,0,3171,23,6,-6,16,0,-102,-1,2,24,16,8,5,3,2,1
15592,16546,263,245,6,8,8,6,5,7,0,1,15,108,1,1,1,2,0,1,0,1,0,0,-954,18,-2,2,-2,0,-93,0,-1,31.8,10.6,21.2,5,2,3,1
15459,13418,334,270,3,1,1,3,1,1,1,0,30,15,4,3,1,0,1,0,1,0,0,0,2041,64,2,-2,0,0,15,1,1,12.4,43,-30.6,2,2,0,0
14409,15458,272,237,3,7,7,3,2,7,0,0,38,15,2,5,0,0,0,1,0,0,0,0,-1049,35,-4,4,-5,0,23,-3,0,56.6,5.8,50.8,5,1,4,0
15862,16452,248,232,7,9,9,7,8,12,0,0,22,39,2,4,3,0,1,0,0,0,0,0,-590,16,-2,2,-4,0,-17,-2,3,15.6,12,3.6,5,4,1,0
15297,17705,244,232,7,10,10,7,8,17,0,0,17,14,0,1,1,0,0,1,0,0,0,0,-2408,12,-3,3,-9,0,3,-1,1,4.6,63,-58.4,2,3,-1,0
13701,16321,258,254,2,8,8,2,1,10,0,0,12,15,5,1,1,1,0,1,0,0,0,0,-2620,4,-6,6,-9,0,-3,4,0,21,19,2,4,5,-1,0
15590,14297,251,250,9,4,4,10,6,4,1,0,15,41,2,4,2,0,1,0,1,0,0,0,1293,1,5,-6,2,0,-26,-2,2,30.8,8.6,22.2,4,4,0,1
16233,14728,271,261,7,3,3,7,10,5,1,0,19,16,3,5,2,0,1,0,1,0,0,0,1505,10,4,-4,5,0,3,-2,2,31.2,37.2,-6,5,5,0,1
15132,15392,265,265,5,7,8,5,2,5,0,1,13,22,2,3,0,0,1,0,0,1,0,0,-260,0,-2,3,-3,0,-9,-1,0,17.8,22.6,-4.8,3,4,-1,1
16369,14592,249,279,9,2,2,9,10,3,0,0,29,15,3,0,1,0,1,0,0,0,0,0,1777,-30,7,-7,7,0,14,3,1,76.8,18.2,58.6,4,2,2,1
17129,13922,295,241,11,3,3,11,8,3,0,0,14,15,3,2,1,0,1,0,0,0,0,0,3207,54,8,-8,5,0,-1,1,1,23.2,7.4,15.8,4,3,1,1
17312,14275,275,244,12,4,5,12,8,1,1,0,16,16,2,1,0,0,0,1,1,0,0,0,3037,31,8,-7,7,0,0,1,0,5.8,63.6,-57.8,2,4,-2,1
14561,15613,260,269,3,6,6,3,5,3,0,0,123,16,4,2,0,3,1,0,0,0,0,0,-1052,-9,-3,3,2,0,107,2,-3,13.2,15.4,-2.2,4,3,1,0
14388,16524,251,246,4,10,10,4,2,12,0,1,13,17,2,1,0,3,0,1,0,1,0,0,-2136,5,-6,6,-10,0,-4,1,-3,44.6,19.6,25,2,4,-2,0
17880,14930,255,211,11,7,7,11,10,9,0,1,13,16,5,1,2,0,1,0,0,1,0,0,2950,44,4,-4,1,0,-3,4,2,79.8,102.6,-22.8,4,4,0,1
14704,15471,203,238,7,8,8,7,6,9,0,0,18,13,0,2,0,0,1,0,0,0,0,0,-767,-35,-1,1,-3,0,5,-2,0,61.4,18.2,43.2,4,4,0,1
15437,16545,287,259,5,8,8,5,6,12,0,1,34,16,6,2,0,2,1,0,0,1,0,0,-1108,28,-3,3,-6,0,18,4,-2,21.4,15.6,5.8,5,5,0,0
15759,16414,253,240,6,10,10,6,6,17,0,1,20,23,2,4,1,0,0,1,0,1,0,0,-655,13,-4,4,-11,0,-3,-2,1,13.2,45.8,-32.6,4,5,-1,1
14507,16966,231,266,5,10,10,5,6,11,0,0,17,18,5,4,1,3,0,1,0,0,0,0,-2459,-35,-5,5,-5,0,-1,1,-2,17,15.4,1.6,4,3,1,0
15666,16158,249,266,6,7,7,6,6,5,0,0,36,15,2,3,1,0,0,1,0,0,0,0,-492,-17,-1,1,1,0,21,-1,1,9.8,10.4,-0.6,3,3,0,1
16669,14498,274,257,8,4,4,8,8,3,1,0,42,18,4,3,1,1,1,0,1,0,0,0,2171,17,4,-4,5,0,24,1,0,78.2,69.2,9,4,3,1,1
15919,14037,275,247,5,3,3,5,6,4,0,0,14,15,4,4,2,0,1,0,0,0,0,0,1882,28,2,-2,2,0,-1,0,2,9.2,11.6,-2.4,3,3,0,1
15608,14274,278,278,6,2,2,6,6,3,0,0,13,14,4,3,2,0,0,1,0,0,0,0,1334,0,4,-4,3,0,-1,1,2,51.6,57,-5.4,5,5,0,1
13848,15937,236,255,3,7,7,3,4,9,0,0,11,16,3,1,0,0,0,1,0,0,0,0,-2089,-19,-4,4,-5,0,-5,2,0,16,37.4,-21.4,3,5,-2,0
15888,15957,265,266,6,6,6,7,5,4,0,0,45,33,3,3,2,2,1,0,0,0,0,0,-69,-1,0,-1,1,0,12,0,0,5.6,37.6,-32,3,4,-1,0
15918,14626,292,240,5,6,6,6,5,4,0,0,15,21,4,1,1,0,0,1,0,0,0,0,1292,52,-1,0,1,0,-6,3,1,8.4,41.6,-33.2,2,4,-2,1
16526,14260,254,227,7,5,5,7,12,3,0,0,12,16,8,3,1,1,1,0,0,0,0,0,2266,27,2,-2,9,0,-4,5,0,9.6,29.6,-20,2,3,-1,0
15850,15494,210,227,8,9,9,8,8,6,0,0,29,17,5,4,1,0,0,1,0,0,0,0,356,-17,-1,1,2,0,12,1,1,40.4,14.8,25.6,3,3,0,0
15553,16512,259,215,6,10,10,6,5,12,0,0,20,15,4,4,1,0,0,1,0,0,0,0,-959,44,-4,4,-7,0,5,0,1,11.2,36.2,-25,3,3,0,0
17157,14766,257,222,9,6,6,9,12,10,0,1,18,37,8,5,1,0,1,0,0,1,0,0,2391,35,3,-3,2,0,-19,3,1,59.8,22.6,37.2,5,2,3,1
14632,14169,268,281,3,2,2,3,4,2,0,0,17,17,2,0,0,0,0,1,0,0,0,0,463,-13,1,-1,2,0,0,2,0,40.4,43.8,-3.4,4,5,-1,0
14242,13873,271,256,3,3,3,3,2,2,0,0,17,12,6,1,0,0,0,1,0,0,0,0,369,15,0,0,0,0,5,5,0,39.2,49,-9.8,3,3,0,0
14454,14316,259,276,4,4,4,4,2,1,0,0,38,16,2,4,0,1,0,1,0,0,0,0,138,-17,0,0,1,0,22,-2,-1,104.4,12.8,91.6,5,4,1,0
15081,15221,275,296,5,4,4,5,8,2,0,0,14,22,3,3,0,1,1,0,0,0,0,0,-140,-21,1,-1,6,0,-8,0,-1,65.4,53.6,11.8,5,3,2,1
17261,17285,253,236,9,11,11,9,11,13,0,0,18,16,3,1,3,0,0,1,0,0,0,0,-24,17,-2,2,-2,0,2,2,3,20,16.2,3.8,3,3,0,1
16595,14831,262,278,8,4,4,8,8,2,0,0,21,18,2,4,0,0,0,1,0,0,0,0,1764,-16,4,-4,6,0,3,-2,0,33.4,25,8.4,3,4,-1,0
16424,14025,268,251,8,2,2,8,11,2,0,0,16,18,3,3,1,0,1,0,0,0,0,0,2399,17,6,-6,9,0,-2,0,1,26.8,38.4,-11.6,4,4,0,1
14635,14561,252,268,4,4,4,4,5,3,1,0,17,13,1,5,0,1,0,1,1,0,0,0,74,-16,0,0,2,0,4,-4,-1,78.2,51.6,26.6,3,4,-1,1
16971,13823,230,208,11,4,4,11,11,6,0,0,24,14,1,1,0,0,1,0,0,0,0,0,3148,22,7,-7,5,0,10,0,0,40.4,24.2,16.2,5,4,1,1
15816,14921,262,262,7,4,4,7,12,5,0,0,24,24,4,3,0,1,1,0,0,0,0,0,895,0,3,-3,7,0,0,1,-1,34.8,15.2,19.6,4,4,0,1
13843,13528,234,276,5,2,2,5,2,0,0,0,12,37,4,2,0,0,0,1,0,0,0,0,315,-42,3,-3,2,0,-25,2,0,56.4,62.8,-6.4,4,3,1,1
17890,12372,291,218,10,1,1,10,14,1,0,0,15,30,4,0,3,0,1,0,0,0,0,0,5518,73,9,-9,13,0,-15,4,3,24.4,28,-3.6,4,4,0,1
15513,15293,265,249,7,7,7,7,5,6,0,1,20,37,1,2,1,2,0,1,0,1,0,0,220,16,0,0,-1,0,-17,-1,-1,66.4,53,13.4,4,3,1,0
15260,13807,219,244,8,4,4,8,6,3,0,1,13,14,0,3,0,0,0,1,0,1,0,0,1453,-25,4,-4,3,0,-1,-3,0,39.2,32.4,6.8,5,3,2,1
15105,14988,212,254,6,6,6,6,8,4,0,1,14,18,1,0,0,0,0,1,0,1,0,0,117,-42,0,0,4,0,-4,1,0,26.4,34.6,-8.2,5,4,1,1
16768,14259,268,271,7,3,4,8,9,3,0,0,14,17,5,0,1,0,0,1,0,0,0,0,2509,-3,4,-4,6,0,-3,5,1,113.6,15.8,97.8,3,3,0,1
16131,14402,241,232,9,5,5,9,11,7,0,0,19,16,3,2,1,0,0,1,0,0,0,0,1729,9,4,-4,4,0,3,1,1,40.4,57.4,-17,4,3,1,1
14056,15073,283,269,2,5,5,2,3,3,1,0,35,19,6,5,0,0,0,1,1,0,0,0,-1017,14,-3,3,0,0,16,1,0,24.4,67.8,-43.4,5,4,1,1
18086,14073,242,219,14,5,5,14,14,5,0,0,20,14,2,6,0,0,0,1,0,0,0,0,4013,23,9,-9,9,0,6,-4,0,17.8,49,-31.2,5,4,1,1
18826,18162,250,262,11,12,12,11,13,18,0,0,19,24,3,2,2,0,1,0,0,0,0,0,664,-12,-1,1,-5,0,-5,1,2,122.4,30.4,92,4,3,1,1
14876,14247,247,286,5,2,2,5,4,1,1,0,14,45,22,0,1,4,1,0,1,0,0,0,629,-39,3,-3,3,0,-31,22,-3,21.6,23,-1.4,3,5,-2,1
15450,16335,250,256,6,8,8,6,5,10,0,1,102,13,1,4,1,1,1,0,0,1,0,0,-885,-6,-2,2,-5,0,89,-3,0,16,32.8,-16.8,3,4,-1,0
15449,13970,249,227,7,5,5,7,7,3,0,0,14,18,1,0,0,0,0,1,0,0,0,0,1479,22,2,-2,4,0,-4,1,0,6.2,7.4,-1.2,2,2,0,0
16196,16000,268,216,7,9,9,7,5,7,0,0,21,13,1,4,1,1,0,1,0,0,0,0,196,52,-2,2,-2,0,8,-3,0,59.2,19.6,39.6,5,4,1,1
15422,14771,286,254,5,4,4,5,5,4,0,0,15,16,2,6,0,0,0,1,0,0,0,0,651,32,1,-1,1,0,-1,-4,0,13.6,54.6,-41,4,4,0,1
13714,14343,260,263,2,4,4,2,2,7,0,0,18,18,4,3,1,0,1,0,0,0,0,0,-629,-3,-2,2,-5,0,0,1,1,38.8,80.8,-42,4,4,0,0
14062,15129,258,277,3,4,4,3,2,6,0,0,21,41,1,3,0,0,1,0,0,0,0,0,-1067,-19,-1,1,-4,0,-20,-2,0,79.6,27,52.6,4,5,-1,1
15020,14873,239,301,5,3,3,5,5,2,0,1,18,13,2,7,0,1,0,1,0,1,0,0,147,-62,2,-2,3,0,5,-5,-1,30.4,10.8,19.6,4,4,0,0
13531,15450,228,260,3,6,6,3,7,5,0,0,33,14,1,1,0,2,1,0,0,0,0,0,-1919,-32,-3,3,2,0,19,0,-2,62.6,41.2,21.4,5,5,0,1
15180,15638,269,227,5,8,8,5,4,10,0,0,155,28,2,3,0,0,0,1,0,0,0,0,-458,42,-3,3,-6,0,127,-1,0,18,26.8,-8.8,3,4,-1,0
13349,14703,246,278,2,4,4,2,2,2,0,1,43,12,3,3,0,0,0,1,0,1,0,0,-1354,-32,-2,2,0,0,31,0,0,32.6,55.2,-22.6,4,4,0,0
15947,17878,224,241,7,12,12,7,15,19,0,0,18,26,2,3,0,0,0,1,0,0,0,0,-1931,-17,-5,5,-4,0,-8,-1,0,8.6,62.4,-53.8,3,5,-2,0
15835,14047,248,248,8,3,3,8,11,4,0,0,16,15,5,3,0,0,1,0,0,0,0,0,1788,0,5,-5,7,0,1,2,0,32.8,25.8,7,5,4,1,1
17669,18683,225,261,11,12,12,12,14,13,0,0,13,13,3,0,1,4,1,0,0,0,0,0,-1014,-36,-1,0,1,0,0,3,-3,6,37.2,-31.2,3,4,-1,1
18309,13572,272,237,13,2,2,13,12,2,0,0,17,16,2,1,4,0,1,0,0,0,0,0,4737,35,11,-11,10,0,1,1,4,17,64,-47,3,3,0,0
15079,14957,278,278,4,4,4,4,5,2,1,0,14,9,1,5,0,1,0,1,1,0,0,0,122,0,0,0,3,0,5,-4,-1,64.2,26.2,38,5,5,0,1
15634,15684,270,274,5,6,6,5,6,7,0,1,37,16,3,3,0,0,1,0,0,1,0,0,-50,-4,-1,1,-1,0,21,0,0,19.8,14,5.8,5,2,3,0
16701,13926,298,259,7,3,3,7,7,4,0,1,107,16,1,2,3,0,1,0,0,1,0,0,2775,39,4,-4,3,0,91,-1,3,46,14.6,31.4,3,2,1,1
15406,15219,262,280,6,5,5,6,9,6,0,1,17,13,2,6,0,0,0,1,0,1,0,0,187,-18,1,-1,3,0,4,-4,0,14.6,54.4,-39.8,3,4,-1,0
15306,14013,268,262,4,3,3,4,6,3,0,0,35,104,5,4,1,0,0,1,0,0,0,0,1293,6,1,-1,3,0,-69,1,1,74,46.4,27.6,5,4,1,1
17452,13448,294,258,8,2,2,8,14,3,1,0,114,19,1,2,1,0,0,1,1,0,0,0,4004,36,6,-6,11,0,95,-1,1,19.4,53.4,-34,4,4,0,1
14998,14389,284,238,4,4,4,4,3,5,0,0,48,47,4,4,1,0,0,1,0,0,0,0,609,46,0,0,-2,0,1,0,1,23.6,57.4,-33.8,4,4,0,0
15640,14828,271,252,5,4,4,5,6,5,0,0,18,108,2,5,2,1,0,1,0,0,0,0,812,19,1,-1,1,0,-90,-3,1,9.6,108.2,-98.6,4,3,1,1
15903,16178,289,283,5,6,6,6,6,11,1,0,15,31,5,3,1,0,1,0,1,0,0,0,-275,6,-1,0,-5,0,-16,2,1,80.2,56.8,23.4,4,4,0,0
16237,13652,286,229,6,3,3,6,5,3,0,0,11,13,4,0,1,0,1,0,0,0,0,0,2585,57,3,-3,2,0,-2,4,1,20.4,21.6,-1.2,3,4,-1,1
14858,16812,264,256,4,8,8,4,1,9,0,0,124,21,5,5,2,1,0,1,0,0,0,0,-1954,8,-4,4,-8,0,103,0,1,35,12.4,22.6,3,4,-1,0
13075,16694,272,303,0,6,6,0,0,4,0,0,30,16,2,2,0,3,0,1,0,0,0,0,-3619,-31,-6,6,-4,0,14,0,-3,96,45.2,50.8,5,4,1,0
13942,14157,259,269,2,1,1,2,1,1,0,0,20,55,4,6,1,2,0,1,0,0,0,0,-215,-10,1,-1,0,0,-35,-2,-1,36.4,10.8,25.6,4,4,0,1
15186,15891,238,274,7,6,6,7,6,4,0,1,20,16,5,4,0,0,0,1,0,1,0,0,-705,-36,1,-1,2,0,4,1,0,20.4,16.8,3.6,3,4,-1,1
15506,14943,293,302,4,3,3,4,7,4,1,0,18,14,4,5,0,1,0,1,1,0,0,0,563,-9,1,-1,3,0,4,-1,-1,56.6,66.4,-9.8,4,4,0,1
13935,16162,288,282,1,7,7,1,1,10,0,1,13,18,2,1,0,0,0,1,0,1,0,0,-2227,6,-6,6,-9,0,-5,1,0,50.4,24,26.4,4,3,1,1
15416,13721,296,266,4,2,2,4,4,3,0,1,18,42,2,4,0,1,1,0,0,1,0,0,1695,30,2,-2,1,0,-24,-2,-1,64.8,71.8,-7,5,3,2,1
15885,13735,271,268,7,2,2,7,6,0,1,0,19,15,3,6,2,0,1,0,1,0,0,0,2150,3,5,-5,6,0,4,-3,2,18.4,45.4,-27,4,5,-1,1
18288,17738,207,243,13,12,12,13,17,12,0,0,30,18,3,1,1,1,0,1,0,0,0,0,550,-36,1,-1,5,0,12,2,0,62.6,6.8,55.8,3,2,1,1
17893,13554,258,230,12,2,2,12,11,3,0,0,25,20,2,4,1,0,1,0,0,0,0,0,4339,28,10,-10,8,0,5,-2,1,106.8,24.4,82.4,4,4,0,1
14762,17877,235,294,5,11,11,5,5,13,0,0,18,17,2,1,0,1,0,1,0,0,0,0,-3115,-59,-6,6,-8,0,1,1,-1,78.6,27,51.6,4,4,0,0
15239,15538,236,247,7,8,8,7,7,7,0,0,28,14,5,4,2,1,0,1,0,0,0,0,-299,-11,-1,1,0,0,14,1,1,57.4,59.8,-2.4,4,5,-1,1
14246,15061,278,249,2,6,6,2,4,6,0,1,36,18,3,0,1,1,0,1,0,1,0,0,-815,29,-4,4,-2,0,18,3,0,29.2,24.6,4.6,3,4,-1,0
15971,16023,229,267,9,6,6,9,9,4,1,0,18,15,3,5,0,1,1,0,1,0,0,0,-52,-38,3,-3,5,0,3,-2,-1,61.4,19,42.4,4,3,1,1
15272,13453,273,262,5,2,2,5,5,0,0,0,12,18,5,1,0,0,1,0,0,0,0,0,1819,11,3,-3,5,0,-6,4,0,6.8,27.4,-20.6,3,5,-2,0
14473,15998,266,267,3,7,7,3,4,15,0,1,15,25,2,1,0,0,1,0,0,1,0,0,-1525,-1,-4,4,-11,0,-10,1,0,18,24.2,-6.2,4,5,-1,0
14338,15247,272,251,3,7,7,3,3,7,0,1,13,9,0,2,0,0,0,1,0,1,0,0,-909,21,-4,4,-4,0,4,-2,0,21.4,39.4,-18,3,4,-1,0
13733,16411,260,294,2,8,8,2,1,11,0,1,11,50,3,3,0,0,0,1,0,1,0,0,-2678,-34,-6,6,-10,0,-39,0,0,54.4,53.4,1,4,2,2,0
14743,14818,267,236,4,5,5,4,2,7,0,0,17,16,2,2,0,0,0,1,0,0,0,0,-75,31,-1,1,-5,0,1,0,0,70.8,30.8,40,4,3,1,1
16681,13656,252,237,8,4,4,8,6,1,0,0,16,16,0,3,1,0,0,1,0,0,0,0,3025,15,4,-4,5,0,0,-3,1,113,62.6,50.4,4,2,2,1
14659,15928,289,270,3,7,7,3,3,9,0,1,18,37,2,5,0,0,0,1,0,1,0,0,-1269,19,-4,4,-6,0,-19,-3,0,48.6,81.8,-33.2,4,5,-1,1
15121,17626,260,255,5,12,12,5,8,22,0,1,18,18,5,2,1,1,0,1,0,1,0,0,-2505,5,-7,7,-14,0,0,3,0,16.4,22,-5.6,4,5,-1,0
14717,15460,244,267,5,5,5,5,7,4,0,0,95,15,3,2,2,2,0,1,0,0,0,0,-743,-23,0,0,3,0,80,1,0,10.8,30.6,-19.8,3,4,-1,0
15468,15498,261,255,6,5,5,6,8,10,0,0,20,19,2,4,0,0,1,0,0,0,0,0,-30,6,1,-1,-2,0,1,-2,0,11.8,21,-9.2,4,4,0,1
14131,15460,259,273,3,6,6,3,3,8,0,1,19,17,3,1,0,1,0,1,0,1,0,0,-1329,-14,-3,3,-5,0,2,2,-1,54.8,4.8,50,4,1,3,0
16090,13002,269,278,8,0,0,8,12,0,0,0,36,15,3,6,0,0,1,0,0,0,0,0,3088,-9,8,-8,12,0,21,-3,0,67.6,37.4,30.2,4,5,-1,1
15900,15030,216,252,10,6,6,10,9,3,0,0,21,17,3,3,0,1,1,0,0,0,0,0,870,-36,4,-4,6,0,4,0,-1,49.4,10.4,39,4,3,1,1
15260,14176,272,274,4,2,2,4,5,4,0,0,18,32,4,4,0,0,1,0,0,0,0,0,1084,-2,2,-2,1,0,-14,0,0,12.6,48.4,-35.8,3,4,-1,1
15081,13999,312,273,3,3,3,3,1,2,0,1,13,19,2,3,1,0,0,1,0,1,0,0,1082,39,0,0,-1,0,-6,-1,1,16,52.2,-36.2,3,5,-2,1
15545,15052,280,273,6,5,5,6,4,4,1,0,10,15,3,3,2,0,1,0,1,0,0,0,493,7,1,-1,0,0,-5,0,2,49.8,41,8.8,4,5,-1,0
12863,15492,242,274,1,5,5,1,0,6,0,0,52,21,4,3,0,2,0,1,0,0,0,0,-2629,-32,-4,4,-6,0,31,1,-2,62.2,65.4,-3.2,3,4,-1,0
14095,15896,271,275,2,6,6,2,3,7,0,0,60,15,1,7,0,0,0,1,0,0,0,0,-1801,-4,-4,4,-4,0,45,-6,0,16.4,7.6,8.8,3,2,1,1
16684,17653,259,236,11,13,13,11,10,12,0,1,16,11,1,5,0,0,1,0,0,1,0,0,-969,23,-2,2,-2,0,5,-4,0,8,23.8,-15.8,2,5,-3,0
13096,16438,237,274,3,8,8,3,3,6,1,0,11,33,2,2,0,5,0,1,1,0,0,0,-3342,-37,-5,5,-3,0,-22,0,-5,92.6,84.2,8.4,4,4,0,0
15139,15885,257,271,4,7,7,4,6,5,0,0,17,15,2,3,0,0,1,0,0,0,0,0,-746,-14,-3,3,1,0,2,-1,0,96.4,95.6,0.8,3,4,-1,0
16170,15644,233,220,9,7,7,9,9,11,0,1,16,21,6,3,2,1,0,1,0,1,0,0,526,13,2,-2,-2,0,-5,3,1,17.6,14.4,3.2,5,3,2,1
14185,15759,266,248,2,7,7,3,2,8,0,0,17,18,5,5,0,1,0,1,0,0,0,0,-1574,18,-5,4,-6,0,-1,0,-1,75.2,61.4,13.8,4,5,-1,1
15723,15073,294,261,7,5,5,7,6,4,1,0,13,27,2,3,0,0,1,0,1,0,0,0,650,33,2,-2,2,0,-14,-1,0,31,16.8,14.2,5,2,3,1
14060,14794,263,255,2,5,5,3,4,8,0,0,38,15,4,3,0,0,0,1,0,0,0,0,-734,8,-3,2,-4,0,23,1,0,57.4,88,-30.6,5,5,0,1
15287,16790,277,270,4,7,8,4,4,8,0,0,17,37,3,8,0,2,1,0,0,0,0,0,-1503,7,-3,4,-4,0,-20,-5,-2,34.8,66.4,-31.6,4,4,0,0
16136,15882,236,252,8,7,7,8,9,5,0,1,10,27,0,1,2,1,1,0,0,1,0,0,254,-16,1,-1,4,0,-17,-1,1,44.6,52.8,-8.2,5,5,0,0
14312,15978,262,259,3,7,7,3,4,6,1,0,15,17,2,4,0,0,1,0,1,0,0,0,-1666,3,-4,4,-2,0,-2,-2,0,72,67.8,4.2,5,3,2,1
15376,14167,247,265,7,3,3,7,5,2,0,0,22,143,6,1,0,1,1,0,0,0,0,0,1209,-18,4,-4,3,0,-121,5,-1,25.8,8.8,17,3,2,1,0
16056,15053,237,294,9,3,3,9,12,1,0,0,17,17,5,1,1,2,0,1,0,0,0,0,1003,-57,6,-6,11,0,0,4,-1,26.8,28.8,-2,2,4,-2,1
15410,15740,245,265,6,7,7,6,5,8,0,0,29,20,4,5,2,0,1,0,0,0,0,0,-330,-20,-1,1,-3,0,9,-1,2,22,15.4,6.6,4,4,0,1
15924,15399,280,261,5,6,6,5,7,4,1,0,15,18,4,3,1,1,1,0,1,0,0,0,525,19,-1,1,3,0,-3,1,0,18,14.8,3.2,2,3,-1,1
15526,16666,257,249,6,9,9,6,6,8,1,0,10,32,2,1,0,3,0,1,1,0,0,0,-1140,8,-3,3,-2,0,-22,1,-3,25,39.4,-14.4,4,3,1,0
16888,17711,261,276,9,10,10,9,10,10,0,0,13,123,3,6,0,2,1,0,0,0,0,0,-823,-15,-1,1,0,0,-110,-3,-2,43.2,5.6,37.6,4,1,3,0
15221,13819,307,256,4,2,2,4,1,3,0,0,12,15,2,0,0,1,1,0,0,0,0,0,1402,51,2,-2,-2,0,-3,2,-1,54,23,31,5,3,2,1
13872,13970,241,233,3,4,4,3,5,3,0,0,14,16,3,1,1,0,1,0,0,0,0,0,-98,8,-1,1,2,0,-2,2,1,7.4,111.4,-104,3,5,-2,1
13847,15604,242,270,4,6,6,4,2,6,0,0,14,16,4,2,0,0,0,1,0,0,0,0,-1757,-28,-2,2,-4,0,-2,2,0,19.2,21.2,-2,2,4,-2,1
15983,15285,287,237,5,6,6,5,4,7,0,0,15,7,0,5,1,0,1,0,0,0,0,0,698,50,-1,1,-3,0,8,-5,1,18,13.8,4.2,3,4,-1,1
15331,12874,288,245,4,1,1,4,7,1,0,1,15,32,0,3,0,0,0,1,0,1,0,0,2457,43,3,-3,6,0,-17,-3,0,12.4,123.4,-111,4,4,0,1
14113,15779,286,284,2,6,6,2,0,5,0,0,36,16,4,5,0,0,0,1,0,0,0,0,-1666,2,-4,4,-5,0,20,-1,0,18,52.8,-34.8,3,4,-1,0
16765,14393,264,264,9,4,4,9,7,5,0,0,37,18,7,2,2,0,1,0,0,0,0,0,2372,0,5,-5,2,0,19,5,2,48.2,30.4,17.8,5,3,2,0
15613,13841,286,239,5,3,3,5,3,6,0,1,44,17,3,17,0,0,1,0,0,1,0,0,1772,47,2,-2,-3,0,27,-14,0,159,37.2,121.8,4,3,1,0
15200,14580,246,228,6,5,5,6,6,7,0,0,11,19,5,1,0,0,0,1,0,0,0,0,620,18,1,-1,-1,0,-8,4,0,30.4,67.6,-37.2,4,4,0,1
15572,16124,239,238,7,8,8,7,12,8,0,0,11,18,4,1,1,1,1,0,0,0,0,0,-552,1,-1,1,4,0,-7,3,0,20.6,6.6,14,3,3,0,1
17389,14688,265,253,10,4,4,10,9,7,1,0,15,20,0,1,1,0,0,1,1,0,0,0,2701,12,6,-6,2,0,-5,-1,1,15.4,77,-61.6,2,4,-2,1
18505,14288,240,208,15,5,5,15,21,6,0,0,31,17,4,4,1,0,1,0,0,0,0,0,4217,32,10,-10,15,0,14,0,1,81.4,10.6,70.8,4,4,0,1
14208,14908,275,270,3,5,5,3,1,3,0,0,14,16,3,4,0,0,0,1,0,0,0,0,-700,5,-2,2,-2,0,-2,-1,0,41,22,19,3,3,0,0
15187,15609,257,247,5,7,7,5,6,8,0,0,17,18,4,1,3,1,0,1,0,0,0,0,-422,10,-2,2,-2,0,-1,3,2,6.6,42,-35.4,3,5,-2,0
16244,15617,236,236,9,7,7,9,12,13,0,0,24,36,3,4,1,0,1,0,0,0,0,0,627,0,2,-2,-1,0,-12,-1,1,69.2,31.8,37.4,5,4,1,1
16288,15160,328,284,5,3,3,5,7,6,0,0,24,35,6,8,1,1,0,1,0,0,0,0,1128,44,2,-2,1,0,-11,-2,0,27.4,69.2,-41.8,4,3,1,1
16235,13254,289,270,8,1,3,8,6,0,0,0,19,38,3,2,0,0,1,0,0,0,0,0,2981,19,7,-5,6,0,-19,1,0,79.4,6.8,72.6,4,2,2,1
15670,13602,272,256,5,2,2,5,6,5,0,0,43,17,2,6,1,0,1,0,0,0,0,0,2068,16,3,-3,1,0,26,-4,1,10.6,36.4,-25.8,4,4,0,1
14780,16466,262,278,4,8,8,4,3,8,0,1,12,16,3,4,0,1,0,1,0,1,0,0,-1686,-16,-4,4,-5,0,-4,-1,-1,22.8,89.8,-67,2,4,-2,1
15511,14714,280,278,4,4,4,4,5,4,0,1,112,17,4,2,0,0,0,1,0,1,0,0,797,2,0,0,1,0,95,2,0,13.8,111.4,-97.6,2,5,-3,1
15119,14930,281,264,4,5,5,4,6,6,0,0,15,15,4,3,0,0,1,0,0,0,0,0,189,17,-1,1,0,0,0,1,0,70.6,22.8,47.8,5,3,2,1
15610,16494,276,226,5,10,10,5,3,11,0,0,32,31,4,6,1,0,1,0,0,0,0,0,-884,50,-5,5,-8,0,1,-2,1,21.2,37.2,-16,4,5,-1,0
14422,15734,252,263,4,5,5,4,5,8,0,0,21,16,4,1,0,2,1,0,0,0,0,0,-1312,-11,-1,1,-3,0,5,3,-2,15.2,7,8.2,4,3,1,0
17306,15777,277,281,10,5,5,10,8,7,0,0,18,16,1,6,1,0,0,1,0,0,0,0,1529,-4,5,-5,1,0,2,-5,1,34.6,60.4,-25.8,5,5,0,0
15848,13835,284,258,7,3,3,7,5,6,0,0,11,25,3,1,1,0,0,1,0,0,0,0,2013,26,4,-4,-1,0,-14,2,1,64.2,42.8,21.4,4,3,1,0
15963,13857,290,248,5,3,3,5,4,4,0,0,23,12,2,7,2,0,0,1,0,0,0,0,2106,42,2,-2,0,0,11,-5,2,88,47,41,3,4,-1,1
14462,14338,262,287,3,3,3,3,4,2,0,1,16,13,4,2,0,0,0,1,0,1,0,0,124,-25,0,0,2,0,3,2,0,7.8,52.4,-44.6,3,4,-1,1
16503,15228,261,245,10,6,6,10,3,5,0,0,16,16,4,3,0,1,1,0,0,0,0,0,1275,16,4,-4,-2,0,0,1,-1,48.8,58.4,-9.6,4,3,1,1
13514,13783,250,278,2,1,1,2,3,2,0,1,14,36,5,4,2,0,1,0,0,1,0,0,-269,-28,1,-1,1,0,-22,1,2,9.6,71.2,-61.6,5,4,1,0
14671,15768,257,257,3,6,6,3,4,8,0,1,14,14,2,2,1,0,1,0,0,1,0,0,-1097,0,-3,3,-4,0,0,0,1,18.2,16.6,1.6,4,3,1,0
15669,13664,265,256,7,2,2,7,8,1,0,0,20,19,3,1,0,1,1,0,0,0,0,0,2005,9,5,-5,7,0,1,2,-1,11.6,24.8,-13.2,4,4,0,1
16478,14318,256,254,9,2,2,9,11,2,1,0,19,15,2,2,1,1,1,0,1,0,0,0,2160,2,7,-7,9,0,4,0,0,61.6,44,17.6,4,3,1,1
15963,17547,266,202,7,12,12,7,6,14,0,0,19,14,4,2,1,1,0,1,0,0,0,0,-1584,64,-5,5,-8,0,5,2,0,23.6,32.2,-8.6,2,3,-1,0
16597,14451,283,234,6,5,5,6,11,6,0,1,15,14,3,4,2,0,0,1,0,1,0,0,2146,49,1,-1,5,0,1,-1,2,10.8,57.6,-46.8,2,3,-1,0
15449,14278,293,271,4,3,3,5,6,5,0,1,14,12,6,2,1,1,1,0,0,1,0,0,1171,22,1,-2,1,0,2,4,0,18,10.8,7.2,5,4,1,1
17008,13379,278,251,8,2,2,8,7,2,0,0,27,19,2,5,1,0,0,1,0,0,0,0,3629,27,6,-6,5,0,8,-3,1,69,117.2,-48.2,4,5,-1,1
15698,16043,213,276,8,6,6,8,11,5,0,0,15,12,5,1,1,4,0,1,0,0,0,0,-345,-63,2,-2,6,0,3,4,-3,141.2,21.6,119.6,4,3,1,0
17532,16993,243,237,11,10,10,11,11,11,0,0,13,14,3,3,0,1,0,1,0,0,0,0,539,6,1,-1,0,0,-1,0,-1,17,81.4,-64.4,4,5,-1,0
14795,16232,255,272,5,7,7,5,4,7,0,0,13,23,6,5,0,2,1,0,0,0,0,0,-1437,-17,-2,2,-3,0,-10,1,-2,6.4,10.6,-4.2,2,4,-2,1
17396,17504,237,250,10,10,10,10,10,10,0,1,16,28,2,5,0,2,0,1,0,1,0,0,-108,-13,0,0,0,0,-12,-3,-2,69.2,12.6,56.6,3,3,0,1
15452,16336,253,266,6,6,6,6,6,11,0,0,17,37,6,5,2,0,0,1,0,0,0,0,-884,-13,0,0,-5,0,-20,1,2,28.6,76.2,-47.6,5,4,1,1
15002,15302,245,264,5,5,5,6,5,6,0,0,19,38,3,4,1,2,0,1,0,0,0,0,-300,-19,0,-1,-1,0,-19,-1,-1,76,229,-153,5,5,0,0
17763,14871,270,271,11,4,4,11,10,4,0,0,15,17,2,5,3,2,1,0,0,0,0,0,2892,-1,7,-7,6,0,-2,-3,1,37.8,189,-151.2,4,5,-1,1
14369,15544,247,272,4,6,6,4,6,7,0,0,19,16,3,1,0,1,0,1,0,0,0,0,-1175,-25,-2,2,-1,0,3,2,-1,7.8,11.8,-4,1,4,-3,0
16185,17121,248,230,7,10,10,7,8,15,0,0,16,93,3,1,0,1,1,0,0,0,0,0,-936,18,-3,3,-7,0,-77,2,-1,88.6,51.4,37.2,3,4,-1,0
13531,13901,283,264,0,3,3,0,0,5,0,0,14,15,0,2,3,0,0,1,0,0,0,0,-370,19,-3,3,-5,0,-1,-2,3,32.6,77.4,-44.8,3,4,-1,1
16674,17015,278,281,9,8,8,9,8,13,0,1,14,16,3,1,0,0,0,1,0,1,0,0,-341,-3,1,-1,-5,0,-2,2,0,14.4,27,-12.6,3,4,-1,0
15682,13852,266,240,5,3,3,5,3,3,0,0,16,33,4,2,1,1,0,1,0,0,0,0,1830,26,2,-2,0,0,-17,2,0,29,26.8,2.2,3,4,-1,1
16615,14498,295,259,7,4,4,7,5,3,0,0,16,19,7,1,2,0,0,1,0,0,0,0,2117,36,3,-3,2,0,-3,6,2,20,28.4,-8.4,4,2,2,1
17264,14841,269,228,11,5,5,12,9,3,0,0,19,14,1,5,2,0,1,0,0,0,0,0,2423,41,6,-7,6,0,5,-4,2,94.6,79,15.6,4,4,0,1
15920,18395,274,281,8,12,12,9,7,9,0,0,30,119,5,3,0,1,0,1,0,0,0,0,-2475,-7,-4,3,-2,0,-89,2,-1,57.4,86.2,-28.8,5,4,1,0
15869,14124,283,285,5,2,2,5,7,3,1,0,24,13,4,4,3,0,0,1,1,0,0,0,1745,-2,3,-3,4,0,11,0,3,98.6,114.8,-16.2,4,4,0,1
13904,14779,219,269,4,4,4,4,5,3,0,1,19,9,0,3,0,1,0,1,0,1,0,0,-875,-50,0,0,2,0,10,-3,-1,24.6,7.4,17.2,4,3,1,0
18269,14955,281,217,12,6,6,12,11,6,0,0,136,16,3,3,2,0,1,0,0,0,0,0,3314,64,6,-6,5,0,120,0,2,21.8,70.2,-48.4,3,3,0,1
16111,13118,305,278,6,0,0,6,5,0,0,0,15,17,6,2,2,0,1,0,0,0,0,0,2993,27,6,-6,5,0,-2,4,2,51.2,40.8,10.4,4,4,0,1
15811,14636,262,259,7,5,5,7,7,5,0,0,17,18,2,2,1,1,0,1,0,0,0,0,1175,3,2,-2,2,0,-1,0,0,77.6,16.4,61.2,4,3,1,1
16806,15724,224,236,11,7,7,11,13,7,0,0,14,37,5,1,0,0,1,0,0,0,0,0,1082,-12,4,-4,6,0,-23,4,0,25.2,114.4,-89.2,4,3,1,0
13138,16721,249,285,1,8,8,1,1,7,0,0,31,51,1,1,0,0,0,1,0,0,0,0,-3583,-36,-7,7,-6,0,-20,0,0,56.8,110.4,-53.6,4,4,0,0
14245,14274,301,295,1,1,1,1,0,2,0,1,17,89,3,4,0,0,1,0,0,1,0,0,-29,6,0,0,-2,0,-72,-1,0,15.6,22,-6.4,4,3,1,0
15499,14655,264,270,7,4,4,7,4,6,0,1,16,11,0,6,0,0,1,0,0,1,0,0,844,-6,3,-3,-2,0,5,-6,0,34.6,56,-21.4,2,5,-3,1
13934,16393,276,280,2,8,8,2,1,10,0,1,13,16,4,5,0,0,0,1,0,1,0,0,-2459,-4,-6,6,-9,0,-3,-1,0,74,18,56,4,5,-1,0
15394,13754,313,267,5,2,2,5,2,3,0,0,13,15,4,3,0,0,0,1,0,0,0,0,1640,46,3,-3,-1,0,-2,1,0,39.2,85.8,-46.6,4,4,0,1
16332,15201,269,255,8,6,6,8,11,6,0,0,14,13,1,2,0,0,1,0,0,0,0,0,1131,14,2,-2,5,0,1,-1,0,8.4,13.2,-4.8,2,2,0,0
16111,12765,302,236,5,1,1,5,3,1,0,1,17,16,1,1,0,0,1,0,0,1,0,0,3346,66,4,-4,2,0,1,0,0,10.8,11.8,-1,4,4,0,1
14812,14678,281,265,3,4,4,3,2,5,0,1,33,14,2,2,1,1,1,0,0,1,0,0,134,16,-1,1,-3,0,19,0,0,40.4,49.8,-9.4,5,3,2,0
14056,15592,241,250,3,8,8,3,4,12,0,1,43,18,4,2,0,1,0,1,0,1,0,0,-1536,-9,-5,5,-8,0,25,2,-1,37.8,99.8,-62,4,5,-1,0
12529,16163,235,246,1,9,9,1,0,10,1,0,13,20,6,1,0,3,0,1,1,0,0,0,-3634,-11,-8,8,-10,0,-7,5,-3,52.2,16.2,36,3,3,0,0
15412,15277,290,262,4,5,5,4,4,3,0,1,14,34,3,4,0,0,0,1,0,1,0,0,135,28,-1,1,1,0,-20,-1,0,10.8,99.8,-89,2,5,-3,1
14690,15265,253,262,3,6,6,4,4,5,0,0,50,19,1,1,2,2,0,1,0,0,0,0,-575,-9,-3,2,-1,0,31,0,0,37,88.2,-51.2,3,4,-1,0
13329,16425,267,269,1,7,7,1,2,10,0,0,27,17,3,2,0,1,0,1,0,0,0,0,-3096,-2,-6,6,-8,0,10,1,-1,19.4,9.6,9.8,3,3,0,0
16809,16638,229,268,10,7,7,10,15,5,0,0,13,14,3,1,0,2,1,0,0,0,0,0,171,-39,3,-3,10,0,-1,2,-2,26.6,16,10.6,5,3,2,0
16889,14342,272,268,7,3,3,7,8,2,0,1,36,18,2,4,2,0,0,1,0,1,0,0,2547,4,4,-4,6,0,18,-2,2,15.2,17.2,-2,3,3,0,1
16937,19502,222,254,10,16,16,10,15,27,1,0,14,39,1,3,1,1,0,1,1,0,0,0,-2565,-32,-6,6,-12,0,-25,-2,0,17.4,7.8,9.6,4,2,2,0
14323,17457,258,240,4,11,11,4,3,15,0,0,9,19,0,3,0,1,0,1,0,0,0,0,-3134,18,-7,7,-12,0,-10,-3,-1,66.8,38.4,28.4,3,4,-1,0
13613,15472,243,225,2,8,8,2,4,14,0,0,15,9,0,1,0,2,1,0,0,0,0,0,-1859,18,-6,6,-10,0,6,-1,-2,5,5.4,-0.4,1,1,0,0
12971,15398,180,230,3,7,7,3,4,8,0,1,22,13,1,2,1,0,1,0,0,1,0,0,-2427,-50,-4,4,-4,0,9,-1,1,7.4,9,-1.6,3,4,-1,0
15164,14190,270,261,6,3,3,6,6,4,0,0,30,14,2,2,0,0,1,0,0,0,0,0,974,9,3,-3,2,0,16,0,0,55.6,33,22.6,4,5,-1,1
15217,14522,285,252,5,4,4,5,6,9,1,0,17,17,4,4,0,0,0,1,1,0,0,0,695,33,1,-1,-3,0,0,0,0,25.6,17.8,7.8,5,2,3,1
14954,15702,244,254,5,7,7,5,3,6,0,0,31,16,1,1,1,0,1,0,0,0,0,0,-748,-10,-2,2,-3,0,15,0,1,33.8,9.6,24.2,5,2,3,0
15579,14373,249,245,7,4,4,8,13,2,0,0,22,14,3,1,0,2,0,1,0,0,0,0,1206,4,3,-4,11,0,8,2,-2,13.8,74,-60.2,4,3,1,1
15674,17716,245,276,5,11,11,5,5,12,0,0,14,17,2,1,0,1,0,1,0,0,0,0,-2042,-31,-6,6,-7,0,-3,1,-1,38.8,9.6,29.2,4,4,0,0
16516,14801,277,245,8,6,6,8,5,3,0,1,15,23,5,2,0,0,1,0,0,1,0,0,1715,32,2,-2,2,0,-8,3,0,28,43.8,-15.8,3,4,-1,1
16156,15380,253,243,7,6,6,7,9,5,0,0,12,13,2,3,0,0,1,0,0,0,0,0,776,10,1,-1,4,0,-1,-1,0,22.4,20.6,1.8,5,5,0,1
14681,15225,266,254,4,5,5,4,4,5,0,0,18,47,7,4,0,0,0,1,0,0,0,0,-544,12,-1,1,-1,0,-29,3,0,14.8,29.4,-14.6,3,4,-1,0
14971,18475,250,269,4,13,13,4,5,11,0,1,20,14,3,3,0,1,0,1,0,1,0,0,-3504,-19,-9,9,-6,0,6,0,-1,7.4,9.8,-2.4,3,3,0,0
16952,14005,294,227,6,4,4,6,10,4,0,0,113,72,4,3,3,0,0,1,0,0,0,0,2947,67,2,-2,6,0,41,1,3,38.6,13.2,25.4,3,3,0,1
14024,13885,248,240,3,4,4,3,2,5,1,0,17,19,2,0,2,0,1,0,1,0,0,0,139,8,-1,1,-3,0,-2,2,2,11.4,6,5.4,1,1,0,1
14988,16331,252,268,5,7,7,5,7,5,0,0,14,18,1,2,0,1,0,1,0,0,0,0,-1343,-16,-2,2,2,0,-4,-1,-1,17.8,18,-0.2,5,4,1,0
15053,15354,217,234,7,8,8,7,5,10,0,1,20,10,2,1,1,1,0,1,0,1,0,0,-301,-17,-1,1,-5,0,10,1,0,10.4,7.8,2.6,2,1,1,1
14769,14641,283,272,3,3,3,3,2,4,0,1,16,32,3,2,2,0,1,0,0,1,0,0,128,11,0,0,-2,0,-16,1,2,15.8,80.8,-65,4,4,0,0
17163,14581,289,265,8,3,3,9,12,4,1,0,20,18,3,4,2,1,1,0,1,0,0,0,2582,24,5,-6,8,0,2,-1,1,10,19.8,-9.8,4,4,0,1
15725,15419,266,281,6,6,6,7,8,2,0,0,15,19,0,4,0,2,1,0,0,0,0,0,306,-15,0,-1,6,0,-4,-4,-2,30.4,42.2,-11.8,5,4,1,1
14927,14060,247,262,5,2,2,5,12,3,0,0,12,16,2,1,1,1,0,1,0,0,0,0,867,-15,3,-3,9,0,-4,1,0,11.8,9.4,2.4,3,2,1,1
14084,15664,270,273,2,6,6,2,1,5,0,0,35,13,2,1,1,3,0,1,0,0,0,0,-1580,-3,-4,4,-4,0,22,1,-2,13.6,30.6,-17,4,3,1,0
15608,17626,251,260,7,10,10,7,5,12,0,1,37,15,3,5,0,0,1,0,0,1,0,0,-2018,-9,-3,3,-7,0,22,-2,0,12.2,42.8,-30.6,3,5,-2,0
14235,18416,261,279,3,12,12,3,1,14,0,0,169,19,8,0,0,0,0,1,0,0,0,0,-4181,-18,-9,9,-13,0,150,8,0,68.2,20.2,48,5,4,1,0
16514,15475,259,261,9,6,6,9,10,4,0,1,20,31,5,4,1,0,1,0,0,1,0,0,1039,-2,3,-3,6,0,-11,1,1,7.4,124.6,-117.2,2,4,-2,1
16457,13880,237,241,10,4,4,10,9,3,0,0,18,17,3,3,0,1,1,0,0,0,0,0,2577,-4,6,-6,6,0,1,0,-1,44.6,9,35.6,4,2,2,1
14075,16473,273,284,2,8,8,2,2,3,0,0,42,114,3,18,0,3,0,1,0,0,0,0,-2398,-11,-6,6,-1,0,-72,-15,-3,135.2,17,118.2,4,4,0,0
13868,14925,276,291,2,4,4,2,2,1,0,0,32,13,1,2,0,2,0,1,0,0,0,0,-1057,-15,-2,2,1,0,19,-1,-2,13.8,16.4,-2.6,4,4,0,1
16799,14741,249,222,10,6,6,10,6,6,0,0,12,17,3,1,3,1,1,0,0,0,0,0,2058,27,4,-4,0,0,-5,2,2,37,21.4,15.6,3,5,-2,1
15918,14308,253,239,7,5,5,7,8,2,0,1,9,14,1,2,1,0,0,1,0,1,0,0,1610,14,2,-2,6,0,-5,-1,1,4.6,38.6,-34,1,3,-2,0
16282,16049,251,271,9,6,6,10,10,7,0,1,16,18,2,4,1,0,1,0,0,1,0,0,233,-20,3,-4,3,0,-2,-2,1,92.4,134.2,-41.8,3,4,-1,1
15915,14573,270,256,7,4,4,7,4,4,0,0,31,44,2,2,1,0,1,0,0,0,0,0,1342,14,3,-3,0,0,-13,0,1,54.2,10.6,43.6,5,3,2,1
17226,18145,258,248,10,13,13,10,7,17,1,0,24,18,1,1,1,0,1,0,1,0,0,0,-919,10,-3,3,-10,0,6,0,1,147.8,24.2,123.6,4,4,0,1
17302,14427,263,261,12,3,3,12,11,1,0,1,38,15,2,3,3,1,1,0,0,1,0,0,2875,2,9,-9,10,0,23,-1,2,65.6,35,30.6,4,5,-1,1
14768,14321,277,241,3,5,5,3,3,4,0,1,15,21,1,3,1,0,1,0,0,1,0,0,447,36,-2,2,-1,0,-6,-2,1,12.6,18.2,-5.6,2,2,0,1
17447,13897,260,248,11,3,3,12,9,2,0,0,12,19,2,3,2,0,1,0,0,0,0,0,3550,12,8,-9,7,0,-7,-1,2,17.8,43.2,-25.4,3,4,-1,1
13653,15661,278,297,1,5,5,1,2,8,1,0,18,16,2,2,0,0,0,1,1,0,0,0,-2008,-19,-4,4,-6,0,2,0,0,31,42.2,-11.2,2,4,-2,0
15804,13998,288,248,7,2,2,7,5,4,1,0,16,38,2,2,2,1,1,0,1,0,0,0,1806,40,5,-5,1,0,-22,0,1,9,20,-11,3,2,1,1
14945,15125,262,267,5,4,4,5,4,4,0,0,19,17,4,5,0,1,0,1,0,0,0,0,-180,-5,1,-1,0,0,2,-1,-1,22.4,14.6,7.8,4,3,1,1
16955,14817,293,287,8,3,3,8,8,4,0,0,14,12,4,2,0,1,0,1,0,0,0,0,2138,6,5,-5,4,0,2,2,-1,95.8,76.2,19.6,4,5,-1,1
16579,13414,256,239,9,2,2,9,12,4,0,0,15,18,6,3,0,1,0,1,0,0,0,0,3165,17,7,-7,8,0,-3,3,-1,36.2,20.2,16,3,5,-2,1
16285,14488,248,244,9,5,5,9,9,2,0,0,42,13,1,3,0,0,1,0,0,0,0,0,1797,4,4,-4,7,0,29,-2,0,19.8,12.4,7.4,3,5,-2,0
16671,16444,289,249,7,9,9,7,7,8,0,0,26,37,3,3,1,0,0,1,0,0,0,0,227,40,-2,2,-1,0,-11,0,1,22.8,19.2,3.6,4,4,0,0
17728,14700,258,244,11,5,5,11,14,2,0,0,17,140,1,4,1,0,1,0,0,0,0,0,3028,14,6,-6,12,0,-123,-3,1,20.8,6,14.8,4,1,3,1
12583,16910,242,294,0,7,7,0,0,7,0,1,15,13,0,2,0,4,0,1,0,1,0,0,-4327,-52,-7,7,-7,0,2,-2,-4,35,12,23,3,4,-1,0
14533,13892,277,296,3,1,1,3,4,1,0,1,32,117,6,5,0,0,1,0,0,1,0,0,641,-19,2,-2,3,0,-85,1,0,49.2,36.8,12.4,4,5,-1,1
15527,15817,270,274,6,7,7,6,4,5,0,0,34,17,3,3,1,1,1,0,0,0,0,0,-290,-4,-1,1,-1,0,17,0,0,17,44.6,-27.6,5,4,1,0
14448,17274,293,268,1,9,9,1,1,15,0,0,14,18,5,3,0,3,0,1,0,0,0,0,-2826,25,-8,8,-14,0,-4,2,-3,173.8,28.6,145.2,5,3,2,0
15026,17289,264,270,5,10,10,5,3,11,0,0,17,15,1,5,0,2,0,1,0,0,0,0,-2263,-6,-5,5,-8,0,2,-4,-2,11.2,14.6,-3.4,2,3,-1,1
16540,14578,239,230,10,5,5,10,13,6,0,0,15,15,2,2,1,0,1,0,0,0,0,0,1962,9,5,-5,7,0,0,0,1,68.2,65,3.2,3,4,-1,0
16939,15883,274,298,8,5,5,8,11,4,1,0,15,14,2,2,0,1,1,0,1,0,0,0,1056,-24,3,-3,7,0,1,0,-1,41.2,35,6.2,4,5,-1,0
17099,14917,272,246,9,6,6,9,10,7,0,0,104,16,4,3,0,0,1,0,0,0,0,0,2182,26,3,-3,3,0,88,1,0,14.8,95.8,-81,5,4,1,1
16778,18476,233,254,8,14,14,8,12,17,0,1,15,18,0,4,0,0,0,1,0,1,0,0,-1698,-21,-6,6,-5,0,-3,-4,0,24.6,79.2,-54.6,3,2,1,0
16753,13912,270,263,8,2,2,8,16,3,0,0,19,15,3,6,0,0,1,0,0,0,0,0,2841,7,6,-6,13,0,4,-3,0,21,45.2,-24.2,5,3,2,1
13737,14288,257,257,2,3,3,2,2,7,0,0,15,18,3,2,0,0,0,1,0,0,0,0,-551,0,-1,1,-5,0,-3,1,0,10.8,30.4,-19.6,4,4,0,1
15146,17291,225,235,6,11,11,6,7,15,0,0,19,29,2,3,0,0,1,0,0,0,0,0,-2145,-10,-5,5,-8,0,-10,-1,0,104.6,54.6,50,2,4,-2,0
14362,14957,286,270,2,5,5,2,2,6,0,1,17,18,3,4,0,0,0,1,0,1,0,0,-595,16,-3,3,-4,0,-1,-1,0,9,62.8,-53.8,2,5,-3,0
14347,17142,229,263,6,9,9,6,4,9,0,0,15,24,2,0,0,0,1,0,0,0,0,0,-2795,-34,-3,3,-5,0,-9,2,0,29,35.2,-6.2,3,3,0,0
14444,16277,282,274,3,7,7,3,4,10,0,0,23,14,4,5,2,1,0,1,0,0,0,0,-1833,8,-4,4,-6,0,9,-1,1,21.6,44.6,-23,4,3,1,0
15539,14367,266,256,7,4,4,7,6,4,0,0,16,15,1,2,0,0,1,0,0,0,0,0,1172,10,3,-3,2,0,1,-1,0,106.6,58.4,48.2,3,3,0,1
16328,14438,269,252,7,4,4,7,13,6,0,0,19,15,2,6,0,0,1,0,0,0,0,0,1890,17,3,-3,7,0,4,-4,0,28.8,83,-54.2,3,3,0,1
14740,16815,264,291,4,7,8,4,3,9,0,1,13,26,5,3,0,0,0,1,0,1,0,0,-2075,-27,-3,4,-6,0,-13,2,0,31,21,10,5,4,1,1
15109,16301,246,260,5,8,8,5,7,7,1,0,17,28,7,4,1,3,0,1,1,0,0,0,-1192,-14,-3,3,0,0,-11,3,-2,18.2,19.6,-1.4,4,3,1,0
17176,16523,270,273,9,7,7,9,14,12,0,0,15,16,1,2,1,0,1,0,0,0,0,0,653,-3,2,-2,2,0,-1,-1,1,17.8,47.8,-30,3,3,0,1
14219,15779,268,263,4,9,9,4,1,7,0,1,16,16,2,6,1,0,1,0,0,1,0,0,-1560,5,-5,5,-6,0,0,-4,1,68.4,47.6,20.8,2,3,-1,0
16375,15948,225,227,9,7,7,9,13,8,1,0,44,18,4,2,0,1,1,0,1,0,0,0,427,-2,2,-2,5,0,26,2,-1,60.2,13.6,46.6,3,2,1,0
14631,15065,232,265,5,5,5,5,8,7,1,0,14,14,2,2,0,0,0,1,1,0,0,0,-434,-33,0,0,1,0,0,0,0,18.8,150.2,-131.4,2,4,-2,0
15636,14898,244,268,7,5,5,7,7,6,0,0,131,11,2,3,1,1,1,0,0,0,0,0,738,-24,2,-2,1,0,120,-1,0,27.4,32.2,-4.8,5,4,1,0
16848,15625,278,239,9,7,7,9,13,5,0,0,14,18,6,2,0,1,1,0,0,0,0,0,1223,39,2,-2,8,0,-4,4,-1,8.2,55,-46.8,3,3,0,0
15433,14586,267,268,5,4,5,5,5,2,0,0,18,101,4,4,2,1,0,1,0,0,0,0,847,-1,1,0,3,0,-83,0,1,99.8,17,82.8,5,2,3,1
14028,15938,258,283,3,7,7,3,2,5,0,0,102,13,2,3,0,0,0,1,0,0,0,0,-1910,-25,-4,4,-3,0,89,-1,0,97.6,38,59.6,3,5,-2,0
14078,15675,246,275,4,5,5,4,8,7,0,0,21,18,4,1,0,0,1,0,0,0,0,0,-1597,-29,-1,1,1,0,3,3,0,16.4,59.8,-43.4,4,5,-1,0
15367,15208,260,261,6,6,6,6,7,5,1,0,153,34,8,4,0,0,0,1,1,0,0,0,159,-1,0,0,2,0,119,4,0,35.2,19.6,15.6,4,4,0,1
17195,14664,273,275,9,3,3,9,10,1,0,0,13,51,5,4,2,0,1,0,0,0,0,0,2531,-2,6,-6,9,0,-38,1,2,114.4,51.2,63.2,5,4,1,1
17085,16936,251,250,9,11,11,9,7,10,0,0,17,14,5,4,5,2,0,1,0,0,0,0,149,1,-2,2,-3,0,3,1,3,19.8,66.4,-46.6,3,4,-1,0
16731,17746,232,261,11,9,9,11,10,14,0,0,11,108,2,0,1,2,0,1,0,0,0,0,-1015,-29,2,-2,-4,0,-97,2,-1,111.2,15.2,96,3,5,-2,0
16062,16969,258,250,8,9,9,8,8,15,1,0,14,47,3,1,0,0,0,1,1,0,0,0,-907,8,-1,1,-7,0,-33,2,0,39.8,17.4,22.4,5,4,1,1
15525,14039,269,261,6,3,3,6,5,5,0,1,13,14,3,2,0,0,1,0,0,1,0,0,1486,8,3,-3,0,0,-1,1,0,27.4,27.6,-0.2,3,4,-1,0
16556,13484,248,252,9,2,2,9,10,1,0,0,18,13,2,3,1,0,1,0,0,0,0,0,3072,-4,7,-7,9,0,5,-1,1,19.4,18.6,0.8,5,5,0,1
15194,15176,284,246,4,5,5,4,4,7,0,1,15,26,6,3,0,0,1,0,0,1,0,0,18,38,-1,1,-3,0,-11,3,0,47.2,46,1.2,4,3,1,0
13651,17151,256,259,3,11,12,3,3,13,0,1,16,13,2,6,0,1,1,0,0,1,0,0,-3500,-3,-8,9,-10,0,3,-4,-1,114.4,21,93.4,5,3,2,0
14082,17165,232,268,4,12,12,4,3,8,0,1,17,13,2,0,0,0,0,1,0,1,0,0,-3083,-36,-8,8,-5,0,4,2,0,4.4,7.2,-2.8,2,2,0,0
13473,16446,251,309,1,6,6,1,1,5,0,1,19,16,5,4,0,2,0,1,0,1,0,0,-2973,-58,-5,5,-4,0,3,1,-2,21.8,11.6,10.2,5,4,1,0
15149,14257,306,290,3,2,3,3,3,2,0,0,39,18,3,2,1,0,1,0,0,0,0,0,892,16,1,0,1,0,21,1,1,16.4,6.8,9.6,3,2,1,1
14336,16116,274,272,2,6,6,2,3,7,0,0,14,22,4,3,1,0,0,1,0,0,0,0,-1780,2,-4,4,-4,0,-8,1,1,18,17,1,3,3,0,0
16400,16302,228,236,9,9,9,9,5,11,0,0,12,18,3,5,0,0,0,1,0,0,0,0,98,-8,0,0,-6,0,-6,-2,0,98.4,17.4,81,4,3,1,1
13428,16254,266,256,1,10,10,1,1,8,0,0,11,26,2,1,0,1,0,1,0,0,0,0,-2826,10,-9,9,-7,0,-15,1,-1,126.6,100,26.6,4,5,-1,0
14638,13956,257,294,5,1,1,5,4,1,1,0,71,14,2,4,1,0,1,0,1,0,0,0,682,-37,4,-4,3,0,57,-2,1,45,28.2,16.8,4,4,0,0
16859,14893,275,237,8,6,6,8,7,7,0,1,35,73,2,0,3,0,1,0,0,1,0,0,1966,38,2,-2,0,0,-38,2,3,7.4,11.6,-4.2,2,2,0,1
14783,14370,272,228,4,5,6,4,3,5,0,0,19,19,2,3,1,0,1,0,0,0,0,0,413,44,-1,2,-2,0,0,-1,1,85.6,24.6,61,5,4,1,0
14636,16094,222,258,6,8,8,6,3,7,0,1,106,11,1,3,0,4,0,1,0,1,0,0,-1458,-36,-2,2,-4,0,95,-2,-4,20.6,10.6,10,3,3,0,0
14037,13250,251,254,3,2,2,3,2,0,0,0,14,16,3,2,1,0,1,0,0,0,0,0,787,-3,1,-1,2,0,-2,1,1,24.2,92.8,-68.6,4,4,0,1
13407,14202,249,244,2,3,4,2,2,1,0,0,14,20,2,2,0,2,0,1,0,0,0,0,-795,5,-1,2,1,0,-6,0,-2,18.6,10,8.6,2,3,-1,1
16599,14561,239,272,11,3,3,11,20,5,1,0,16,16,1,1,0,1,1,0,1,0,0,0,2038,-33,8,-8,15,0,0,0,-1,18.6,16.4,2.2,4,4,0,1
14273,14998,305,269,2,5,5,2,1,4,0,0,11,29,1,0,0,0,0,1,0,0,0,0,-725,36,-3,3,-3,0,-18,1,0,26,55.6,-29.6,3,4,-1,0
14376,14277,261,272,3,3,3,3,5,2,0,0,19,17,5,3,0,1,1,0,0,0,0,0,99,-11,0,0,3,0,2,2,-1,140.8,44.8,96,3,2,1,1
14421,15816,264,276,4,6,6,4,4,5,0,1,15,16,4,4,0,0,0,1,0,1,0,0,-1395,-12,-2,2,-1,0,-1,0,0,10.6,52.2,-41.6,2,5,-3,0
14033,15651,248,256,4,8,8,4,1,8,0,0,16,19,6,3,1,0,0,1,0,0,0,0,-1618,-8,-4,4,-7,0,-3,3,1,64,34,30,5,3,2,0
14054,13682,294,280,1,2,2,1,1,1,0,1,14,20,5,0,0,0,0,1,0,1,0,0,372,14,-1,1,0,0,-6,5,0,75.2,21.4,53.8,3,4,-1,0
14065,15317,280,259,2,6,6,2,2,6,0,1,20,12,1,4,0,2,0,1,0,1,0,0,-1252,21,-4,4,-4,0,8,-3,-2,39.2,39.2,0,4,4,0,0
16518,15302,276,260,7,6,6,7,9,9,0,1,13,23,1,3,2,0,0,1,0,1,0,0,1216,16,1,-1,0,0,-10,-2,2,38.8,140.2,-101.4,3,5,-2,1
18851,15995,225,284,14,6,6,14,13,5,0,0,19,16,6,3,3,1,1,0,0,0,0,0,2856,-59,8,-8,8,0,3,3,2,9.8,23.6,-13.8,3,5,-2,0
16222,13664,259,242,7,2,2,7,9,2,0,0,17,26,2,2,1,1,1,0,0,0,0,0,2558,17,5,-5,7,0,-9,0,0,18,14,4,2,2,0,1
15878,14539,289,261,5,3,3,6,4,5,0,0,24,14,3,1,0,0,1,0,0,0,0,0,1339,28,2,-3,-1,0,10,2,0,67.2,22,45.2,4,3,1,1
14001,14673,253,255,3,4,4,3,4,6,1,0,18,54,0,4,1,0,1,0,1,0,0,0,-672,-2,-1,1,-2,0,-36,-4,1,36.2,88.2,-52,4,5,-1,1
15643,14877,245,232,8,6,6,8,11,5,0,0,13,15,8,2,0,0,1,0,0,0,0,0,766,13,2,-2,6,0,-2,6,0,38.2,39.2,-1,4,4,0,0
15732,12773,270,234,5,1,1,5,6,2,0,1,17,12,1,1,4,0,1,0,0,1,0,0,2959,36,4,-4,4,0,5,0,4,38,36.4,1.6,5,4,1,1
15700,17202,230,262,6,9,9,6,9,14,0,1,16,18,5,5,0,2,0,1,0,1,0,0,-1502,-32,-3,3,-5,0,-2,0,-2,14.4,19,-4.6,3,5,-2,1
14524,15308,286,270,3,5,5,3,2,8,1,0,14,18,2,2,1,0,0,1,1,0,0,0,-784,16,-2,2,-6,0,-4,0,1,58.2,15.6,42.6,4,4,0,1
13511,17089,267,268,2,9,9,2,0,14,0,1,12,107,2,1,0,0,0,1,0,1,0,0,-3578,-1,-7,7,-14,0,-95,1,0,27.8,26.8,1,5,4,1,0
16830,15957,257,236,11,7,7,11,9,5,0,0,17,120,3,2,1,1,1,0,0,0,0,0,873,21,4,-4,4,0,-103,1,0,37,17.2,19.8,5,3,2,1
16186,16116,288,273,7,6,6,7,9,6,0,0,19,17,3,2,1,0,1,0,0,0,0,0,70,15,1,-1,3,0,2,1,1,67.8,52.4,15.4,4,4,0,0
14567,16132,283,266,2,6,6,3,1,8,0,0,16,45,3,4,1,0,0,1,0,0,0,0,-1565,17,-4,3,-7,0,-29,-1,1,33.2,7.8,25.4,4,2,2,0
14180,16282,274,311,2,5,5,3,1,5,0,1,39,15,4,2,1,2,0,1,0,1,0,0,-2102,-37,-3,2,-4,0,24,2,-1,105,86.6,18.4,5,5,0,0
15543,14457,295,280,5,2,2,5,2,3,0,0,16,15,2,4,1,0,0,1,0,0,0,0,1086,15,3,-3,-1,0,1,-2,1,20.8,16.4,4.4,3,2,1,1
17374,13417,271,240,10,3,3,11,14,2,0,0,43,19,6,3,0,0,0,1,0,0,0,0,3957,31,7,-8,12,0,24,3,0,13.8,48,-34.2,4,3,1,0
17763,14621,275,236,12,5,5,12,14,4,0,0,15,14,4,2,0,0,1,0,0,0,0,0,3142,39,7,-7,10,0,1,2,0,46.8,8.2,38.6,4,2,2,1
14462,14533,251,290,4,2,2,4,5,2,0,0,26,16,5,6,0,1,1,0,0,0,0,0,-71,-39,2,-2,3,0,10,-1,-1,60.6,69.4,-8.8,4,5,-1,0
16188,14773,280,238,5,5,5,5,6,7,1,0,15,19,6,1,4,0,1,0,1,0,0,0,1415,42,0,0,-1,0,-4,5,4,13.6,8.8,4.8,2,2,0,1
16052,14541,282,263,7,3,3,7,10,3,0,1,15,10,1,3,0,1,1,0,0,1,0,0,1511,19,4,-4,7,0,5,-2,-1,21.8,32.2,-10.4,3,3,0,1
14760,15726,264,270,4,7,8,4,3,5,0,1,14,15,4,2,0,0,1,0,0,1,0,0,-966,-6,-3,4,-2,0,-1,2,0,16,20.8,-4.8,4,4,0,0
15884,16122,242,241,7,8,8,7,7,10,0,0,14,19,6,2,1,2,0,1,0,0,0,0,-238,1,-1,1,-3,0,-5,4,-1,40.6,15.4,25.2,4,3,1,1
14966,15875,259,263,6,7,7,6,2,4,0,0,21,24,2,4,0,0,0,1,0,0,0,0,-909,-4,-1,1,-2,0,-3,-2,0,64.2,19,45.2,3,4,-1,0
13962,16571,239,249,4,8,8,4,3,10,0,0,22,13,0,3,2,2,0,1,0,0,0,0,-2609,-10,-4,4,-7,0,9,-3,0,6.4,88.8,-82.4,2,4,-2,0
14550,15324,264,248,5,6,6,5,4,8,0,0,17,14,4,3,1,3,1,0,0,0,0,0,-774,16,-1,1,-4,0,3,1,-2,17,77.4,-60.4,4,5,-1,0
15736,14506,269,268,6,4,4,6,9,5,0,0,36,31,7,4,1,0,1,0,0,0,0,0,1230,1,2,-2,4,0,5,3,1,37.2,22.2,15,5,3,2,1
16448,13453,261,253,7,2,2,7,8,1,0,0,17,15,4,5,2,0,0,1,0,0,0,0,2995,8,5,-5,7,0,2,-1,2,22.4,81.8,-59.4,4,5,-1,1
13007,17931,237,286,2,11,11,2,1,13,1,0,10,10,0,3,0,4,0,1,1,0,0,0,-4924,-49,-9,9,-12,0,0,-3,-4,6.6,66.2,-59.6,3,3,0,0
16262,14759,247,250,10,4,4,11,9,5,0,1,18,19,6,3,2,0,1,0,0,1,0,0,1503,-3,6,-7,4,0,-1,3,2,32.2,23.2,9,4,4,0,1
14811,14283,267,250,4,4,4,5,6,6,0,1,16,15,1,4,0,1,0,1,0,1,0,0,528,17,0,-1,0,0,1,-3,-1,55.4,4,51.4,4,0,4,1
16665,14539,264,224,8,6,6,8,8,3,0,0,16,14,4,4,2,0,1,0,0,0,0,0,2126,40,2,-2,5,0,2,0,2,32,22.8,9.2,5,5,0,1
14273,14987,259,271,4,5,5,4,3,6,0,0,23,17,2,2,1,0,1,0,0,0,0,0,-714,-12,-1,1,-3,0,6,0,1,31,32.8,-1.8,4,2,2,1
14339,14088,290,276,2,3,3,2,1,1,0,1,14,40,6,4,0,0,1,0,0,1,0,0,251,14,-1,1,0,0,-26,2,0,19.2,21.6,-2.4,3,4,-1,1
15506,14526,267,286,7,3,3,8,6,3,0,0,13,33,4,1,0,1,1,0,0,0,0,0,980,-19,4,-5,3,0,-20,3,-1,67,9.4,57.6,5,3,2,0
15382,17811,264,264,6,10,10,6,3,13,1,0,14,17,3,4,0,1,1,0,1,0,0,0,-2429,0,-4,4,-10,0,-3,-1,-1,20.4,10.6,9.8,3,3,0,0
14747,16452,249,207,6,10,10,6,1,9,0,0,15,19,4,2,1,0,0,1,0,0,0,0,-1705,42,-4,4,-8,0,-4,2,1,48.4,133,-84.6,4,4,0,0
14024,14181,256,252,3,3,3,3,8,8,1,0,15,15,2,3,1,0,1,0,1,0,0,0,-157,4,0,0,0,0,0,-1,1,20,31.8,-11.8,3,5,-2,1
14390,17630,259,264,3,12,12,3,4,15,1,0,33,14,1,2,0,0,1,0,1,0,0,0,-3240,-5,-9,9,-11,0,19,-1,0,28.4,88,-59.6,3,4,-1,1
14613,13483,296,279,2,1,1,2,2,1,0,1,15,13,2,3,0,0,1,0,0,1,0,0,1130,17,1,-1,1,0,2,-1,0,80.8,81.8,-1,5,5,0,0
12484,17707,224,280,1,11,11,1,1,10,0,0,13,9,1,2,0,2,0,1,0,0,0,0,-5223,-56,-10,10,-9,0,4,-1,-2,5.6,58.6,-53,2,2,0,0
13186,16453,237,290,2,7,7,2,3,9,0,0,13,17,2,3,0,2,0,1,0,0,0,0,-3267,-53,-5,5,-6,0,-4,-1,-2,75.6,7,68.6,4,2,2,0
12323,17082,246,293,0,7,8,0,0,8,1,0,16,18,0,4,0,3,0,1,1,0,0,0,-4759,-47,-7,8,-8,0,-2,-4,-3,9,12.2,-3.2,3,2,1,0
14606,16984,289,253,3,10,10,3,2,12,0,0,13,41,4,2,1,2,1,0,0,0,0,0,-2378,36,-7,7,-10,0,-28,2,-1,31,84,-53,4,4,0,0
2567,2572,1,1,0,0,0,0,0,0,0,0,3,1,0,0,0,0,0,0,0,0,0,0,-5,0,0,0,0,0,2,0,0,54.4,53.6,0.8,4,4,0,1
14963,14789,259,279,5,3,3,5,8,6,0,1,16,17,1,0,0,1,1,0,0,1,0,0,174,-20,2,-2,2,0,-1,1,-1,42,49,-7,4,3,1,1
13904,15726,250,268,3,5,5,3,3,7,1,0,15,22,2,1,0,0,1,0,1,0,0,0,-1822,-18,-2,2,-4,0,-7,1,0,25,96.2,-71.2,3,3,0,0
12760,18952,208,271,2,13,13,2,1,14,0,1,29,18,3,3,0,2,0,1,0,1,0,0,-6192,-63,-11,11,-13,0,11,0,-2,60.4,64.6,-4.2,3,5,-2,0
14975,15377,310,269,3,6,6,3,2,4,0,1,16,15,3,4,0,0,0,1,0,1,0,0,-402,41,-3,3,-2,0,1,-1,0,9.8,34.8,-25,4,4,0,1
14263,16708,244,281,4,8,8,4,4,5,0,0,11,15,2,2,0,2,0,1,0,0,0,0,-2445,-37,-4,4,-1,0,-4,0,-2,8.6,30.4,-21.8,4,5,-1,0
16463,13606,254,236,8,2,2,8,9,3,0,0,14,14,1,1,0,1,1,0,0,0,0,0,2857,18,6,-6,6,0,0,0,-1,7,37.4,-30.4,1,4,-3,1
15697,15061,253,245,8,6,6,8,4,3,0,1,32,18,2,2,1,2,1,0,0,1,0,0,636,8,2,-2,1,0,14,0,-1,41.4,15.6,25.8,2,4,-2,1
14471,15384,240,233,4,8,8,4,4,6,0,0,16,16,4,1,3,0,0,1,0,0,0,0,-913,7,-4,4,-2,0,0,3,3,16,21.2,-5.2,3,4,-1,0
15395,14445,286,246,4,5,5,4,2,3,0,1,35,13,3,5,1,1,1,0,0,1,0,0,950,40,-1,1,-1,0,22,-2,0,15.2,23,-7.8,4,3,1,1
11062,12211,166,178,4,5,5,5,3,6,0,0,8,11,2,1,0,0,0,1,0,0,0,0,-1149,-12,-1,0,-3,0,-3,1,0,9.6,75.6,-66,4,5,-1,0
14909,14185,282,271,5,3,3,5,2,1,0,1,13,17,3,3,0,0,0,1,0,1,0,0,724,11,2,-2,1,0,-4,0,0,43.4,13.8,29.6,4,3,1,1
15181,14565,283,278,3,3,3,3,5,5,0,1,13,19,7,1,2,0,0,1,0,1,0,0,616,5,0,0,0,0,-6,6,2,45.2,85.4,-40.2,5,4,1,1
14303,14407,256,241,4,5,5,4,4,6,0,0,19,48,2,1,0,0,1,0,0,0,0,0,-104,15,-1,1,-2,0,-29,1,0,73.4,25.8,47.6,4,3,1,1
13564,16398,207,245,6,9,11,6,2,7,0,0,29,29,3,0,0,1,0,1,0,0,0,0,-2834,-38,-3,5,-5,0,0,3,-1,42.6,39.8,2.8,4,5,-1,0
15916,15037,283,268,6,5,5,6,5,3,1,0,18,19,4,4,0,0,1,0,1,0,0,0,879,15,1,-1,2,0,-1,0,0,59.6,11.4,48.2,5,3,2,1
16449,12572,275,241,8,1,1,8,7,0,0,1,18,14,3,1,3,0,1,0,0,1,0,0,3877,34,7,-7,7,0,4,2,3,53.8,29.4,24.4,4,4,0,1
14583,15713,263,285,4,5,5,5,2,4,0,0,14,23,4,2,2,1,1,0,0,0,0,0,-1130,-22,-1,0,-2,0,-9,2,1,67.8,9.8,58,5,3,2,0
14544,15118,287,276,2,4,4,2,4,5,0,0,14,18,2,5,0,1,0,1,0,0,0,0,-574,11,-2,2,-1,0,-4,-3,-1,24.2,27.4,-3.2,3,5,-2,0
16695,13727,285,272,8,1,1,8,10,3,0,1,17,34,4,5,0,1,1,0,0,1,0,0,2968,13,7,-7,7,0,-17,-1,-1,24.8,117.4,-92.6,2,5,-3,1
15072,15644,267,271,5,6,6,5,7,7,0,0,17,32,4,4,0,0,0,1,0,0,0,0,-572,-4,-1,1,0,0,-15,0,0,13.2,111.8,-98.6,5,5,0,1
16703,13832,293,255,7,3,4,7,9,4,0,1,17,15,1,1,0,0,0,1,0,1,0,0,2871,38,4,-3,5,0,2,0,0,85.8,43.2,42.6,4,4,0,1
14515,14463,256,277,3,3,3,3,5,5,0,1,29,19,2,2,0,1,1,0,0,1,0,0,52,-21,0,0,0,0,10,0,-1,5.2,68.8,-63.6,2,2,0,0
14598,17398,222,238,6,14,14,6,5,8,0,0,15,20,5,4,1,0,1,0,0,0,0,0,-2800,-16,-8,8,-3,0,-5,1,1,27,19.2,7.8,1,4,-3,0
15018,15456,255,237,4,6,7,4,8,12,0,0,13,18,4,2,1,1,1,0,0,0,0,0,-438,18,-2,3,-4,0,-5,2,0,155.6,78,77.6,5,3,2,0
15744,15310,244,268,7,6,6,7,11,4,0,0,13,13,1,1,0,0,0,1,0,0,0,0,434,-24,1,-1,7,0,0,0,0,8.8,33.2,-24.4,2,4,-2,1
14752,16220,246,245,6,8,8,7,4,12,0,0,17,19,3,5,0,1,1,0,0,0,0,0,-1468,1,-2,1,-8,0,-2,-2,-1,48.4,14.6,33.8,3,3,0,1
16278,15426,257,257,7,5,5,7,11,5,0,0,15,15,3,4,3,1,1,0,0,0,0,0,852,0,2,-2,6,0,0,-1,2,131.4,63.8,67.6,3,5,-2,1
15440,13927,261,237,5,3,3,5,5,5,0,0,16,15,4,2,0,0,0,1,0,0,0,0,1513,24,2,-2,0,0,1,2,0,94.2,36.2,58,3,5,-2,1
16267,14645,299,256,5,4,4,5,8,9,0,1,11,13,2,2,1,1,0,1,0,1,0,0,1622,43,1,-1,-1,0,-2,0,0,63.6,50.6,13,5,4,1,1
15043,15966,275,271,5,5,5,5,3,6,0,0,15,34,1,1,0,0,1,0,0,0,0,0,-923,4,0,0,-3,0,-19,0,0,13.8,51.8,-38,5,4,1,1
16195,13940,275,263,6,2,2,6,8,3,0,0,19,42,3,6,1,0,1,0,0,0,0,0,2255,12,4,-4,5,0,-23,-3,1,70.2,104.2,-34,4,3,1,1
14265,16354,279,287,2,6,6,2,2,6,0,1,13,16,2,2,1,1,0,1,0,1,0,0,-2089,-8,-4,4,-4,0,-3,0,0,72.4,29.4,43,5,4,1,0
15246,15304,228,251,6,6,6,6,9,6,0,1,14,20,4,0,0,1,0,1,0,1,0,0,-58,-23,0,0,3,0,-6,4,-1,68.8,15.4,53.4,2,3,-1,0
15617,13762,282,271,6,2,2,6,6,3,0,1,16,20,4,3,0,0,0,1,0,1,0,0,1855,11,4,-4,3,0,-4,1,0,62.2,17.8,44.4,4,3,1,0
17605,13871,277,253,9,4,4,9,7,3,0,1,16,12,0,2,5,0,0,1,0,1,0,0,3734,24,5,-5,4,0,4,-2,5,41,40.2,0.8,3,5,-2,1
15678,16128,219,267,9,6,6,9,10,8,0,0,19,18,1,3,0,2,0,1,0,0,0,0,-450,-48,3,-3,2,0,1,-2,-2,29,17.4,11.6,3,4,-1,0
17758,14588,267,243,11,3,3,11,16,2,0,0,13,15,0,2,0,0,1,0,0,0,0,0,3170,24,8,-8,14,0,-2,-2,0,30,37.4,-7.4,4,4,0,1
14511,14739,234,229,5,6,6,5,5,7,0,0,15,30,1,4,0,0,1,0,0,0,0,0,-228,5,-1,1,-2,0,-15,-3,0,111,48.2,62.8,5,3,2,1
15516,15738,295,274,4,5,5,4,3,9,0,0,15,39,0,1,0,0,1,0,0,0,0,0,-222,21,-1,1,-6,0,-24,-1,0,51.2,30.6,20.6,4,5,-1,1
15196,15267,280,276,4,6,6,4,3,2,0,1,14,12,1,3,1,1,0,1,0,1,0,0,-71,4,-2,2,1,0,2,-2,0,12,14.4,-2.4,5,4,1,0
15157,15410,227,243,5,7,8,5,12,7,0,0,30,13,8,0,0,0,0,1,0,0,0,0,-253,-16,-2,3,5,0,17,8,0,41.6,13.8,27.8,5,4,1,1
17428,13577,240,193,13,5,5,13,16,2,0,0,19,14,6,1,1,0,0,1,0,0,0,0,3851,47,8,-8,14,0,5,5,1,36.4,24.2,12.2,3,4,-1,1
15152,17085,261,293,4,9,9,4,5,10,0,1,90,29,5,3,1,1,0,1,0,1,0,0,-1933,-32,-5,5,-5,0,61,2,0,55.4,23.8,31.6,4,2,2,0
16753,15023,212,213,10,6,6,11,10,5,0,0,14,15,0,3,2,0,1,0,0,0,0,0,1730,-1,4,-5,5,0,-1,-3,2,36.2,42.6,-6.4,5,4,1,1
17397,16193,266,252,9,7,7,9,11,8,0,0,124,12,2,2,2,0,1,0,0,0,0,0,1204,14,2,-2,3,0,112,0,2,76.4,28.6,47.8,3,3,0,1
13016,14465,242,292,1,2,2,1,1,2,0,1,16,14,3,4,0,0,0,1,0,1,0,0,-1449,-50,-1,1,-1,0,2,-1,0,16,70.6,-54.6,5,3,2,0
15154,15481,241,259,6,6,6,6,7,4,0,0,18,17,2,3,1,1,0,1,0,0,0,0,-327,-18,0,0,3,0,1,-1,0,20.6,25.8,-5.2,3,4,-1,1
15800,15635,259,264,6,5,6,6,13,3,0,0,17,16,2,4,0,2,0,1,0,0,0,0,165,-5,1,0,10,0,1,-2,-2,20.2,9.2,11,4,4,0,0
15114,17170,282,266,4,9,9,4,5,16,0,0,18,40,1,7,1,1,0,1,0,0,0,0,-2056,16,-5,5,-11,0,-22,-6,0,63,61.6,1.4,4,5,-1,0
16557,14103,275,282,9,2,2,9,14,2,0,0,16,16,0,0,0,1,1,0,0,0,0,0,2454,-7,7,-7,12,0,0,0,-1,97.6,43.8,53.8,5,2,3,1
16434,15380,273,252,7,5,5,7,9,7,1,0,14,13,4,2,3,0,1,0,1,0,0,0,1054,21,2,-2,2,0,1,2,3,4.6,21.2,-16.6,1,5,-4,1
16088,15780,272,260,6,6,6,6,8,7,1,0,15,11,1,3,1,1,0,1,1,0,0,0,308,12,0,0,1,0,4,-2,0,11.4,11.2,0.2,3,2,1,0
14474,17160,275,289,3,10,10,3,3,7,0,1,14,17,3,5,0,2,0,1,0,1,0,0,-2686,-14,-7,7,-4,0,-3,-2,-2,34.2,21.2,13,3,4,-1,0
15726,15768,272,274,6,7,7,6,6,6,0,0,15,20,2,4,1,0,0,1,0,0,0,0,-42,-2,-1,1,0,0,-5,-2,1,81.4,68.4,13,3,4,-1,1
14484,15644,231,237,6,7,7,6,3,10,0,0,17,13,1,3,1,0,0,1,0,0,0,0,-1160,-6,-1,1,-7,0,4,-2,1,11,76.8,-65.8,4,5,-1,1
14235,15771,283,276,2,6,6,2,2,7,0,1,16,20,5,2,0,2,1,0,0,1,0,0,-1536,7,-4,4,-5,0,-4,3,-2,40,15.6,24.4,4,3,1,0
15532,15156,288,274,5,4,4,5,9,7,0,0,22,19,1,4,0,0,1,0,0,0,0,0,376,14,1,-1,2,0,3,-3,0,62.8,40.4,22.4,3,2,1,0
15193,14001,294,271,3,2,2,3,4,3,1,0,16,15,4,3,2,0,1,0,1,0,0,0,1192,23,1,-1,1,0,1,1,2,14.6,182.2,-167.6,4,5,-1,1
14695,13019,279,247,4,1,1,4,3,1,1,0,19,10,1,5,0,0,0,1,1,0,0,0,1676,32,3,-3,2,0,9,-4,0,39,4,35,5,1,4,1
16927,14560,269,258,8,4,4,8,11,3,0,1,16,37,3,4,1,0,1,0,0,1,0,0,2367,11,4,-4,8,0,-21,-1,1,24,28.2,-4.2,5,3,2,1
15267,15568,268,301,6,4,4,6,4,3,1,0,86,12,1,1,0,1,0,1,1,0,0,0,-301,-33,2,-2,1,0,74,0,-1,70.2,13.6,56.6,3,4,-1,0
14052,15831,265,301,3,5,5,3,2,3,0,0,20,23,1,5,0,0,1,0,0,0,0,0,-1779,-36,-2,2,-1,0,-3,-4,0,18.6,96.2,-77.6,4,4,0,0
13788,13974,233,288,3,1,1,3,7,1,0,0,39,18,3,4,1,1,1,0,0,0,0,0,-186,-55,2,-2,6,0,21,-1,0,11.8,62.4,-50.6,4,3,1,1
15301,19300,248,306,6,14,14,6,7,22,0,0,12,17,3,2,0,3,1,0,0,0,0,0,-3999,-58,-8,8,-15,0,-5,1,-3,73.6,96.8,-23.2,5,4,1,0
13384,16634,250,280,2,7,7,2,3,11,0,1,12,16,6,3,0,1,0,1,0,1,0,0,-3250,-30,-5,5,-8,0,-4,3,-1,10,24.8,-14.8,4,5,-1,0
15381,13466,301,265,5,2,2,5,2,2,0,0,14,9,2,0,0,0,1,0,0,0,0,0,1915,36,3,-3,0,0,5,2,0,14.4,54.8,-40.4,4,5,-1,0
17882,16250,239,280,11,5,5,11,15,8,1,0,59,20,3,7,1,4,1,0,1,0,0,0,1632,-41,6,-6,7,0,39,-4,-3,14.6,51,-36.4,3,5,-2,1
15571,15505,211,252,8,7,7,8,11,3,0,1,18,13,1,4,1,4,0,1,0,1,0,0,66,-41,1,-1,8,0,5,-3,-3,92.2,54.2,38,4,4,0,0
14549,17497,262,253,4,10,10,4,7,16,1,0,32,12,3,4,0,1,0,1,1,0,0,0,-2948,9,-6,6,-9,0,20,-1,-1,16.8,26.6,-9.8,5,5,0,0
14857,16928,256,280,4,8,8,4,4,10,0,0,19,20,7,4,0,1,0,1,0,0,0,0,-2071,-24,-4,4,-6,0,-1,3,-1,63.8,130.2,-66.4,5,4,1,1
15374,16491,257,243,5,7,7,5,6,9,0,0,12,16,3,1,2,3,0,1,0,0,0,1,-1117,14,-2,2,-3,0,-4,2,-1,20,42.6,-22.6,3,5,-2,0
16087,13196,268,284,7,0,0,7,13,0,0,1,13,22,3,2,0,0,1,0,0,1,0,0,2891,-16,7,-7,13,0,-9,1,0,37,51.6,-14.6,5,3,2,1
13526,13845,266,248,2,3,3,2,0,6,1,0,25,14,2,2,1,0,0,1,1,0,0,0,-319,18,-1,1,-6,0,11,0,1,19.6,6.2,13.4,1,1,0,0
15955,15364,285,276,6,4,4,6,3,7,0,0,15,16,2,2,2,1,1,0,0,0,0,0,591,9,2,-2,-4,0,-1,0,1,7.4,9.8,-2.4,4,3,1,0
15494,15456,283,276,5,5,5,5,5,7,0,0,18,18,4,1,0,1,1,0,0,0,0,0,38,7,0,0,-2,0,0,3,-1,23.2,72,-48.8,4,4,0,0
15999,15368,285,264,5,5,5,5,4,9,0,0,17,124,3,2,0,0,1,0,0,0,0,0,631,21,0,0,-5,0,-107,1,0,73,9.8,63.2,4,2,2,0
15823,16332,229,276,8,6,6,8,17,6,1,0,47,11,0,3,1,4,0,1,1,0,0,0,-509,-47,2,-2,11,0,36,-3,-3,30.6,27,3.6,4,4,0,1
16760,14967,304,240,7,5,5,7,5,6,1,0,20,13,2,3,1,0,1,0,1,0,0,0,1793,64,2,-2,-1,0,7,-1,1,13.2,15.8,-2.6,4,4,0,1
17690,15210,259,253,12,6,6,12,19,7,0,0,18,15,5,7,1,0,1,0,0,0,0,0,2480,6,6,-6,12,0,3,-2,1,14.4,78.2,-63.8,4,5,-1,1
14110,14596,251,240,4,4,4,4,3,6,0,0,14,15,2,3,0,2,1,0,0,0,0,0,-486,11,0,0,-3,0,-1,-1,-2,8,61.8,-53.8,3,4,-1,0
15403,15922,254,262,6,7,7,6,5,7,0,0,16,17,2,2,1,2,0,1,0,0,0,0,-519,-8,-1,1,-2,0,-1,0,-1,26.2,30.4,-4.2,4,3,1,0
13696,15088,262,276,2,5,5,2,3,5,0,1,21,20,3,1,0,0,0,1,0,1,0,0,-1392,-14,-3,3,-2,0,1,2,0,119.2,88,31.2,5,5,0,0
16431,13849,278,258,6,3,3,6,10,3,1,0,37,14,4,4,1,0,0,1,1,0,0,0,2582,20,3,-3,7,0,23,0,1,20.8,27.6,-6.8,4,5,-1,0
15036,14904,210,239,9,7,7,9,10,2,0,0,10,15,3,1,0,0,1,0,0,0,0,0,132,-29,2,-2,8,0,-5,2,0,13.6,7.8,5.8,4,2,2,0
16130,14529,263,213,7,6,6,7,8,5,0,0,98,141,2,2,1,0,0,1,0,0,0,0,1601,50,1,-1,3,0,-43,0,1,33,25.2,7.8,4,4,0,1
14522,14553,277,267,3,3,3,3,10,5,1,0,23,127,3,6,0,0,1,0,1,0,0,0,-31,10,0,0,5,0,-104,-3,0,37,63,-26,5,2,3,1
14301,15225,268,272,3,4,4,3,2,5,0,0,12,18,5,0,0,0,1,0,0,0,0,0,-924,-4,-1,1,-3,0,-6,5,0,11.6,30.8,-19.2,4,4,0,0
15610,14552,262,261,6,3,3,6,6,6,0,0,44,15,2,1,1,0,1,0,0,0,0,0,1058,1,3,-3,0,0,29,1,1,36.6,73.8,-37.2,3,4,-1,0
16103,15670,280,263,7,7,7,9,3,7,0,1,12,16,5,3,0,1,1,0,0,1,0,0,433,17,0,-2,-4,0,-4,2,-1,28,22.8,5.2,3,3,0,1
16303,14034,284,239,8,4,4,8,9,5,0,0,21,14,3,4,0,0,0,1,0,0,0,0,2269,45,4,-4,4,0,7,-1,0,101.6,54.4,47.2,5,4,1,0
16092,15359,257,242,8,8,8,8,13,8,0,1,14,16,7,5,0,0,1,0,0,1,0,0,733,15,0,0,5,0,-2,2,0,43.4,27.2,16.2,3,2,1,1
15854,14662,262,276,6,3,3,6,7,4,0,0,36,17,5,4,0,1,1,0,0,0,0,0,1192,-14,3,-3,3,0,19,1,-1,74.6,10,64.6,5,5,0,1
16004,15176,268,267,7,4,4,7,6,2,1,0,17,12,2,2,0,3,0,1,1,0,0,0,828,1,3,-3,4,0,5,0,-3,45,25.2,19.8,5,2,3,1
14370,15939,260,269,3,5,5,3,4,6,0,0,17,16,1,4,0,2,0,1,0,0,0,0,-1569,-9,-2,2,-2,0,1,-3,-2,6.4,36.8,-30.4,1,4,-3,0
12967,15655,271,255,0,7,7,0,0,10,0,1,32,13,4,1,0,0,0,1,0,1,0,0,-2688,16,-7,7,-10,0,19,3,0,6.8,37.8,-31,3,4,-1,1
16174,16364,261,262,7,8,8,7,6,8,0,0,19,14,4,2,1,1,1,0,0,0,0,0,-190,-1,-1,1,-2,0,5,2,0,14.4,59.2,-44.8,4,5,-1,1
15486,15623,245,267,6,6,6,6,10,7,0,0,17,19,3,3,0,2,0,1,0,0,0,0,-137,-22,0,0,3,0,-2,0,-2,11.4,22.4,-11,3,2,1,1
15236,16449,247,225,6,10,10,6,4,11,0,0,23,14,2,5,1,1,0,1,0,0,0,0,-1213,22,-4,4,-7,0,9,-3,0,23.2,25.4,-2.2,3,4,-1,0
16949,14041,262,221,9,5,5,9,7,3,0,0,132,12,0,2,1,0,1,0,0,0,0,0,2908,41,4,-4,4,0,120,-2,1,13.6,15,-1.4,5,4,1,1
17749,15074,270,253,11,4,4,11,16,8,0,0,18,15,2,1,1,2,0,1,0,0,0,0,2675,17,7,-7,8,0,3,1,-1,14.2,31.8,-17.6,2,4,-2,0
14507,14730,264,219,4,6,6,4,1,8,0,1,13,17,4,3,0,0,0,1,0,1,0,0,-223,45,-2,2,-7,0,-4,1,0,14,59.6,-45.6,2,4,-2,1
13341,15656,258,274,1,5,5,1,2,8,0,0,14,23,2,4,0,0,0,1,0,0,0,0,-2315,-16,-4,4,-6,0,-9,-2,0,90.6,25.8,64.8,5,4,1,1
15435,14645,284,248,5,5,5,5,4,5,0,1,13,13,2,3,1,0,1,0,0,1,0,0,790,36,0,0,-1,0,0,-1,1,32.6,12.4,20.2,5,3,2,0
17560,16096,264,264,8,7,7,8,19,6,0,1,21,13,2,7,0,0,0,1,0,1,0,0,1464,0,1,-1,13,0,8,-5,0,44,36.6,7.4,4,4,0,1
13606,17022,241,291,3,8,8,3,5,8,0,0,8,18,2,1,0,1,0,1,0,0,0,0,-3416,-50,-5,5,-3,0,-10,1,-1,12.4,11.2,1.2,3,3,0,0
15303,14842,258,249,5,5,5,5,9,7,1,0,17,92,2,3,0,0,1,0,1,0,0,0,461,9,0,0,2,0,-75,-1,0,26.4,20.6,5.8,3,3,0,1
15076,15490,264,273,5,6,6,5,4,4,0,1,16,34,3,4,0,0,0,1,0,1,0,0,-414,-9,-1,1,0,0,-18,-1,0,18.8,13.4,5.4,5,5,0,0
13145,14478,273,314,0,1,1,0,0,2,0,0,17,37,6,3,1,0,0,1,0,0,0,0,-1333,-41,-1,1,-2,0,-20,3,1,67.4,10.4,57,4,3,1,1
18968,15167,214,214,17,6,6,17,22,7,1,0,18,66,1,1,2,2,1,0,1,0,0,0,3801,0,11,-11,15,0,-48,0,0,63.4,27.6,35.8,4,3,1,1
17750,15840,261,227,10,9,9,10,17,12,0,1,16,17,1,3,1,0,0,1,0,1,0,0,1910,34,1,-1,5,0,-1,-2,1,10.8,8.6,2.2,3,3,0,1
14774,15932,238,254,6,6,6,6,9,9,0,0,13,18,6,1,0,2,1,0,0,0,0,0,-1158,-16,0,0,0,0,-5,5,-2,34.2,13.2,21,4,4,0,1
15753,15912,292,277,5,5,5,5,6,5,1,0,21,14,5,2,0,1,0,1,1,0,0,0,-159,15,0,0,1,0,7,3,-1,18.6,20.2,-1.6,5,4,1,1
16417,13733,272,253,5,2,2,5,8,4,0,1,35,31,7,2,5,1,1,0,0,1,1,0,2684,19,3,-3,4,0,4,5,4,8.4,37,-28.6,3,4,-1,0
14502,13456,232,266,6,1,1,6,5,0,1,0,15,13,3,8,0,2,1,0,1,0,0,0,1046,-34,5,-5,5,0,2,-5,-2,171,18.8,152.2,4,2,2,0
15547,16804,275,253,5,9,9,5,5,14,0,0,17,19,2,1,2,0,0,1,0,0,0,0,-1257,22,-4,4,-9,0,-2,1,2,12.2,15.6,-3.4,2,3,-1,0
16398,15219,282,225,7,6,7,7,9,6,0,0,16,30,5,2,1,0,1,0,0,0,0,0,1179,57,1,0,3,0,-14,3,1,16,47.8,-31.8,4,4,0,1
14186,17647,225,282,3,9,9,3,7,11,0,0,19,20,4,7,0,0,0,1,0,0,0,0,-3461,-57,-6,6,-4,0,-1,-3,0,24.6,18.2,6.4,5,4,1,0
16528,16489,225,242,10,9,9,10,10,6,0,0,12,16,2,1,0,3,0,1,0,0,0,0,39,-17,1,-1,4,0,-4,1,-3,34.4,38.8,-4.4,4,3,1,1
14779,14758,293,233,2,5,6,2,3,5,0,0,12,34,3,1,0,0,1,0,0,0,0,0,21,60,-3,4,-2,0,-22,2,0,66.6,34.4,32.2,5,5,0,1
15753,14645,291,250,5,4,4,5,4,3,0,1,16,19,2,2,1,1,0,1,0,1,0,0,1108,41,1,-1,1,0,-3,0,0,16.2,96.6,-80.4,3,4,-1,1
15341,14495,263,262,6,5,5,6,7,6,0,0,16,33,4,2,0,0,0,1,0,0,0,0,846,1,1,-1,1,0,-17,2,0,14.2,14.8,-0.6,4,2,2,1
15713,15539,278,275,6,6,6,6,6,3,0,0,99,11,0,1,0,1,0,1,0,0,0,0,174,3,0,0,3,0,88,-1,-1,12.6,132.2,-119.6,3,4,-1,0
17238,14245,264,211,9,5,5,9,9,5,0,0,29,14,6,3,1,0,0,1,0,0,0,0,2993,53,4,-4,4,0,15,3,1,44.6,24.8,19.8,4,3,1,1
15336,15522,261,235,7,7,8,7,3,8,0,0,17,12,2,2,1,0,0,1,0,0,0,0,-186,26,0,1,-5,0,5,0,1,34.4,25.6,8.8,4,4,0,0
16065,13421,252,272,8,0,0,8,10,0,0,0,18,19,4,2,1,1,1,0,0,0,0,0,2644,-20,8,-8,10,0,-1,2,0,18,6,12,3,3,0,0
14719,15125,263,255,4,5,5,4,8,7,0,0,20,15,5,0,1,0,0,1,0,0,0,0,-406,8,-1,1,1,0,5,5,1,43.4,30,13.4,3,4,-1,0
14057,15103,264,292,3,4,4,3,3,2,0,0,17,36,1,4,1,1,0,1,0,0,0,0,-1046,-28,-1,1,1,0,-19,-3,0,92.6,63,29.6,3,3,0,0
14181,18609,217,257,5,12,12,5,5,18,0,0,86,17,2,6,0,1,1,0,0,0,0,0,-4428,-40,-7,7,-13,0,69,-4,-1,8.2,29,-20.8,3,3,0,0
14509,13688,281,220,3,3,3,3,4,4,0,1,14,17,0,1,0,0,0,1,0,1,0,0,821,61,0,0,0,0,-3,-1,0,9.4,7,2.4,4,2,2,1
15848,13463,262,224,7,3,3,7,4,3,0,0,16,17,5,2,3,0,1,0,0,0,0,0,2385,38,4,-4,1,0,-1,3,3,46.2,10.8,35.4,4,3,1,1
15378,15396,281,256,6,5,5,6,6,6,1,0,14,16,3,6,1,2,1,0,1,0,0,0,-18,25,1,-1,0,0,-2,-3,-1,193.4,53.2,140.2,3,4,-1,1
20501,15996,208,210,21,7,7,21,32,7,0,0,22,16,5,3,2,3,1,0,0,0,0,0,4505,-2,14,-14,25,0,6,2,-1,37.8,20.2,17.6,2,3,-1,1
7255,6509,117,88,1,1,1,1,1,0,0,0,7,5,0,0,0,0,0,1,0,0,0,0,746,29,0,0,1,0,2,0,0,19.4,46.4,-27,4,4,0,0
14338,17455,240,262,4,11,11,4,3,16,0,0,53,114,1,6,0,0,0,1,0,0,0,0,-3117,-22,-7,7,-13,0,-61,-5,0,9.8,12.2,-2.4,2,3,-1,0
15319,14224,261,273,6,2,3,6,3,3,0,0,17,17,3,3,1,0,1,0,0,0,0,0,1095,-12,4,-3,0,0,0,0,1,41.8,22.8,19,3,3,0,1
18231,15927,244,228,11,8,8,11,20,9,0,0,17,16,1,1,2,0,1,0,0,0,1,0,2304,16,3,-3,11,0,1,0,2,21.8,12.8,9,5,2,3,1
17016,14229,264,277,10,2,2,10,8,2,0,0,19,17,5,3,1,0,1,0,0,0,0,0,2787,-13,8,-8,6,0,2,2,1,20.2,5.2,15,5,1,4,0
16061,13310,292,267,6,1,1,6,15,1,1,0,17,19,4,5,1,0,1,0,1,0,0,0,2751,25,5,-5,14,0,-2,-1,1,71.8,29.4,42.4,4,5,-1,1
17095,16957,244,225,10,9,9,11,13,8,1,0,20,12,1,0,2,0,0,1,1,0,0,0,138,19,1,-2,5,0,8,1,2,67.4,42.8,24.6,4,2,2,0
16482,14434,239,242,10,5,5,10,11,4,0,0,18,16,3,1,0,0,0,1,0,0,0,0,2048,-3,5,-5,7,0,2,2,0,37.2,66.4,-29.2,2,4,-2,1
16868,15554,276,260,9,6,6,9,4,6,0,0,14,18,3,1,2,0,1,0,0,0,0,0,1314,16,3,-3,-2,0,-4,2,2,116.6,8,108.6,3,1,2,0
14035,20639,197,265,4,17,17,4,5,20,0,1,17,107,1,2,0,5,0,1,0,1,0,0,-6604,-68,-13,13,-15,0,-90,-1,-5,30.4,44.4,-14,3,4,-1,0
15089,14768,278,292,5,4,4,5,6,4,0,1,111,20,2,3,0,0,1,0,0,1,0,0,321,-14,1,-1,2,0,91,-1,0,18.2,20.8,-2.6,4,5,-1,1
14174,19400,242,273,4,15,15,4,4,18,0,0,12,14,0,2,0,2,0,1,0,0,0,0,-5226,-31,-11,11,-14,0,-2,-2,-2,19.6,17.2,2.4,4,4,0,0
13829,13645,269,238,2,3,3,2,1,2,0,0,22,43,1,5,0,0,1,0,0,0,0,0,184,31,-1,1,-1,0,-21,-4,0,56.8,99.4,-42.6,4,5,-1,1
16183,15473,262,269,7,5,5,7,8,3,1,0,48,14,5,6,0,1,1,0,1,0,0,0,710,-7,2,-2,5,0,34,-1,-1,6.8,33.2,-26.4,2,2,0,0
17663,14635,276,245,9,4,4,9,13,7,0,0,13,15,4,0,0,0,0,1,0,0,0,0,3028,31,5,-5,6,0,-2,4,0,70.6,55.4,15.2,4,4,0,1
13846,15545,247,249,4,8,8,4,2,10,0,0,14,112,6,1,0,0,1,0,0,0,0,0,-1699,-2,-4,4,-8,0,-98,5,0,38.2,168.2,-130,4,4,0,1
15758,15011,240,261,8,5,5,8,11,6,0,0,228,13,2,5,0,0,1,0,0,0,0,0,747,-21,3,-3,5,0,215,-3,0,32.4,34.2,-1.8,5,3,2,0
14894,17641,238,272,5,11,11,5,3,7,0,1,16,17,3,2,1,2,0,1,0,1,0,0,-2747,-34,-6,6,-4,0,-1,1,-1,9.2,41.2,-32,2,4,-2,0
15263,13740,255,277,5,2,2,5,7,3,0,0,17,102,4,5,0,0,0,1,0,0,0,0,1523,-22,3,-3,4,0,-85,-1,0,35.2,31.8,3.4,3,3,0,1
16875,16623,246,241,9,10,10,9,7,11,0,1,15,16,0,1,1,1,1,0,0,1,0,0,252,5,-1,1,-4,0,-1,-1,0,57,132.2,-75.2,3,5,-2,1
14370,17188,256,237,3,11,11,3,4,18,0,1,11,16,3,0,0,3,0,1,0,1,0,0,-2818,19,-8,8,-14,0,-5,3,-3,34.6,126.2,-91.6,2,3,-1,0
15420,14654,257,271,7,3,3,7,9,5,0,0,35,39,4,4,0,0,1,0,0,0,0,0,766,-14,4,-4,4,0,-4,0,0,47,48.2,-1.2,4,3,1,0
14314,14559,250,279,3,3,3,3,4,6,0,0,23,17,5,6,0,0,1,0,0,0,0,0,-245,-29,0,0,-2,0,6,-1,0,149.8,19.8,130,5,4,1,1
14696,15243,271,257,4,5,5,4,3,7,0,1,12,63,2,2,1,0,0,1,0,1,0,0,-547,14,-1,1,-4,0,-51,0,1,119.6,4,115.6,4,1,3,1
16161,17306,189,239,11,12,12,12,10,13,0,0,34,12,1,3,0,1,0,1,0,0,0,0,-1145,-50,-1,0,-3,0,22,-2,-1,21.6,23,-1.4,2,2,0,0
16538,14636,255,254,10,4,4,10,15,9,1,0,15,39,3,2,2,0,0,1,1,0,0,0,1902,1,6,-6,6,0,-24,1,2,6.4,72,-65.6,2,4,-2,1
15966,15965,254,242,8,8,8,8,4,8,0,0,13,10,0,1,0,1,0,1,0,0,0,0,1,12,0,0,-4,0,3,-1,-1,4.8,10.8,-6,1,3,-2,1
16616,14271,267,241,10,3,3,10,9,2,1,0,13,12,1,0,1,1,1,0,1,0,0,0,2345,26,7,-7,7,0,1,1,0,122.4,38.4,84,3,4,-1,1
14709,15409,265,275,3,5,5,3,3,5,1,0,18,50,2,3,0,0,0,1,1,0,0,0,-700,-10,-2,2,-2,0,-32,-1,0,14.2,46.2,-32,4,4,0,0
19046,14756,283,247,14,5,5,14,12,3,1,0,11,13,5,4,2,0,1,0,1,0,0,0,4290,36,9,-9,9,0,-2,1,2,48.4,17.4,31,4,3,1,1
13455,16532,236,272,3,9,9,3,1,8,0,0,11,14,1,2,1,2,0,1,0,0,0,0,-3077,-36,-6,6,-7,0,-3,-1,-1,5.6,7.2,-1.6,1,2,-1,0
15713,14225,247,252,7,3,3,7,10,2,1,0,40,13,2,3,1,2,1,0,1,0,0,0,1488,-5,4,-4,8,0,27,-1,-1,54.2,43.6,10.6,4,3,1,1
15798,15959,267,294,6,5,5,6,7,3,0,1,34,14,1,1,1,3,1,0,0,1,0,0,-161,-27,1,-1,4,0,20,0,-2,21.2,66.8,-45.6,3,5,-2,0
16145,14187,283,238,6,4,4,6,3,5,0,0,15,16,2,5,0,0,0,1,0,0,0,0,1958,45,2,-2,-2,0,-1,-3,0,10,29.4,-19.4,3,3,0,1
13427,16484,243,267,2,8,8,2,2,12,1,0,11,15,4,4,0,1,1,0,1,0,0,0,-3057,-24,-6,6,-10,0,-4,0,-1,81,45.6,35.4,5,3,2,0
13782,18192,196,271,5,12,12,5,3,10,0,0,16,27,3,1,0,2,1,0,0,0,0,0,-4410,-75,-7,7,-7,0,-11,2,-2,13.2,5,8.2,4,2,2,0
16869,16157,247,262,9,7,7,9,8,12,0,1,19,18,4,4,1,1,1,0,0,1,0,0,712,-15,2,-2,-4,0,1,0,0,15.8,68,-52.2,3,4,-1,0
16233,15529,288,244,7,6,6,7,5,7,0,0,19,16,3,5,0,0,1,0,0,0,0,0,704,44,1,-1,-2,0,3,-2,0,7,85.6,-78.6,2,3,-1,0
14302,15382,268,257,3,5,5,3,2,10,1,0,29,19,6,2,0,1,0,1,1,0,0,0,-1080,11,-2,2,-8,0,10,4,-1,30.6,132.2,-101.6,4,5,-1,1
16974,18122,210,220,10,11,11,10,15,18,0,0,16,20,4,3,1,0,0,1,0,0,0,0,-1148,-10,-1,1,-3,0,-4,1,1,35.6,25.4,10.2,4,3,1,1
14259,14062,197,231,8,4,4,8,11,4,0,0,15,18,2,4,0,1,1,0,0,0,0,0,197,-34,4,-4,7,0,-3,-2,-1,13.6,2.8,10.8,3,0,3,0
12921,17078,251,280,1,7,7,1,0,7,0,0,15,60,2,5,0,2,0,1,0,0,0,0,-4157,-29,-6,6,-7,0,-45,-3,-2,27.6,33.2,-5.6,5,4,1,0
14158,14009,260,293,3,1,1,3,4,2,0,0,19,12,1,5,0,0,1,0,0,0,0,0,149,-33,2,-2,2,0,7,-4,0,18.6,37.6,-19,3,5,-2,0
13482,14549,232,250,3,5,6,4,2,2,1,0,48,17,4,3,0,0,1,0,1,0,0,0,-1067,-18,-2,2,0,0,31,1,0,80,19.8,60.2,5,4,1,1
14541,15645,254,282,4,5,5,4,3,5,0,0,24,85,3,2,0,0,1,0,0,0,0,0,-1104,-28,-1,1,-2,0,-61,1,0,10.2,6.2,4,4,2,2,1
15334,15621,231,262,7,4,4,7,5,6,0,0,31,105,2,5,0,2,0,1,0,0,0,0,-287,-31,3,-3,-1,0,-74,-3,-2,8.2,39.4,-31.2,3,3,0,0
14100,13807,304,296,1,1,1,1,2,0,0,1,11,13,2,6,0,0,0,1,0,1,0,0,293,8,0,0,2,0,-2,-4,0,45.2,15.4,29.8,5,4,1,0
17859,13852,237,217,11,5,5,11,13,4,0,0,14,12,0,1,2,1,0,1,0,0,0,0,4007,20,6,-6,9,0,2,-1,1,4.4,4,0.4,2,1,1,1
14342,13964,245,229,4,4,4,4,7,5,0,0,145,14,2,2,0,0,1,0,0,0,0,0,378,16,0,0,2,0,131,0,0,10.2,13.8,-3.6,1,1,0,0
16156,15332,237,254,8,5,5,8,11,4,1,0,19,15,4,1,2,1,1,0,1,0,0,0,824,-17,3,-3,7,0,4,3,1,42.6,30.6,12,5,4,1,1
16281,13563,277,236,7,3,3,7,12,3,0,0,16,14,4,3,1,0,0,1,0,0,0,0,2718,41,4,-4,9,0,2,1,1,114.2,44.4,69.8,5,5,0,1
15924,16056,273,250,5,8,8,5,8,16,0,0,89,36,5,1,1,0,1,0,0,0,0,0,-132,23,-3,3,-8,0,53,4,1,5.6,15.4,-9.8,2,4,-2,0
15138,15103,250,261,6,5,5,6,4,6,0,1,19,13,0,5,0,2,0,1,0,1,0,0,35,-11,1,-1,-2,0,6,-5,-2,40.4,48.8,-8.4,3,4,-1,1
14746,14147,241,237,6,3,3,6,1,4,0,0,12,13,0,1,0,1,0,1,0,0,0,0,599,4,3,-3,-3,0,-1,-1,-1,4.8,3,1.8,1,0,1,1
14037,14430,264,289,2,2,2,2,2,2,0,0,11,27,0,2,1,0,0,1,0,0,0,0,-393,-25,0,0,0,0,-16,-2,1,40.8,8,32.8,4,2,2,1
15743,13960,286,252,6,3,3,6,2,4,0,0,39,26,1,5,0,0,1,0,0,0,0,0,1783,34,3,-3,-2,0,13,-4,0,12.2,66,-53.8,4,4,0,1
15611,14304,279,263,6,3,3,6,8,3,0,0,35,17,3,1,0,2,0,1,0,0,0,0,1307,16,3,-3,5,0,18,2,-2,95,26.8,68.2,4,5,-1,1
18000,14858,282,248,11,4,4,11,13,6,0,0,17,126,4,3,0,0,1,0,0,0,0,0,3142,34,7,-7,7,0,-109,1,0,18.8,16.6,2.2,2,3,-1,1
15548,14685,283,273,5,4,4,5,5,4,0,1,113,41,4,2,0,0,0,1,0,1,0,0,863,10,1,-1,1,0,72,2,0,28.6,8.6,20,4,4,0,0
14634,13863,288,251,5,3,3,5,3,3,0,1,33,14,4,3,0,0,1,0,0,1,0,0,771,37,2,-2,0,0,19,1,0,5.6,40.8,-35.2,1,5,-4,0
16350,16392,231,227,10,11,11,10,8,13,0,0,16,22,0,2,3,1,0,1,0,0,0,0,-42,4,-1,1,-5,0,-6,-2,2,10,20.2,-10.2,4,3,1,1
14870,15880,241,253,5,8,8,5,7,5,0,0,34,32,1,2,1,1,0,1,0,0,0,0,-1010,-12,-3,3,2,0,2,-1,0,93.2,70.6,22.6,3,5,-2,0
18564,14239,216,217,19,4,4,19,15,4,0,0,18,13,3,2,1,3,1,0,0,0,0,0,4325,-1,15,-15,11,0,5,1,-2,2,3.6,-1.6,0,0,0,1
16205,15539,280,290,6,4,4,6,8,5,1,0,22,13,1,5,1,0,0,1,1,0,0,0,666,-10,2,-2,3,0,9,-4,1,29.8,7,22.8,5,1,4,1
15568,14363,286,247,5,4,4,5,2,4,0,0,36,13,3,3,1,0,1,0,0,0,0,0,1205,39,1,-1,-2,0,23,0,1,22.4,104,-81.6,4,5,-1,1
15889,14948,265,240,6,6,6,6,9,5,0,0,38,16,1,2,1,0,1,0,0,0,0,0,941,25,0,0,4,0,22,-1,1,19,49.8,-30.8,4,4,0,0
15612,14775,265,282,7,4,4,7,6,2,1,0,173,26,5,1,0,2,1,0,1,0,0,0,837,-17,3,-3,4,0,147,4,-2,38.2,15.2,23,4,3,1,1
15212,15203,304,264,5,5,5,5,2,4,1,0,37,16,3,2,0,0,1,0,1,0,0,0,9,40,0,0,-2,0,21,1,0,83.8,114,-30.2,5,3,2,1
13835,15617,262,264,2,7,7,2,3,9,1,0,16,14,2,4,0,0,0,1,1,0,0,0,-1782,-2,-5,5,-6,0,2,-2,0,17.4,19,-1.6,3,4,-1,0
14841,14037,254,223,5,6,6,5,2,4,0,0,12,14,1,0,1,1,1,0,0,0,0,0,804,31,-1,1,-2,0,-2,1,0,23,11.8,11.2,2,4,-2,1
17658,15998,270,246,10,8,8,10,13,8,0,0,17,16,2,2,0,0,1,0,0,0,0,0,1660,24,2,-2,5,0,1,0,0,16.2,12.2,4,3,4,-1,1
14335,15571,285,294,2,5,5,2,1,6,0,1,17,43,7,2,1,0,0,1,0,1,0,0,-1236,-9,-3,3,-5,0,-26,5,1,28.2,42.2,-14,2,4,-2,0
16791,13094,279,214,9,3,3,9,10,0,0,0,19,34,1,4,1,1,1,0,0,0,0,0,3697,65,6,-6,10,0,-15,-3,0,11.4,123.4,-112,3,4,-1,1
14110,15821,271,256,2,7,7,2,2,8,0,1,12,18,4,2,0,2,1,0,0,1,0,0,-1711,15,-5,5,-6,0,-6,2,-2,10.6,23.8,-13.2,4,2,2,0
16204,14915,263,254,8,5,5,8,11,2,0,0,50,102,5,5,0,0,1,0,0,0,0,0,1289,9,3,-3,9,0,-52,0,0,18,7.8,10.2,4,2,2,1
14672,14788,218,234,7,6,6,8,2,3,0,0,14,15,3,1,0,1,1,0,0,0,0,0,-116,-16,1,-2,-1,0,-1,2,-1,35.8,16.4,19.4,2,2,0,0
14772,16404,287,288,3,7,7,3,3,8,0,1,19,28,3,9,0,0,0,1,0,1,0,0,-1632,-1,-4,4,-5,0,-9,-6,0,15.4,18.6,-3.2,3,5,-2,0
14798,14663,230,251,6,4,4,6,9,4,0,0,33,103,4,1,0,1,1,0,0,0,0,0,135,-21,2,-2,5,0,-70,3,-1,34.4,46.4,-12,4,4,0,1
15937,14496,272,242,7,5,5,7,6,6,0,0,16,12,2,4,0,0,0,1,0,0,0,0,1441,30,2,-2,0,0,4,-2,0,17.6,7,10.6,4,2,2,0
15183,14505,257,273,5,3,3,5,9,5,0,0,17,18,6,1,0,0,1,0,0,0,0,0,678,-16,2,-2,4,0,-1,5,0,129.8,14.6,115.2,3,4,-1,1
15678,15148,252,260,6,5,5,6,6,7,0,1,15,12,3,2,0,0,0,1,0,1,0,0,530,-8,1,-1,-1,0,3,1,0,23,14.2,8.8,5,2,3,0
15927,14717,261,275,6,4,4,6,8,5,0,1,14,10,1,3,0,2,0,1,0,1,0,0,1210,-14,2,-2,3,0,4,-2,-2,14.4,27.4,-13,3,3,0,0
15833,15549,275,261,7,7,7,7,3,4,0,0,14,36,2,6,1,0,1,0,0,0,0,0,284,14,0,0,-1,0,-22,-4,1,19.8,26.2,-6.4,2,4,-2,0
15458,14874,278,256,5,5,6,5,8,4,0,0,17,19,1,3,1,1,0,1,0,0,0,0,584,22,0,1,4,0,-2,-2,0,59.6,8.4,51.2,4,3,1,1
15486,14741,246,235,6,7,7,6,6,3,0,0,15,16,5,2,0,0,0,1,0,0,0,0,745,11,-1,1,3,0,-1,3,0,14.6,62.2,-47.6,4,3,1,1
15654,15480,253,267,6,6,6,6,6,6,0,0,15,12,2,1,0,0,1,0,0,0,0,0,174,-14,0,0,0,0,3,1,0,22.2,10.2,12,3,2,1,1
14720,17222,228,277,4,10,10,4,5,8,0,0,13,20,1,0,2,2,1,0,0,0,0,0,-2502,-49,-6,6,-3,0,-7,1,0,40.2,33,7.2,5,3,2,0
15478,15560,266,254,6,7,7,6,2,6,0,0,14,15,4,2,2,1,0,1,0,0,0,0,-82,12,-1,1,-4,0,-1,2,1,35.2,13.2,22,4,4,0,1
15984,15239,264,259,8,4,4,8,3,3,0,0,24,35,1,1,0,0,1,0,0,0,0,0,745,5,4,-4,0,0,-11,0,0,93.4,33.4,60,3,4,-1,0
15348,15400,270,235,5,7,7,5,7,14,0,0,17,16,6,4,1,0,0,1,0,0,0,0,-52,35,-2,2,-7,0,1,2,1,14.2,17.6,-3.4,2,4,-2,1
17815,13385,239,236,12,2,2,12,14,1,0,1,117,25,3,3,1,1,1,0,0,1,0,0,4430,3,10,-10,13,0,92,0,0,14.4,32.4,-18,3,5,-2,1
17048,16459,259,257,9,9,9,9,9,6,0,0,15,15,1,4,1,0,1,0,0,0,0,0,589,2,0,0,3,0,0,-3,1,5.8,33.4,-27.6,2,3,-1,0
13627,18217,222,279,3,13,13,3,3,13,1,0,31,13,1,4,0,1,1,0,1,0,0,0,-4590,-57,-10,10,-10,0,18,-3,-1,34.2,70.4,-36.2,4,4,0,0
17764,14511,269,252,9,5,5,9,11,4,0,1,17,12,2,5,1,0,1,0,0,1,0,0,3253,17,4,-4,7,0,5,-3,1,12.2,32.6,-20.4,3,3,0,1
15161,13802,269,269,5,1,1,5,6,1,0,1,49,19,3,2,0,0,1,0,0,1,0,0,1359,0,4,-4,5,0,30,1,0,34.8,35.4,-0.6,3,3,0,1
15558,16910,211,244,9,10,10,9,8,9,0,0,17,17,3,6,0,1,1,0,0,0,0,0,-1352,-33,-1,1,-1,0,0,-3,-1,12.8,13.2,-0.4,5,4,1,1
15591,13013,253,245,7,1,1,7,6,1,1,0,17,14,8,5,0,1,1,0,1,0,0,0,2578,8,6,-6,5,0,3,3,-1,26.2,13.4,12.8,4,4,0,1
15754,15253,276,287,6,4,5,6,8,7,0,0,15,15,3,1,2,0,1,0,0,0,0,0,501,-11,2,-1,1,0,0,2,2,38.4,111,-72.6,5,5,0,0
16828,14348,250,218,9,6,6,9,11,5,0,1,15,18,5,2,1,1,1,0,0,1,0,0,2480,32,3,-3,6,0,-3,3,0,18.6,12.4,6.2,2,4,-2,1
15755,15189,243,259,7,5,5,7,10,5,1,0,22,32,3,2,1,1,1,0,1,0,0,0,566,-16,2,-2,5,0,-10,1,0,15.2,24,-8.8,4,5,-1,0
16523,14905,239,246,9,5,5,9,10,3,0,1,18,14,2,2,2,0,1,0,0,1,0,0,1618,-7,4,-4,7,0,4,0,2,33,22.2,10.8,5,2,3,0
15117,14493,258,267,5,3,3,6,7,7,0,0,23,111,2,1,0,1,1,0,0,0,0,0,624,-9,2,-3,0,0,-88,1,-1,10.8,17.6,-6.8,3,2,1,0
16755,15892,258,232,9,10,10,9,11,6,1,0,24,17,3,1,3,0,0,1,1,0,0,0,863,26,-1,1,5,0,7,2,3,122.2,7.2,115,5,3,2,1
15149,15241,261,288,6,6,6,6,7,3,0,1,9,16,2,1,0,0,0,1,0,1,0,0,-92,-27,0,0,4,0,-7,1,0,65.4,15.2,50.2,3,3,0,0
14830,14089,298,279,4,2,2,4,2,2,1,0,20,11,4,2,0,0,1,0,1,0,0,0,741,19,2,-2,0,0,9,2,0,91.8,47.6,44.2,5,5,0,1
15898,13887,286,246,6,3,3,6,12,5,1,0,13,13,3,3,1,0,1,0,1,0,0,0,2011,40,3,-3,7,0,0,0,1,12.2,15.8,-3.6,4,4,0,0
14766,13342,249,245,5,3,3,5,9,0,0,0,31,17,3,3,1,0,1,0,0,0,0,0,1424,4,2,-2,9,0,14,0,1,92,91.4,0.6,3,3,0,1
15179,15852,281,245,4,8,8,4,3,11,0,0,15,35,1,5,1,0,1,0,0,0,0,0,-673,36,-4,4,-8,0,-20,-4,1,31.4,6.8,24.6,4,2,2,0
14301,15293,277,281,2,4,4,2,1,3,0,1,12,32,2,4,1,1,0,1,0,1,0,0,-992,-4,-2,2,-2,0,-20,-2,0,22.6,34.2,-11.6,4,3,1,0
16430,14596,230,214,10,6,6,11,10,4,0,1,46,13,0,1,1,1,1,0,0,1,0,0,1834,16,4,-5,6,0,33,-1,0,117,13.2,103.8,4,2,2,1
16183,15219,254,254,9,6,6,9,5,5,0,0,19,14,1,4,1,0,0,1,0,0,0,0,964,0,3,-3,0,0,5,-3,1,19.2,44.4,-25.2,2,3,-1,1
15279,16082,258,300,5,5,5,5,9,4,1,0,30,13,3,4,1,3,0,1,1,0,0,0,-803,-42,0,0,5,0,17,-1,-2,42,76,-34,4,4,0,0
16888,14938,240,213,11,7,7,11,12,7,0,0,28,21,2,1,0,1,1,0,0,0,0,0,1950,27,4,-4,5,0,7,1,-1,30.6,10.6,20,4,3,1,1
17192,14102,280,253,9,2,2,9,5,4,0,0,17,15,2,3,1,0,1,0,0,0,0,0,3090,27,7,-7,1,0,2,-1,1,76.6,7.2,69.4,5,2,3,1
16888,16755,284,280,8,8,8,8,6,11,0,0,20,12,1,3,3,2,1,0,0,0,0,0,133,4,0,0,-5,0,8,-2,1,58.2,93.6,-35.4,5,5,0,1
18172,15914,276,206,11,9,9,11,22,16,1,0,14,17,2,3,2,0,0,1,1,0,0,0,2258,70,2,-2,6,0,-3,-1,2,17,19.6,-2.6,3,2,1,1
14599,15110,264,233,4,6,6,4,4,6,1,0,15,14,4,1,1,0,1,0,1,0,0,0,-511,31,-2,2,-2,0,1,3,1,27,8.6,18.4,5,2,3,1
16199,15641,284,281,6,5,5,6,7,4,0,0,48,13,1,2,1,2,0,1,0,0,0,0,558,3,1,-1,3,0,35,-1,-1,64.2,48,16.2,4,4,0,0
14935,16064,266,287,4,7,7,4,5,10,0,1,15,118,4,2,0,0,1,0,0,1,0,0,-1129,-21,-3,3,-5,0,-103,2,0,11.2,89,-77.8,3,5,-2,0
13712,16154,254,320,2,5,5,2,3,4,0,0,65,18,2,5,0,1,0,1,0,0,0,0,-2442,-66,-3,3,-1,0,47,-3,-1,14,47.8,-33.8,3,4,-1,0
14528,17853,258,241,5,10,10,5,4,14,0,0,12,16,5,1,0,0,1,0,0,0,0,0,-3325,17,-5,5,-10,0,-4,4,0,9,12.2,-3.2,3,3,0,0
17530,12926,276,233,11,2,3,11,6,2,0,0,35,18,2,1,0,0,1,0,0,0,0,0,4604,43,9,-8,4,0,17,1,0,49.8,11.8,38,4,4,0,1
17216,14408,256,263,11,3,3,11,9,3,1,0,16,13,2,0,2,0,1,0,1,0,0,0,2808,-7,8,-8,6,0,3,2,2,28.8,44.8,-16,2,4,-2,1
16810,15415,242,201,11,8,8,11,15,5,0,0,16,48,2,4,0,0,1,0,0,0,0,0,1395,41,3,-3,10,0,-32,-2,0,91.6,106.8,-15.2,5,4,1,1
16868,16046,233,253,11,7,7,11,10,5,0,0,19,16,1,3,0,0,0,1,0,0,0,0,822,-20,4,-4,5,0,3,-2,0,27,8.2,18.8,5,2,3,0
15972,15143,277,256,8,5,5,8,8,7,0,0,15,20,3,1,0,0,1,0,0,0,0,0,829,21,3,-3,1,0,-5,2,0,27.2,10.8,16.4,5,3,2,1
14667,14518,268,286,3,2,2,3,4,3,0,0,17,19,6,3,0,1,0,1,0,0,0,0,149,-18,1,-1,1,0,-2,3,-1,59.8,15.6,44.2,5,3,2,1
14441,15318,301,310,2,3,3,2,1,5,0,1,13,15,3,1,0,0,1,0,0,1,0,0,-877,-9,-1,1,-4,0,-2,2,0,26.4,6,20.4,3,2,1,0
14499,17471,232,276,5,8,8,5,3,9,0,1,23,16,5,7,0,2,0,1,0,1,0,0,-2972,-44,-3,3,-6,0,7,-2,-2,26.8,35.4,-8.6,2,4,-2,0
14439,15798,265,285,3,5,5,3,4,6,1,0,31,88,6,2,0,0,0,1,1,0,0,0,-1359,-20,-2,2,-2,0,-57,4,0,9.4,57.2,-47.8,2,3,-1,1
15592,16341,254,255,7,8,8,7,9,5,0,0,15,20,4,2,1,1,1,0,0,0,0,0,-749,-1,-1,1,4,0,-5,2,0,13.8,50.8,-37,2,4,-2,0
15603,16088,275,258,5,8,8,5,6,7,0,0,37,28,4,1,0,0,1,0,0,0,0,0,-485,17,-3,3,-1,0,9,3,0,9.2,23.4,-14.2,3,4,-1,0
15731,16162,256,256,7,7,7,8,13,10,0,0,17,14,5,2,0,1,1,0,0,0,0,0,-431,0,0,-1,3,0,3,3,-1,52.4,93.4,-41,5,5,0,0
15036,15352,223,272,6,4,4,6,6,5,0,0,14,17,7,2,1,1,1,0,0,0,0,0,-316,-49,2,-2,1,0,-3,5,0,75.8,6.8,69,2,3,-1,0
17512,15181,239,232,10,6,6,10,13,9,0,0,12,13,5,1,3,0,0,1,0,0,0,0,2331,7,4,-4,4,0,-1,4,3,23.8,92.4,-68.6,4,3,1,1
15293,15169,252,255,5,5,5,6,5,4,0,0,14,39,6,3,0,1,0,1,0,0,0,0,124,-3,0,-1,1,0,-25,3,-1,10.8,138.6,-127.8,4,5,-1,1
14910,13333,285,255,5,2,2,5,2,1,1,0,126,18,1,1,0,0,1,0,1,0,0,0,1577,30,3,-3,1,0,108,0,0,29.8,48.8,-19,3,3,0,1
15226,15338,266,303,5,4,4,5,10,4,0,0,25,15,1,5,0,1,0,1,0,0,0,0,-112,-37,1,-1,6,0,10,-4,-1,22,65,-43,4,2,2,0
18898,14880,296,298,12,3,3,12,23,3,0,0,19,105,0,2,0,0,1,0,0,0,0,0,4018,-2,9,-9,20,0,-86,-2,0,71.8,12.4,59.4,5,3,2,1
14836,15381,284,290,3,5,5,3,5,4,0,0,36,17,2,2,0,0,0,1,0,0,0,0,-545,-6,-2,2,1,0,19,0,0,15.8,77.2,-61.4,4,5,-1,1
16080,16407,250,257,8,7,7,8,9,9,1,0,14,14,5,2,2,1,0,1,1,0,0,0,-327,-7,1,-1,0,0,0,3,1,33.2,16.6,16.6,5,3,2,1
16468,17913,291,272,6,11,11,6,9,15,0,1,111,15,7,2,0,0,1,0,0,1,0,0,-1445,19,-5,5,-6,0,96,5,0,30.8,27.8,3,5,4,1,0
14270,14133,209,228,5,5,5,5,5,5,0,0,24,18,1,3,0,2,1,0,0,0,0,0,137,-19,0,0,0,0,6,-2,-2,67.6,9.8,57.8,3,3,0,1
19061,14583,281,237,14,5,5,14,15,4,0,0,15,10,1,3,0,0,1,0,0,0,0,0,4478,44,9,-9,11,0,5,-2,0,21.4,37,-15.6,4,4,0,1
15085,15651,236,265,7,6,6,7,8,10,0,1,13,39,3,5,0,1,1,0,0,1,0,0,-566,-29,1,-1,-2,0,-26,-2,-1,55.2,90.4,-35.2,5,5,0,0
15030,17132,251,262,4,9,9,4,6,16,0,1,10,19,5,1,0,1,1,0,0,1,0,0,-2102,-11,-5,5,-10,0,-9,4,-1,25.2,29.2,-4,4,3,1,1
14185,14203,232,251,5,4,4,5,2,3,0,1,55,16,2,4,0,1,1,0,0,1,0,0,-18,-19,1,-1,-1,0,39,-2,-1,112,81.8,30.2,4,3,1,0
15389,14903,258,221,7,6,6,7,3,7,0,0,14,25,2,4,3,2,0,1,0,0,0,0,486,37,1,-1,-4,0,-11,-2,1,35,6,29,2,1,1,1
14950,15458,247,195,6,9,9,6,6,10,0,0,14,28,3,1,1,0,1,0,0,0,0,0,-508,52,-3,3,-4,0,-14,2,1,67.4,91.6,-24.2,3,2,1,1
16603,14096,276,261,7,3,3,7,7,6,0,1,15,108,1,2,3,0,1,0,0,1,0,0,2507,15,4,-4,1,0,-93,-1,3,45,34.6,10.4,5,4,1,1
15636,15023,271,235,6,6,6,6,5,9,0,0,16,16,2,2,2,0,1,0,0,0,0,0,613,36,0,0,-4,0,0,0,2,19.6,22,-2.4,3,2,1,1
15246,13335,268,265,6,2,2,6,9,2,0,1,22,14,1,2,0,0,0,1,0,1,0,0,1911,3,4,-4,7,0,8,-1,0,21.8,35.2,-13.4,2,5,-3,1
15269,14103,277,228,4,4,4,4,6,7,1,0,16,15,3,3,3,0,0,1,1,0,0,0,1166,49,0,0,-1,0,1,0,3,45.8,30,15.8,4,5,-1,1
16361,15154,246,235,8,5,5,9,12,10,0,0,28,18,5,6,0,1,0,1,0,0,0,0,1207,11,3,-4,2,0,10,-1,-1,9.2,3.8,5.4,4,0,4,1
14172,17189,241,288,3,9,9,3,1,10,0,0,53,18,5,4,2,0,1,0,0,0,0,0,-3017,-47,-6,6,-9,0,35,1,2,52.6,166.6,-114,3,4,-1,0
14000,14537,224,231,5,6,6,5,4,4,0,0,17,22,4,3,0,0,1,0,0,0,0,0,-537,-7,-1,1,0,0,-5,1,0,94,91.4,2.6,3,2,1,1
15066,13678,292,251,4,2,2,4,1,1,0,0,15,37,3,2,0,0,1,0,0,0,0,0,1388,41,2,-2,0,0,-22,1,0,12.6,15.2,-2.6,4,4,0,1
15787,15588,263,239,6,8,8,6,3,12,0,1,19,29,3,3,0,2,0,1,0,1,0,0,199,24,-2,2,-9,0,-10,0,-2,11.4,55.2,-43.8,3,4,-1,1
14861,15674,239,266,5,6,6,5,5,5,0,0,14,15,2,2,1,1,1,0,0,0,0,0,-813,-27,-1,1,0,0,-1,0,0,37.8,12.2,25.6,3,2,1,1
15706,18065,269,298,6,12,12,6,9,12,0,1,14,21,3,3,0,3,0,1,0,1,0,0,-2359,-29,-6,6,-3,0,-7,0,-3,68.2,72.8,-4.6,4,4,0,0
13696,15664,225,264,4,6,6,4,5,4,0,0,15,29,3,3,0,1,0,1,0,0,0,0,-1968,-39,-2,2,1,0,-14,0,-1,19.2,13.4,5.8,5,3,2,0
14290,17114,248,263,3,11,11,3,5,13,0,0,32,13,5,3,0,0,1,0,0,0,0,0,-2824,-15,-8,8,-8,0,19,2,0,49.4,30.2,19.2,5,4,1,0
14704,17799,222,255,6,8,8,6,9,11,0,0,14,27,1,3,0,1,1,0,0,0,0,0,-3095,-33,-2,2,-2,0,-13,-2,-1,81,55.6,25.4,4,3,1,0
15338,14330,274,252,5,3,3,5,3,3,0,0,14,20,2,0,2,0,1,0,0,0,0,0,1008,22,2,-2,0,0,-6,2,2,12.8,47,-34.2,3,5,-2,1
17264,14841,269,233,9,6,6,9,6,4,0,0,10,15,2,0,3,0,0,1,0,0,0,0,2423,36,3,-3,2,0,-5,2,3,67,8.8,58.2,5,2,3,1
15816,15021,259,243,6,6,6,6,6,9,0,0,146,17,3,1,0,0,1,0,0,0,0,0,795,16,0,0,-3,0,129,2,0,16.4,8,8.4,4,1,3,0
15286,14889,235,220,7,6,7,7,7,12,0,0,18,15,2,2,0,0,1,0,0,0,0,0,397,15,1,0,-5,0,3,0,0,36.8,57.8,-21,5,4,1,1
13941,16011,251,264,3,6,6,3,4,11,0,1,12,15,7,4,0,2,0,1,0,1,0,0,-2070,-13,-3,3,-7,0,-3,3,-2,49.8,32,17.8,5,4,1,0
16975,16616,222,235,11,9,9,11,11,12,0,0,15,16,3,2,2,2,1,0,0,0,0,0,359,-13,2,-2,-1,0,-1,1,0,10.4,48,-37.6,2,3,-1,1
15321,14999,238,249,7,7,7,7,7,3,0,0,15,14,4,3,1,0,1,0,0,0,0,0,322,-11,0,0,4,0,1,1,1,20.6,13,7.6,5,4,1,0
14985,17034,263,259,5,10,10,5,9,12,1,0,12,12,4,1,0,2,1,0,1,0,0,0,-2049,4,-5,5,-3,0,0,3,-2,20,75.2,-55.2,4,4,0,1
16351,16864,248,226,8,9,9,8,9,15,0,0,18,39,1,1,2,1,1,0,0,0,0,0,-513,22,-1,1,-6,0,-21,0,1,63.2,23.2,40,5,1,4,0
15342,15496,268,276,5,5,5,5,5,6,0,0,17,13,1,4,0,1,0,1,0,0,0,0,-154,-8,0,0,-1,0,4,-3,-1,20.2,4.2,16,4,1,3,0
15204,16432,264,275,5,6,6,5,8,10,0,0,14,16,6,0,1,1,1,0,0,0,0,0,-1228,-11,-1,1,-2,0,-2,6,0,48.2,40.4,7.8,4,4,0,0
14317,14175,275,271,3,3,3,3,3,3,0,1,14,16,2,0,0,0,1,0,0,1,0,0,142,4,0,0,0,0,-2,2,0,33.6,15.2,18.4,4,4,0,0
14610,14972,254,261,5,5,5,5,2,3,0,0,15,14,0,1,1,1,1,0,0,0,0,0,-362,-7,0,0,-1,0,1,-1,0,6.8,107,-100.2,2,4,-2,1
14765,12980,238,261,5,1,1,5,7,2,0,1,20,14,2,4,1,0,1,0,0,1,0,0,1785,-23,4,-4,5,0,6,-2,1,8.6,8.6,0,2,2,0,1
14970,12606,255,194,5,3,3,5,3,2,0,0,27,15,5,3,2,0,0,1,0,0,0,0,2364,61,2,-2,1,0,12,2,2,14.4,19,-4.6,2,2,0,1
13852,17366,221,245,3,13,13,3,6,15,0,1,16,20,4,3,0,0,0,1,0,1,0,0,-3514,-24,-10,10,-9,0,-4,1,0,26.8,20.2,6.6,2,4,-2,0
15387,14282,278,284,4,2,2,4,4,4,0,0,13,16,2,4,1,1,0,1,0,0,0,0,1105,-6,2,-2,0,0,-3,-2,0,137,25.2,111.8,3,4,-1,1
17902,14601,278,277,11,3,3,11,16,6,0,0,35,15,5,1,0,0,0,1,0,0,0,0,3301,1,8,-8,10,0,20,4,0,32.4,8,24.4,3,3,0,1
14867,18078,236,269,4,12,12,4,4,11,0,0,14,16,1,2,0,1,0,1,0,0,0,0,-3211,-33,-8,8,-7,0,-2,-1,-1,15.6,43.2,-27.6,3,3,0,0
14312,16417,262,252,4,9,9,4,3,12,0,0,16,21,2,1,0,0,0,1,0,0,0,0,-2105,10,-5,5,-9,0,-5,1,0,93,19.4,73.6,5,3,2,0
15187,15410,230,253,6,5,5,6,9,9,0,0,43,106,3,3,0,0,0,1,0,0,0,0,-223,-23,1,-1,0,0,-63,0,0,30,69.2,-39.2,4,5,-1,0
17184,15193,285,260,9,4,4,9,7,4,0,0,15,14,7,4,2,1,1,0,0,0,0,0,1991,25,5,-5,3,0,1,3,1,36.2,43,-6.8,1,4,-3,0
16489,17276,229,258,9,11,11,9,16,13,0,0,19,15,2,3,0,1,0,1,0,0,0,0,-787,-29,-2,2,3,0,4,-1,-1,99.8,52,47.8,4,3,1,0
16422,15071,291,292,7,4,4,7,6,3,0,0,14,15,1,3,0,1,0,1,0,0,0,0,1351,-1,3,-3,3,0,-1,-2,-1,22.4,16.4,6,2,3,-1,1
16836,15047,257,289,9,4,4,9,11,2,0,0,14,17,4,4,1,1,0,1,0,0,0,0,1789,-32,5,-5,9,0,-3,0,0,74,23.8,50.2,5,5,0,0
14426,15257,273,291,3,4,4,3,4,4,1,0,33,25,7,2,0,0,0,1,1,0,0,0,-831,-18,-1,1,0,0,8,5,0,21.8,31.4,-9.6,4,4,0,1
12744,14514,238,241,2,5,5,2,0,6,0,0,10,17,6,1,0,0,0,1,0,0,0,0,-1770,-3,-3,3,-6,0,-7,5,0,6.8,41.2,-34.4,2,2,0,0
16847,17052,236,216,10,13,13,10,11,21,0,0,16,23,2,2,0,0,0,1,0,0,0,0,-205,20,-3,3,-10,0,-7,0,0,51,41.2,9.8,4,4,0,1
14622,17066,258,283,4,8,8,4,6,7,0,0,18,16,4,1,0,0,1,0,0,0,0,0,-2444,-25,-4,4,-1,0,2,3,0,145.4,41.6,103.8,3,2,1,0
15402,16820,270,259,5,10,10,5,4,8,0,1,106,15,3,2,0,0,0,1,0,1,0,0,-1418,11,-5,5,-4,0,91,1,0,36,57.6,-21.6,3,4,-1,0
15702,13424,260,260,5,1,1,5,7,2,1,0,19,12,2,2,2,0,1,0,1,0,1,0,2278,0,4,-4,5,0,7,0,2,47.6,31.2,16.4,5,2,3,1
16433,15517,287,288,8,4,4,8,11,4,0,0,16,103,2,4,1,0,1,0,0,0,0,0,916,-1,4,-4,7,0,-87,-2,1,30.8,12.2,18.6,5,3,2,0
14658,13562,297,256,3,2,2,3,3,3,0,0,15,17,2,2,0,0,1,0,0,0,0,0,1096,41,1,-1,0,0,-2,0,0,96,30.8,65.2,4,4,0,1
16127,18057,213,228,9,15,15,9,9,20,0,0,20,17,0,4,1,0,1,0,0,0,0,0,-1930,-15,-6,6,-11,0,3,-4,1,95.2,10,85.2,4,2,2,1
15210,14538,289,266,4,3,3,4,7,6,0,0,17,35,4,2,0,1,0,1,0,0,0,0,672,23,1,-1,1,0,-18,2,-1,65.6,39.6,26,5,5,0,0
17113,13019,280,228,9,3,3,9,16,4,1,0,14,15,5,1,0,0,1,0,1,0,0,0,4094,52,6,-6,12,0,-1,4,0,43.2,35.6,7.6,4,4,0,1
15807,14813,275,266,5,3,3,5,7,3,0,0,35,17,6,4,1,1,1,0,0,0,0,0,994,9,2,-2,4,0,18,2,0,10.2,10.2,0,3,4,-1,1
15606,15339,265,255,6,6,6,6,7,5,0,1,12,15,1,2,0,0,0,1,0,1,0,0,267,10,0,0,2,0,-3,-1,0,93.6,22.8,70.8,5,5,0,0
16537,14622,253,247,9,3,3,9,9,3,0,0,14,14,3,4,0,0,1,0,0,0,0,0,1915,6,6,-6,6,0,0,-1,0,15.6,73.2,-57.6,3,4,-1,0
14925,13898,291,289,3,1,1,3,4,0,0,0,31,17,7,1,0,0,1,0,0,0,0,0,1027,2,2,-2,4,0,14,6,0,43.6,45.8,-2.2,4,4,0,1
15066,16400,246,262,5,9,9,5,4,7,1,0,49,16,5,2,1,1,0,1,1,0,0,0,-1334,-16,-4,4,-3,0,33,3,0,77.8,42.2,35.6,5,5,0,0
16707,15494,233,244,10,7,7,10,6,5,0,1,37,13,4,6,2,2,1,0,0,1,0,0,1213,-11,3,-3,1,0,24,-2,0,13.4,14.4,-1,4,4,0,0
15136,15282,236,243,5,5,5,5,13,6,1,0,14,16,2,3,2,0,0,1,1,0,0,0,-146,-7,0,0,7,0,-2,-1,2,39,46.2,-7.2,3,4,-1,1
17553,13856,292,271,9,1,2,9,9,1,0,0,18,18,2,5,4,0,1,0,0,0,0,0,3697,21,8,-7,8,0,0,-3,4,33.6,50.8,-17.2,4,4,0,1
14437,14506,268,271,3,3,3,3,2,5,1,0,16,38,4,4,2,0,1,0,1,0,0,0,-69,-3,0,0,-3,0,-22,0,2,13.2,23.6,-10.4,4,4,0,0
16293,14902,268,281,8,3,3,8,5,3,0,0,13,16,6,4,1,0,1,0,0,0,0,0,1391,-13,5,-5,2,0,-3,2,1,49.8,18.6,31.2,5,4,1,1
15707,16307,237,279,6,8,9,6,8,10,0,1,14,115,3,4,0,1,0,1,0,1,0,0,-600,-42,-2,3,-2,0,-101,-1,-1,10.6,27.2,-16.6,4,3,1,0
15763,15131,292,307,5,3,3,5,6,2,0,0,16,16,2,2,0,0,1,0,0,0,0,0,632,-15,2,-2,4,0,0,0,0,17.8,27.2,-9.4,4,4,0,0
16862,17202,227,255,9,9,9,9,11,11,0,0,17,20,5,3,1,0,1,0,0,0,0,0,-340,-28,0,0,0,0,-3,2,1,67.4,69.2,-1.8,3,5,-2,1
16453,14208,276,278,8,3,3,9,10,1,1,0,24,17,3,2,0,0,0,1,1,0,0,0,2245,-2,5,-6,9,0,7,1,0,66.8,13.6,53.2,5,4,1,1
16995,15362,241,256,11,7,7,11,10,7,0,0,13,14,2,1,1,0,0,1,0,0,0,0,1633,-15,4,-4,3,0,-1,1,1,71.6,31.4,40.2,4,4,0,1
15672,15526,303,250,5,5,5,5,10,9,0,1,17,20,3,5,0,0,1,0,0,1,0,0,146,53,0,0,1,0,-3,-2,0,13.4,28.6,-15.2,5,3,2,0
12953,17780,244,267,1,13,13,1,0,17,0,1,14,16,1,0,0,0,0,1,0,1,0,0,-4827,-23,-12,12,-17,0,-2,1,0,57.6,109.6,-52,5,3,2,0
15893,17031,276,272,7,9,9,7,11,11,0,0,36,28,7,3,0,1,1,0,0,0,0,0,-1138,4,-2,2,0,0,8,4,-1,7.6,33.8,-26.2,3,5,-2,0
14852,16024,289,263,3,5,5,3,2,5,0,0,15,17,1,3,0,0,0,1,0,0,0,0,-1172,26,-2,2,-3,0,-2,-2,0,55.4,21.2,34.2,3,5,-2,0
14331,14620,267,256,3,5,5,3,1,6,0,0,13,19,5,0,2,0,1,0,0,0,0,0,-289,11,-2,2,-5,0,-6,5,2,30.8,16.4,14.4,5,5,0,1
15405,16215,267,270,5,7,8,5,5,6,0,1,16,19,4,4,2,1,1,0,0,1,0,0,-810,-3,-2,3,-1,0,-3,0,1,69.8,50,19.8,5,4,1,0
15360,15957,270,270,4,6,6,4,5,9,0,0,17,17,3,5,0,1,0,1,0,0,0,0,-597,0,-2,2,-4,0,0,-2,-1,37.2,67.8,-30.6,4,5,-1,0
14341,16181,247,271,4,6,6,4,10,10,1,0,16,21,1,4,0,2,0,1,1,0,0,0,-1840,-24,-2,2,0,0,-5,-3,-2,81.4,47,34.4,4,4,0,0
16419,15746,267,243,7,7,7,7,9,6,0,0,19,21,4,2,1,2,1,0,0,0,0,0,673,24,0,0,3,0,-2,2,-1,20.4,7.6,12.8,5,2,3,1
13535,14144,246,278,2,3,3,2,2,2,0,1,16,18,3,2,0,1,1,0,0,1,0,0,-609,-32,-1,1,0,0,-2,1,-1,70.4,16.4,54,4,3,1,0
14888,15746,256,255,4,8,8,4,5,10,0,0,17,20,2,3,0,0,0,1,0,0,0,0,-858,1,-4,4,-5,0,-3,-1,0,27.8,13.8,14,4,3,1,1
15861,15133,306,273,6,4,4,6,2,6,0,0,19,15,2,4,1,1,1,0,0,0,0,0,728,33,2,-2,-4,0,4,-2,0,11.6,20.4,-8.8,4,5,-1,1
12730,16071,221,277,2,6,6,2,3,9,0,1,14,17,4,3,0,0,1,0,0,1,0,0,-3341,-56,-4,4,-6,0,-3,1,0,17.8,26.8,-9,4,3,1,0
16769,13421,247,232,11,2,2,11,6,0,0,0,17,41,2,3,0,0,1,0,0,0,0,0,3348,15,9,-9,6,0,-24,-1,0,40.6,14.6,26,4,5,-1,1
15126,15194,300,289,4,3,3,4,2,3,0,0,36,15,3,6,0,2,1,0,0,0,0,0,-68,11,1,-1,-1,0,21,-3,-2,40,15.4,24.6,4,4,0,0
14209,15676,262,284,3,5,5,3,2,6,0,1,21,19,2,5,0,0,0,1,0,1,0,0,-1467,-22,-2,2,-4,0,2,-3,0,96,75,21,3,5,-2,1
14895,16745,242,256,5,9,9,5,4,12,0,1,16,19,3,4,0,0,1,0,0,1,0,0,-1850,-14,-4,4,-8,0,-3,-1,0,21.4,53,-31.6,3,5,-2,0
15702,15759,243,238,8,7,7,8,10,12,1,0,36,18,2,3,0,0,0,1,1,0,0,0,-57,5,1,-1,-2,0,18,-1,0,7.6,14.6,-7,3,4,-1,0
16162,15867,264,274,6,6,6,6,10,5,0,0,12,48,4,4,1,0,0,1,0,0,0,0,295,-10,0,0,5,0,-36,0,1,64.6,14.4,50.2,3,3,0,1
13853,14264,269,293,2,2,2,3,3,1,0,1,20,20,1,2,0,1,0,1,0,1,0,0,-411,-24,0,-1,2,0,0,-1,-1,14.6,16.4,-1.8,4,4,0,0
15379,15275,277,264,6,5,5,6,4,5,0,0,17,12,0,6,0,0,1,0,0,0,0,0,104,13,1,-1,-1,0,5,-6,0,24,9.2,14.8,4,4,0,0
13978,14351,261,271,3,4,4,3,2,1,0,0,14,44,3,1,0,0,1,0,0,0,0,0,-373,-10,-1,1,1,0,-30,2,0,47.8,12,35.8,4,3,1,0
17093,14044,292,246,9,3,3,9,9,4,0,0,18,104,1,3,1,0,1,0,0,0,0,0,3049,46,6,-6,5,0,-86,-2,1,17.4,17.8,-0.4,3,3,0,1
15820,15478,298,231,5,7,7,5,6,9,0,1,19,15,3,3,2,0,1,0,0,1,0,0,342,67,-2,2,-3,0,4,0,2,10.6,31.8,-21.2,2,4,-2,1
13995,15468,281,246,2,7,7,2,1,6,0,1,15,16,2,2,0,2,0,1,0,1,0,0,-1473,35,-5,5,-5,0,-1,0,-2,76.8,44.4,32.4,4,5,-1,0
15240,15468,275,274,4,5,5,4,6,4,0,1,20,15,2,3,1,2,1,0,0,1,0,0,-228,1,-1,1,2,0,5,-1,-1,10,52.4,-42.4,3,2,1,1
16220,14990,257,240,8,5,5,8,5,7,0,0,102,41,4,0,2,0,1,0,0,0,0,0,1230,17,3,-3,-2,0,61,4,2,7.8,7.6,0.2,2,2,0,1
16676,16305,252,222,8,9,9,9,6,10,0,0,15,38,2,2,1,0,1,0,0,0,0,0,371,30,-1,0,-4,0,-23,0,1,36,102,-66,4,3,1,0
14881,15155,259,266,4,4,4,5,5,5,0,0,29,111,2,5,3,2,0,1,0,0,0,0,-274,-7,0,-1,0,0,-82,-3,1,91.8,14.8,77,4,4,0,0
14965,14732,261,255,5,5,5,5,6,4,0,0,16,16,2,1,0,1,1,0,0,0,0,0,233,6,0,0,2,0,0,1,-1,13.2,19.2,-6,2,3,-1,1
16289,13451,280,264,7,2,2,7,7,1,0,1,29,36,6,7,1,1,0,1,0,1,0,0,2838,16,5,-5,6,0,-7,-1,0,19.8,10.8,9,4,3,1,1
15223,15765,256,281,6,5,5,6,6,9,0,0,15,23,2,0,0,2,0,1,0,0,0,0,-542,-25,1,-1,-3,0,-8,2,-2,13,17,-4,2,4,-2,0
15511,15118,254,281,6,4,4,7,4,4,0,0,14,34,0,5,0,1,1,0,0,0,0,0,393,-27,2,-3,0,0,-20,-5,-1,7.4,22.2,-14.8,2,5,-3,0
13491,18405,230,267,3,12,12,3,1,24,0,0,37,20,3,2,0,1,1,0,0,0,0,0,-4914,-37,-9,9,-23,0,17,1,-1,5.8,45,-39.2,3,2,1,0
14351,14640,243,239,5,5,6,5,2,7,0,1,15,22,1,4,0,0,0,1,0,1,0,0,-289,4,0,1,-5,0,-7,-3,0,31.4,12.6,18.8,5,3,2,1
15543,15359,263,278,6,5,5,6,7,1,0,0,17,18,4,5,0,2,1,0,0,0,0,0,184,-15,1,-1,6,0,-1,-1,-2,64.8,10.4,54.4,2,2,0,0
14106,15154,211,208,5,8,8,5,4,7,0,0,16,14,4,4,0,0,0,1,0,0,0,0,-1048,3,-3,3,-3,0,2,0,0,5.8,8.8,-3,2,4,-2,0
15535,15388,273,277,5,4,4,5,7,5,1,0,14,36,2,3,1,1,1,0,1,0,0,0,147,-4,1,-1,2,0,-22,-1,0,15.2,18.2,-3,3,3,0,0
15102,16084,256,267,5,6,6,5,7,14,0,0,107,16,2,2,1,1,1,0,0,0,0,0,-982,-11,-1,1,-7,0,91,0,0,17.2,39.6,-22.4,3,4,-1,1
13325,14939,251,239,2,6,6,2,2,8,1,0,13,25,3,0,0,0,0,1,1,0,0,0,-1614,12,-4,4,-6,0,-12,3,0,26.6,9.8,16.8,4,2,2,0
13679,17533,248,239,3,13,13,3,2,11,0,0,11,16,1,4,0,2,1,0,0,0,0,0,-3854,9,-10,10,-9,0,-5,-3,-2,6.6,104.2,-97.6,1,4,-3,0
14685,15372,265,244,4,8,8,5,3,9,0,1,22,13,1,8,0,0,0,1,0,1,0,0,-687,21,-4,3,-6,0,9,-7,0,9.6,12.8,-3.2,2,2,0,0
13641,15887,252,270,3,6,6,3,2,6,0,0,16,15,1,1,0,0,1,0,0,0,0,0,-2246,-18,-3,3,-4,0,1,0,0,11.2,21.6,-10.4,1,4,-3,0
13880,15681,267,283,3,6,6,3,0,5,0,1,18,33,2,3,0,1,0,1,0,1,0,0,-1801,-16,-3,3,-5,0,-15,-1,-1,15.8,35.2,-19.4,3,2,1,1
12863,16546,230,268,2,8,8,2,1,8,0,1,34,12,3,5,0,1,0,1,0,1,0,0,-3683,-38,-6,6,-7,0,22,-2,-1,9.4,11.2,-1.8,3,2,1,0
15968,16067,264,255,7,8,8,7,6,5,0,0,16,107,2,5,0,1,1,0,0,0,0,0,-99,9,-1,1,1,0,-91,-3,-1,16.2,16.6,-0.4,4,4,0,1
15499,15484,271,271,4,6,6,4,4,5,0,0,19,17,1,2,1,0,0,1,0,0,0,0,15,0,-2,2,-1,0,2,-1,1,65.8,6,59.8,3,2,1,0
16148,15454,255,286,8,4,4,8,7,4,0,0,16,19,4,0,0,0,1,0,0,0,0,0,694,-31,4,-4,3,0,-3,4,0,21.4,44.4,-23,4,3,1,1
13690,15761,278,281,2,5,5,2,3,6,0,1,23,34,3,7,0,0,1,0,0,1,0,0,-2071,-3,-3,3,-3,0,-11,-4,0,12,14.8,-2.8,3,3,0,0
15209,15708,265,259,5,7,7,5,4,7,0,0,15,13,2,2,1,0,0,1,0,0,0,0,-499,6,-2,2,-3,0,2,0,1,12,10.4,1.6,3,3,0,1
16292,14734,256,229,8,6,6,8,10,6,0,0,17,17,0,3,0,0,1,0,0,0,0,0,1558,27,2,-2,4,0,0,-3,0,23.6,18.2,5.4,3,4,-1,1
12359,14257,250,275,0,3,3,0,0,2,0,0,13,13,1,1,0,0,0,1,0,0,0,0,-1898,-25,-3,3,-2,0,0,0,0,11.2,18.2,-7,3,3,0,0
14875,15209,247,242,4,7,7,4,9,7,0,1,13,15,3,2,1,2,0,1,0,1,0,0,-334,5,-3,3,2,0,-2,1,-1,22.2,24,-1.8,3,4,-1,0
15193,15031,279,254,5,5,5,5,5,5,0,0,17,19,5,5,0,0,1,0,0,0,0,0,162,25,0,0,0,0,-2,0,0,18.4,21.4,-3,4,3,1,0
15958,14025,270,268,8,3,3,8,8,1,1,0,16,16,2,2,0,0,1,0,1,0,0,0,1933,2,5,-5,7,0,0,0,0,36.2,20.2,16,5,3,2,1
16848,13644,280,246,9,2,2,9,8,3,0,0,17,32,2,4,1,0,0,1,0,0,0,0,3204,34,7,-7,5,0,-15,-2,1,14.8,22.4,-7.6,3,3,0,1
12609,14455,252,287,0,2,2,0,0,4,0,0,34,15,1,2,0,1,0,1,0,0,0,0,-1846,-35,-2,2,-4,0,19,-1,-1,9.8,16.8,-7,3,3,0,0
15339,16946,223,226,6,11,11,6,7,12,0,0,15,18,2,3,0,0,1,0,0,0,0,0,-1607,-3,-5,5,-5,0,-3,-1,0,48.6,23.6,25,4,4,0,0
14435,15201,268,283,3,5,5,3,4,5,0,0,14,27,1,2,0,0,1,0,0,0,0,0,-766,-15,-2,2,-1,0,-13,-1,0,32.2,19,13.2,3,2,1,0
16854,14094,298,245,8,3,3,8,5,2,0,0,39,16,2,5,0,0,0,1,0,0,0,0,2760,53,5,-5,3,0,23,-3,0,22.8,19.4,3.4,5,2,3,1
13643,14815,234,242,4,6,6,4,1,6,0,1,14,20,1,1,0,1,1,0,0,1,0,0,-1172,-8,-2,2,-5,0,-6,0,-1,13,7.4,5.6,3,2,1,0
16804,15952,263,233,9,9,9,9,9,6,0,0,102,14,3,2,1,0,1,0,0,0,0,0,852,30,0,0,3,0,88,1,1,55.2,45.6,9.6,5,4,1,1
11095,14488,188,215,2,9,9,2,2,10,1,0,11,14,3,2,0,2,0,1,1,0,0,0,-3393,-27,-7,7,-8,0,-3,1,-2,23.4,10.8,12.6,1,4,-3,0
16184,15236,257,259,8,5,5,8,8,6,1,0,33,17,1,1,1,0,1,0,1,0,0,0,948,-2,3,-3,2,0,16,0,1,36.8,63.2,-26.4,4,4,0,1
18456,14974,258,248,12,5,5,12,16,4,0,0,16,17,4,1,0,0,1,0,0,0,0,0,3482,10,7,-7,12,0,-1,3,0,14.8,102.6,-87.8,3,5,-2,1
13855,13883,226,218,5,6,6,6,5,5,0,0,14,13,2,2,0,0,0,1,0,0,0,0,-28,8,-1,0,0,0,1,0,0,32.6,10,22.6,4,3,1,1
13726,14808,266,273,2,6,6,2,2,3,0,1,15,19,2,2,0,0,0,1,0,1,0,0,-1082,-7,-4,4,-1,0,-4,0,0,63.2,111.2,-48,4,4,0,0
14286,16608,272,266,2,10,10,2,1,8,0,1,128,16,3,2,0,0,0,1,0,1,0,0,-2322,6,-8,8,-7,0,112,1,0,13,52,-39,3,3,0,0
15127,15958,262,266,6,6,6,6,6,9,1,0,14,31,6,2,0,0,1,0,1,0,0,0,-831,-4,0,0,-3,0,-17,4,0,50.4,43.6,6.8,4,4,0,0
14549,15919,275,257,3,7,7,3,3,7,0,1,15,15,2,1,0,2,1,0,0,1,0,0,-1370,18,-4,4,-4,0,0,1,-2,8.8,33,-24.2,4,3,1,1
16703,14406,291,281,8,3,3,8,8,2,0,0,12,13,2,4,1,3,0,1,0,0,0,0,2297,10,5,-5,6,0,-1,-2,-2,61.6,12,49.6,5,4,1,0
16169,14958,235,266,9,5,5,9,12,4,1,0,14,29,2,4,0,0,1,0,1,0,0,0,1211,-31,4,-4,8,0,-15,-2,0,82.4,7.4,75,4,2,2,0
15768,14970,233,236,7,5,5,7,8,5,0,1,39,15,4,4,0,1,0,1,0,1,0,0,798,-3,2,-2,3,0,24,0,-1,22.2,52,-29.8,3,5,-2,0
18462,18701,228,249,13,12,12,13,16,14,0,0,18,14,0,1,0,0,1,0,0,0,0,0,-239,-21,1,-1,2,0,4,-1,0,46,48.8,-2.8,2,3,-1,0
16028,15992,240,267,8,7,7,8,11,4,0,1,15,218,2,1,2,0,0,1,0,1,0,0,36,-27,1,-1,7,0,-203,1,2,66,12.6,53.4,3,3,0,1
14953,14318,238,253,5,4,4,5,6,3,0,0,17,17,4,0,0,1,1,0,0,0,0,0,635,-15,1,-1,3,0,0,4,-1,22.8,20.6,2.2,4,4,0,0
14960,19925,245,248,6,14,14,6,7,23,0,1,17,14,0,3,1,3,1,0,0,1,0,0,-4965,-3,-8,8,-16,0,3,-3,-2,36.2,25.8,10.4,3,4,-1,0
13497,14628,223,242,4,4,4,4,4,4,0,0,12,14,3,1,0,2,1,0,0,0,0,0,-1131,-19,0,0,0,0,-2,2,-2,13.8,38.8,-25,3,2,1,0
14426,15643,273,298,3,5,5,3,3,6,0,0,10,18,2,2,1,0,1,0,0,0,0,0,-1217,-25,-2,2,-3,0,-8,0,1,21,52,-31,3,4,-1,0
16923,14705,272,255,9,4,4,9,23,8,1,0,17,17,4,2,1,1,0,1,1,0,0,0,2218,17,5,-5,15,0,0,2,0,9,20.4,-11.4,2,5,-3,1
15754,15809,295,266,4,6,6,4,8,6,0,0,17,18,0,1,2,1,1,0,0,0,0,0,-55,29,-2,2,2,0,-1,-1,1,73,39.4,33.6,5,3,2,1
17538,14411,281,272,9,3,3,9,14,2,0,0,18,12,0,2,1,2,0,1,0,0,0,0,3127,9,6,-6,12,0,6,-2,-1,19.4,29.8,-10.4,2,3,-1,0
16286,16355,254,234,8,8,8,8,9,11,1,0,16,32,5,3,0,1,1,0,1,0,0,0,-69,20,0,0,-2,0,-16,2,-1,57.8,9.4,48.4,4,2,2,0
14675,17144,258,244,3,12,12,3,2,13,0,0,9,13,1,1,0,0,0,1,0,0,0,0,-2469,14,-9,9,-11,0,-4,0,0,29.8,20.2,9.6,4,4,0,0
13309,13834,268,246,1,2,2,1,1,4,0,1,15,100,4,4,0,0,0,1,0,1,0,0,-525,22,-1,1,-3,0,-85,0,0,11.4,52.6,-41.2,3,3,0,0
14535,14141,258,223,5,5,5,5,4,2,0,0,182,14,2,2,0,0,1,0,0,0,0,0,394,35,0,0,2,0,168,0,0,54.4,20.6,33.8,4,3,1,0
14660,13478,215,267,7,1,1,7,7,0,0,0,17,39,3,1,0,0,1,0,0,0,0,0,1182,-52,6,-6,7,0,-22,2,0,32.2,25.4,6.8,2,4,-2,1
15363,16733,261,258,6,9,9,7,3,15,0,0,15,17,5,3,0,2,1,0,0,0,0,0,-1370,3,-3,2,-12,0,-2,2,-2,39.2,44.8,-5.6,2,4,-2,1
14489,14622,236,248,5,6,6,5,3,3,0,1,33,14,4,1,1,0,0,1,0,1,0,0,-133,-12,-1,1,0,0,19,3,1,7.6,29.8,-22.2,2,3,-1,0
15324,15356,286,264,4,5,6,4,3,5,0,0,17,17,3,2,2,1,1,0,0,0,0,0,-32,22,-1,2,-2,0,0,1,1,43.4,25.8,17.6,4,5,-1,0
15869,14784,274,240,5,5,5,5,10,5,0,0,13,14,2,4,1,2,1,0,0,0,0,0,1085,34,0,0,5,0,-1,-2,-1,18.6,14,4.6,4,3,1,1
14215,14410,278,260,3,4,4,3,1,1,0,0,17,16,2,3,0,2,1,0,0,0,0,0,-195,18,-1,1,0,0,1,-1,-2,16,15.2,0.8,5,3,2,1
15129,14664,267,248,5,5,5,5,3,5,1,0,12,12,1,5,1,1,0,1,1,0,0,0,465,19,0,0,-2,0,0,-4,0,34.4,25.2,9.2,4,3,1,1
14555,14441,290,282,2,3,3,2,2,2,0,1,17,18,3,3,2,0,1,0,0,1,0,0,114,8,-1,1,0,0,-1,0,2,6.4,11.6,-5.2,2,4,-2,1
14933,15327,238,243,5,7,7,5,3,5,0,1,17,65,4,7,0,2,0,1,0,1,0,0,-394,-5,-2,2,-2,0,-48,-3,-2,14.6,24.6,-10,4,5,-1,0
14209,14288,220,262,4,3,3,4,3,2,0,0,111,18,0,1,0,1,1,0,0,0,0,0,-79,-42,1,-1,1,0,93,-1,-1,18.4,33,-14.6,3,3,0,1
14402,15931,276,298,2,5,5,2,4,5,1,0,17,34,3,4,1,0,0,1,1,0,0,0,-1529,-22,-3,3,-1,0,-17,-1,1,13.6,141.4,-127.8,3,5,-2,1
16001,13459,272,264,6,2,2,6,5,1,0,1,16,13,5,4,0,0,1,0,0,1,0,0,2542,8,4,-4,4,0,3,1,0,30,28.4,1.6,3,4,-1,1
13559,15210,247,257,2,5,5,2,2,6,1,0,16,15,4,4,0,2,0,1,1,0,0,0,-1651,-10,-3,3,-4,0,1,0,-2,21.4,22,-0.6,5,4,1,0
14651,16091,244,244,6,6,6,7,7,8,0,0,26,18,4,3,0,1,0,1,0,0,0,0,-1440,0,0,-1,-1,0,8,1,-1,14,109.2,-95.2,5,4,1,1
16218,14634,276,223,7,5,5,7,7,7,0,0,17,50,9,3,0,0,1,0,0,0,0,0,1584,53,2,-2,0,0,-33,6,0,33,17.8,15.2,4,4,0,1
16946,17612,229,234,12,12,12,12,9,11,0,0,30,18,1,3,1,3,1,0,0,0,0,0,-666,-5,0,0,-2,0,12,-2,-2,48,27.2,20.8,3,4,-1,0
15249,16044,252,254,5,8,8,6,4,8,0,0,19,13,0,3,0,1,0,1,0,0,0,0,-795,-2,-3,2,-4,0,6,-3,-1,80.6,94.6,-14,4,5,-1,1
15039,13457,254,265,6,1,1,6,5,1,0,0,15,16,5,4,0,0,1,0,0,0,0,0,1582,-11,5,-5,4,0,-1,1,0,64.6,13.4,51.2,5,2,3,1
14612,14835,278,245,3,6,6,3,3,5,1,0,15,15,2,3,2,0,1,0,1,0,0,0,-223,33,-3,3,-2,0,0,-1,2,26.6,18.8,7.8,4,3,1,0
13771,14800,249,248,3,6,6,3,1,6,0,0,34,27,5,2,2,0,0,1,0,0,0,0,-1029,1,-3,3,-5,0,7,3,2,12.8,48.8,-36,1,3,-2,0
15484,15189,249,269,6,5,5,6,9,7,0,1,15,38,4,4,0,0,0,1,0,1,0,0,295,-20,1,-1,2,0,-23,0,0,45,19.4,25.6,5,4,1,1
17291,16360,258,237,10,11,11,10,10,5,0,0,12,18,3,2,1,0,0,1,0,0,0,0,931,21,-1,1,5,0,-6,1,1,110.4,44.6,65.8,2,1,1,0
13802,15277,272,297,2,4,4,2,1,2,0,0,36,25,7,2,1,1,0,1,0,0,0,0,-1475,-25,-2,2,-1,0,11,5,0,44.6,14.6,30,5,2,3,0
13672,17250,240,253,3,12,12,3,2,12,0,1,14,15,1,2,0,0,1,0,0,1,0,0,-3578,-13,-9,9,-10,0,-1,-1,0,114.6,27.8,86.8,4,4,0,0
18230,16208,271,262,11,8,8,11,15,8,0,0,15,15,1,3,0,1,0,1,0,0,0,0,2022,9,3,-3,7,0,0,-2,-1,38.2,49.8,-11.6,3,5,-2,1
14528,16991,270,282,3,8,8,3,3,10,0,0,14,118,3,3,1,1,0,1,0,0,0,0,-2463,-12,-5,5,-7,0,-104,0,0,39.8,83.4,-43.6,5,5,0,0
14916,15135,263,266,5,6,6,5,4,1,0,1,18,18,4,3,0,1,0,1,0,1,0,0,-219,-3,-1,1,3,0,0,1,-1,11.4,13.6,-2.2,2,4,-2,1
15460,16461,286,255,6,10,10,6,3,8,0,0,14,16,4,2,0,0,0,1,0,0,0,0,-1001,31,-4,4,-5,0,-2,2,0,18.2,23.2,-5,4,2,2,0
15353,14160,258,259,6,2,2,6,7,3,1,0,122,14,5,3,3,2,0,1,1,0,0,0,1193,-1,4,-4,4,0,108,2,1,11.8,108,-96.2,3,4,-1,1
14820,15235,281,284,4,4,5,4,8,7,0,1,20,21,1,4,0,0,0,1,0,1,0,0,-415,-3,0,1,1,0,-1,-3,0,29,14.2,14.8,5,3,2,0
15408,13391,293,280,4,1,1,4,4,0,0,0,21,18,5,6,1,0,0,1,0,0,0,0,2017,13,3,-3,4,0,3,-1,1,16,12,4,4,3,1,1
15365,17195,231,236,6,9,9,6,6,15,0,0,17,14,1,2,2,1,0,1,0,0,0,0,-1830,-5,-3,3,-9,0,3,-1,1,31.8,21.6,10.2,3,3,0,0
18520,14519,275,232,13,5,5,13,6,6,0,0,14,30,4,1,4,0,1,0,0,0,0,0,4001,43,8,-8,0,0,-16,3,4,40.6,22.6,18,3,2,1,1
15956,15456,301,267,5,5,5,5,5,7,0,0,107,16,3,2,0,0,1,0,0,0,0,0,500,34,0,0,-2,0,91,1,0,51,16.2,34.8,3,3,0,1
15786,15021,248,256,7,4,4,7,9,4,0,0,13,13,2,1,1,0,1,0,0,0,0,0,765,-8,3,-3,5,0,0,1,1,18.2,9,9.2,3,3,0,0
18009,15430,257,232,13,6,6,13,13,4,0,0,17,13,0,1,0,0,1,0,0,0,0,0,2579,25,7,-7,9,0,4,-1,0,27.4,13.8,13.6,4,2,2,1
16493,15342,219,259,9,6,6,9,12,8,0,0,15,12,2,2,2,0,0,1,0,0,0,0,1151,-40,3,-3,4,0,3,0,2,13.4,49,-35.6,2,5,-3,0
13983,14063,246,266,3,3,3,3,5,4,0,1,14,16,5,2,0,0,0,1,0,1,0,0,-80,-20,0,0,1,0,-2,3,0,11,120.6,-109.6,5,4,1,1
17220,17427,251,258,10,9,9,10,12,12,0,1,16,15,3,3,1,1,0,1,0,1,0,0,-207,-7,1,-1,0,0,1,0,0,13.8,8.2,5.6,3,3,0,0
16017,16739,287,273,6,8,8,6,7,9,0,0,17,13,1,6,0,0,1,0,0,0,0,0,-722,14,-2,2,-2,0,4,-5,0,21.8,78.4,-56.6,4,5,-1,1
14124,16861,251,274,2,7,7,2,3,9,0,1,18,16,2,3,1,2,1,0,0,1,0,0,-2737,-23,-5,5,-6,0,2,-1,-1,35.4,7.2,28.2,3,4,-1,0
17462,17617,230,237,14,8,8,14,11,15,0,0,16,14,1,3,0,1,1,0,0,0,0,0,-155,-7,6,-6,-4,0,2,-2,-1,90,14.6,75.4,2,4,-2,0
15155,15613,271,252,4,8,8,4,6,11,0,1,12,43,5,4,1,0,0,1,0,1,0,0,-458,19,-4,4,-5,0,-31,1,1,16,21.2,-5.2,3,4,-1,0
12628,16060,255,271,0,7,7,0,0,8,0,1,17,23,0,3,0,1,0,1,0,1,0,0,-3432,-16,-7,7,-8,0,-6,-3,-1,8.2,14,-5.8,3,4,-1,0
15045,15513,298,246,3,6,6,4,4,8,0,0,14,17,3,3,1,0,0,1,0,0,0,0,-468,52,-3,2,-4,0,-3,0,1,11,19.2,-8.2,2,3,-1,0
16867,15598,289,295,8,4,4,8,9,6,0,0,17,31,3,4,0,0,1,0,0,0,0,0,1269,-6,4,-4,3,0,-14,-1,0,17.2,40.6,-23.4,4,4,0,1
16033,16872,279,260,6,9,10,6,4,9,0,0,12,10,1,2,0,1,1,0,0,0,0,0,-839,19,-3,4,-5,0,2,-1,-1,19.6,24.2,-4.6,4,2,2,1
13698,15014,241,283,3,4,4,3,2,2,0,0,14,14,3,6,0,2,0,1,0,0,0,0,-1316,-42,-1,1,0,0,0,-3,-2,45.2,10.6,34.6,2,2,0,1
16920,15651,297,273,8,5,5,8,8,9,0,0,19,12,2,4,0,1,0,1,0,0,0,0,1269,24,3,-3,-1,0,7,-2,-1,17.6,15.8,1.8,3,3,0,0
14978,15277,264,277,5,5,5,5,8,9,0,0,16,14,2,4,0,3,0,1,0,0,0,0,-299,-13,0,0,-1,0,2,-2,-3,12.4,65.4,-53,2,3,-1,0
14019,14913,239,270,4,4,4,4,2,2,0,0,115,11,1,4,0,1,1,0,0,0,0,0,-894,-31,0,0,0,0,104,-3,-1,69.8,17.6,52.2,3,5,-2,0
13224,15604,244,242,2,8,8,2,2,10,0,1,13,15,4,2,0,1,0,1,0,1,0,0,-2380,2,-6,6,-8,0,-2,2,-1,17.2,22.4,-5.2,3,4,-1,0
15896,15510,253,239,8,7,7,8,9,6,0,0,39,13,1,6,0,0,0,1,0,0,0,0,386,14,1,-1,3,0,26,-5,0,105,34.6,70.4,3,4,-1,0
15567,13650,309,236,5,3,3,5,3,3,0,0,34,15,2,3,0,0,1,0,0,0,0,0,1917,73,2,-2,0,0,19,-1,0,48.4,21.8,26.6,2,5,-3,1
15880,15117,252,290,7,4,4,8,6,9,0,1,35,17,3,1,0,0,0,1,0,1,0,0,763,-38,3,-4,-3,0,18,2,0,25.8,24,1.8,4,4,0,1
15004,15492,282,286,4,5,6,4,7,4,1,0,15,15,1,3,1,1,1,0,1,0,0,0,-488,-4,-1,2,3,0,0,-2,0,33,27.6,5.4,5,4,1,1
15892,13460,280,240,6,2,2,6,11,0,0,0,13,60,2,1,3,1,0,1,0,0,0,0,2432,40,4,-4,11,0,-47,1,2,5.2,62.2,-57,1,5,-4,0
15103,14944,263,263,5,5,5,5,7,5,1,0,16,17,9,5,0,0,1,0,1,0,0,0,159,0,0,0,2,0,-1,4,0,18,45.2,-27.2,3,5,-2,0
16345,16787,265,274,6,9,9,6,7,11,0,0,20,21,1,6,2,0,0,1,0,0,0,0,-442,-9,-3,3,-4,0,-1,-5,2,6.2,18.4,-12.2,1,3,-2,0
14092,17514,252,263,3,11,11,3,5,14,1,0,38,14,3,2,0,0,1,0,1,0,0,0,-3422,-11,-8,8,-9,0,24,1,0,30.8,46.4,-15.6,5,4,1,0
15625,14615,323,281,3,3,3,3,5,4,0,0,15,22,4,3,2,0,0,1,0,0,0,0,1010,42,0,0,1,0,-7,1,2,17.4,83.4,-66,4,3,1,1
15669,16908,256,295,6,8,8,6,7,9,0,1,14,19,1,4,0,3,0,1,0,1,0,0,-1239,-39,-2,2,-2,0,-5,-3,-3,30.8,20,10.8,5,4,1,0
15363,18781,287,265,4,13,13,5,4,12,0,0,39,35,1,4,0,1,0,1,0,0,0,0,-3418,22,-9,8,-8,0,4,-3,-1,65.2,48.6,16.6,4,4,0,0
14817,14066,272,242,4,4,4,5,3,3,0,1,12,12,1,5,0,0,0,1,0,1,0,0,751,30,0,-1,0,0,0,-4,0,12.8,8.4,4.4,2,3,-1,0
13798,14487,259,279,2,3,3,2,2,6,0,1,39,20,4,4,0,0,1,0,0,1,0,0,-689,-20,-1,1,-4,0,19,0,0,26.8,75.4,-48.6,4,4,0,0
14729,13083,258,259,5,1,1,5,7,1,0,1,13,15,2,1,0,0,0,1,0,1,0,0,1646,-1,4,-4,6,0,-2,1,0,28.4,16.4,12,5,4,1,1
13496,17806,245,265,2,12,12,2,3,13,0,1,13,13,0,2,0,0,0,1,0,1,0,0,-4310,-20,-10,10,-10,0,0,-2,0,22.6,49.2,-26.6,4,5,-1,0
15752,17789,225,258,8,12,12,8,9,15,0,0,11,32,4,2,0,1,1,0,0,0,0,0,-2037,-33,-4,4,-6,0,-21,2,-1,37.4,25,12.4,5,4,1,0
14477,15055,277,270,2,4,4,2,2,6,0,0,17,16,3,0,1,1,0,1,0,0,0,0,-578,7,-2,2,-4,0,1,3,0,20,32.4,-12.4,4,5,-1,1
13794,16077,260,292,2,6,6,2,2,4,0,0,36,14,0,4,0,1,0,1,0,0,0,0,-2283,-32,-4,4,-2,0,22,-4,-1,28.6,27.6,1,3,5,-2,0
15508,15112,257,275,7,5,5,7,8,5,0,0,14,35,6,4,1,0,0,1,0,0,0,0,396,-18,2,-2,3,0,-21,2,1,29.8,18.8,11,3,3,0,1
16533,14391,248,237,8,5,5,8,10,3,0,0,145,219,3,2,1,0,0,1,0,0,0,0,2142,11,3,-3,7,0,-74,1,1,58,33.8,24.2,4,5,-1,1
15879,16747,292,264,5,9,9,6,7,15,0,1,16,16,3,3,0,0,0,1,0,1,0,0,-868,28,-4,3,-8,0,0,0,0,91.8,41,50.8,4,4,0,0
15200,16484,237,292,6,7,7,6,7,6,1,0,12,13,1,3,2,1,0,1,1,0,0,0,-1284,-55,-1,1,1,0,-1,-2,1,34,17.2,16.8,4,4,0,0
15502,15299,260,263,6,6,6,7,9,4,0,0,17,17,3,1,0,0,1,0,0,0,0,0,203,-3,0,-1,5,0,0,2,0,42.8,17,25.8,4,3,1,0
15709,14976,277,284,5,3,3,5,5,3,0,0,24,13,2,3,2,1,1,0,0,0,0,0,733,-7,2,-2,2,0,11,-1,1,27.8,11.2,16.6,4,3,1,0
12362,18077,246,282,0,11,11,0,0,14,0,0,26,61,2,1,1,0,0,1,0,0,0,0,-5715,-36,-11,11,-14,0,-35,1,1,102,16,86,4,4,0,0
14681,13725,287,277,3,1,1,3,2,1,1,0,15,14,5,2,0,0,1,0,1,0,0,0,956,10,2,-2,1,0,1,3,0,25.6,12.4,13.2,3,4,-1,1
16215,14570,273,248,7,6,8,8,6,3,0,1,14,12,6,2,1,1,0,1,0,1,0,0,1645,25,1,0,3,0,2,4,0,17.4,42.2,-24.8,3,4,-1,0
15348,16562,255,263,6,7,7,6,4,6,0,0,36,18,4,0,0,4,1,0,0,0,0,0,-1214,-8,-1,1,-2,0,18,4,-4,11.6,28.8,-17.2,4,4,0,0
17130,17615,244,263,9,10,10,9,16,12,0,0,14,11,1,4,0,0,0,1,0,0,0,0,-485,-19,-1,1,4,0,3,-3,0,47.6,94.8,-47.2,4,5,-1,0
14988,14599,252,261,5,4,4,5,4,6,0,1,11,15,3,4,1,1,1,0,0,1,0,0,389,-9,1,-1,-2,0,-4,-1,0,37.2,12.6,24.6,3,2,1,0
14328,14451,269,245,3,6,7,3,0,5,0,0,19,15,3,4,0,0,0,1,0,0,0,0,-123,24,-3,4,-5,0,4,-1,0,79.4,59.2,20.2,4,4,0,0
17958,15480,265,231,10,7,7,10,16,11,1,0,25,16,6,5,3,0,1,0,1,0,0,0,2478,34,3,-3,5,0,9,1,3,39.8,36.8,3,3,5,-2,1
17324,14736,275,234,9,5,5,9,12,3,0,1,17,15,3,2,1,0,1,0,0,1,0,0,2588,41,4,-4,9,0,2,1,1,27.2,25.4,1.8,3,4,-1,1
15041,16068,234,244,8,9,9,8,14,15,0,0,19,34,4,3,2,0,0,1,0,0,0,0,-1027,-10,-1,1,-1,0,-15,1,2,34.4,11,23.4,4,4,0,0
15961,14644,288,270,6,5,5,6,6,2,0,1,14,25,2,1,0,0,0,1,0,1,0,0,1317,18,1,-1,4,0,-11,1,0,193.4,27.8,165.6,4,4,0,1
16315,16020,283,280,6,7,7,6,5,8,0,0,16,17,3,1,2,2,0,1,0,0,0,0,295,3,-1,1,-3,0,-1,2,0,21.2,37.6,-16.4,5,5,0,1
16460,14656,257,264,9,4,4,9,11,3,0,1,15,16,0,3,0,2,1,0,0,1,0,0,1804,-7,5,-5,8,0,-1,-3,-2,27,14.4,12.6,2,3,-1,1
16622,15395,238,254,10,5,6,10,13,4,0,0,19,14,1,4,1,1,0,1,0,0,0,0,1227,-16,5,-4,9,0,5,-3,0,10.8,26,-15.2,3,5,-2,1
14882,14331,261,263,5,4,4,5,1,2,0,1,16,13,3,4,1,0,1,0,0,1,0,0,551,-2,1,-1,-1,0,3,-1,1,39.6,32.6,7,3,4,-1,1
14075,16051,281,240,2,8,8,2,1,9,0,0,13,14,3,2,2,0,1,0,0,0,0,0,-1976,41,-6,6,-8,0,-1,1,2,14,5.6,8.4,3,2,1,1
13658,15523,247,281,2,6,6,2,4,5,0,0,15,24,1,3,0,0,0,1,0,0,0,0,-1865,-34,-4,4,-1,0,-9,-2,0,130.4,11.2,119.2,5,3,2,0
13790,15141,271,293,2,5,5,2,2,3,0,0,15,16,3,4,1,0,0,1,0,0,0,0,-1351,-22,-3,3,-1,0,-1,-1,1,27.8,19,8.8,3,4,-1,1
14092,14510,280,265,2,4,4,2,0,5,0,0,26,32,2,2,2,0,0,1,0,0,0,0,-418,15,-2,2,-5,0,-6,0,2,11.6,31.8,-20.2,3,3,0,1
17268,15728,292,238,9,7,7,9,8,5,1,0,15,15,1,4,2,0,1,0,1,0,0,0,1540,54,2,-2,3,0,0,-3,2,13.8,6.8,7,3,1,2,1
16051,15691,247,249,9,6,6,9,6,5,0,0,16,38,3,2,1,1,1,0,0,0,0,0,360,-2,3,-3,1,0,-22,1,0,15.4,5.2,10.2,3,1,2,1
15994,14605,281,223,7,6,6,7,3,8,0,0,19,24,3,0,1,0,1,0,0,0,0,0,1389,58,1,-1,-5,0,-5,3,1,18.4,41.6,-23.2,2,4,-2,1
16601,14197,300,305,6,1,1,6,5,0,0,0,14,16,3,2,1,1,1,0,0,0,0,0,2404,-5,5,-5,5,0,-2,1,0,47.6,32.4,15.2,5,5,0,1
12592,16186,241,273,1,6,6,1,0,8,0,0,12,17,2,0,0,0,0,1,0,0,0,0,-3594,-32,-5,5,-8,0,-5,2,0,7.4,10,-2.6,1,3,-2,0
15071,12892,273,267,4,0,0,4,6,0,0,1,20,17,2,4,0,0,1,0,0,1,0,0,2179,6,4,-4,6,0,3,-2,0,61.6,19.8,41.8,4,3,1,1
15457,15745,223,258,9,8,8,9,10,4,0,1,31,14,2,0,2,2,0,1,0,1,0,0,-288,-35,1,-1,6,0,17,2,0,41.4,9.6,31.8,2,4,-2,0
15664,14379,272,275,6,4,4,6,8,2,0,1,19,35,4,3,0,0,1,0,0,1,0,0,1285,-3,2,-2,6,0,-16,1,0,29.4,51.4,-22,5,4,1,1
14037,17188,255,270,3,9,9,3,2,13,1,0,15,20,3,4,1,0,0,1,1,0,0,0,-3151,-15,-6,6,-11,0,-5,-1,1,28.6,15.8,12.8,4,3,1,0
16361,16764,232,262,9,8,8,9,16,9,0,0,18,14,1,2,1,2,0,1,0,0,0,0,-403,-30,1,-1,7,0,4,-1,-1,20.8,33.2,-12.4,3,3,0,0
14816,13690,284,286,3,1,1,3,4,0,0,0,18,13,2,3,0,1,0,1,0,0,0,0,1126,-2,2,-2,4,0,5,-1,-1,10.2,34.2,-24,2,4,-2,0
15059,16349,267,252,4,9,9,4,4,6,0,1,14,16,4,4,1,1,0,1,0,1,0,0,-1290,15,-5,5,-2,0,-2,0,0,46.6,33.6,13,4,5,-1,0
14664,15214,221,252,6,6,6,7,3,4,0,0,16,33,0,1,0,0,0,1,0,0,0,0,-550,-31,0,-1,-1,0,-17,-1,0,19.4,33.4,-14,3,4,-1,0
15715,14808,279,272,5,4,4,5,7,4,0,0,24,16,4,2,0,0,1,0,0,0,0,0,907,7,1,-1,3,0,8,2,0,23,20.2,2.8,5,5,0,0
15125,16861,268,261,4,9,9,4,4,11,0,0,17,24,3,3,0,1,0,1,0,0,0,0,-1736,7,-5,5,-7,0,-7,0,-1,58.8,91,-32.2,4,5,-1,0
15817,14239,272,247,6,3,3,6,10,5,0,0,16,13,2,3,1,1,1,0,0,0,0,0,1578,25,3,-3,5,0,3,-1,0,18,15,3,3,3,0,1
13460,16568,233,278,3,8,8,3,2,5,0,0,15,26,4,3,0,0,0,1,0,0,0,0,-3108,-45,-5,5,-3,0,-11,1,0,11.6,24.2,-12.6,4,3,1,0
14024,17317,281,275,1,11,11,1,0,9,0,0,117,38,3,4,0,1,0,1,0,0,0,0,-3293,6,-10,10,-9,0,79,-1,-1,33,24.4,8.6,4,4,0,1
14761,15416,259,258,5,6,6,5,6,4,0,0,15,16,1,2,0,0,1,0,0,0,0,0,-655,1,-1,1,2,0,-1,-1,0,31,61.6,-30.6,4,4,0,0
13706,17034,264,283,2,9,9,2,2,12,0,0,14,18,6,3,0,1,0,1,0,0,0,0,-3328,-19,-7,7,-10,0,-4,3,-1,54.6,51.4,3.2,4,4,0,0
17849,14937,268,237,12,5,5,12,10,7,1,0,14,15,1,3,1,0,1,0,1,0,0,0,2912,31,7,-7,3,0,-1,-2,1,10.4,35,-24.6,3,3,0,1
14797,16284,263,282,4,7,7,4,6,8,0,0,17,39,8,2,0,0,0,1,0,0,0,0,-1487,-19,-3,3,-2,0,-22,6,0,33.2,26.6,6.6,4,5,-1,0
14114,14039,251,267,4,2,2,4,6,2,0,0,13,17,5,3,0,0,1,0,0,0,0,0,75,-16,2,-2,4,0,-4,2,0,8.4,41.8,-33.4,2,5,-3,1
14571,15839,248,300,6,5,5,6,6,3,1,0,16,35,0,3,0,0,0,1,1,0,0,0,-1268,-52,1,-1,3,0,-19,-3,0,71.6,22.4,49.2,5,4,1,0
15038,16845,276,299,4,8,8,4,5,6,0,0,18,17,1,5,1,0,0,1,0,0,0,0,-1807,-23,-4,4,-1,0,1,-4,1,29.8,11.2,18.6,3,3,0,1
14626,14150,266,257,4,4,4,4,1,2,0,0,18,12,2,5,1,1,0,1,0,0,0,0,476,9,0,0,-1,0,6,-3,0,51.4,51.6,-0.2,4,5,-1,0
17908,15560,242,268,13,7,7,13,17,2,1,0,17,16,2,4,0,1,1,0,1,0,0,0,2348,-26,6,-6,15,0,1,-2,-1,16,56.6,-40.6,4,4,0,1
15229,16943,248,266,6,10,10,6,7,13,0,1,11,17,1,3,0,1,0,1,0,1,0,0,-1714,-18,-4,4,-6,0,-6,-2,-1,18,19.2,-1.2,3,4,-1,1
16795,14571,258,257,9,4,4,9,9,6,0,0,14,39,4,3,0,1,1,0,0,0,0,0,2224,1,5,-5,3,0,-25,1,-1,21.4,71.6,-50.2,5,4,1,1
16647,15180,252,277,8,5,5,8,10,3,0,0,14,17,2,2,1,0,0,1,0,0,0,0,1467,-25,3,-3,7,0,-3,0,1,37.8,21.8,16,4,4,0,1
17432,15183,256,254,10,6,6,10,15,8,0,0,15,16,3,2,0,0,1,0,0,0,0,0,2249,2,4,-4,7,0,-1,1,0,16.6,49.4,-32.8,4,5,-1,0
14402,15269,279,293,2,3,3,2,3,5,0,0,12,37,1,1,0,0,1,0,0,0,0,0,-867,-14,-1,1,-2,0,-25,0,0,14,12.2,1.8,3,2,1,1
14549,15722,289,249,2,8,8,2,1,14,0,1,13,44,0,0,3,0,0,1,0,1,0,0,-1173,40,-6,6,-13,0,-31,0,3,12.2,117.6,-105.4,3,4,-1,0
15950,14696,276,275,6,2,2,6,8,3,0,1,74,19,5,3,1,0,1,0,0,1,0,0,1254,1,4,-4,5,0,55,2,1,33.2,42.6,-9.4,3,4,-1,1
15675,13961,279,248,6,3,3,6,5,2,0,0,20,36,2,2,0,0,1,0,0,0,0,0,1714,31,3,-3,3,0,-16,0,0,75.2,11.4,63.8,5,2,3,1
15445,13637,257,265,7,2,2,7,4,3,0,0,15,14,3,3,0,0,0,1,0,0,0,0,1808,-8,5,-5,1,0,1,0,0,25.2,13.6,11.6,2,3,-1,0
5560,6268,52,95,1,1,1,1,1,1,0,0,7,17,0,0,0,0,0,1,0,0,0,0,-708,-43,0,0,0,0,-10,0,0,26,11.6,14.4,2,3,-1,0
15089,16150,254,263,5,9,9,5,5,9,0,0,15,107,1,0,1,0,0,1,0,0,0,0,-1061,-9,-4,4,-4,0,-92,1,1,22.4,17.2,5.2,5,3,2,0
15821,14457,303,260,5,4,4,5,5,4,0,0,16,16,4,3,0,0,0,1,0,0,0,0,1364,43,1,-1,1,0,0,1,0,19.4,38.2,-18.8,4,4,0,1
15079,14337,234,281,6,3,3,6,9,1,0,1,16,37,8,3,0,1,1,0,0,1,0,0,742,-47,3,-3,8,0,-21,5,-1,41.4,8.6,32.8,2,2,0,0
15782,14365,283,273,6,3,3,6,7,5,0,0,15,15,4,4,1,0,0,1,0,0,0,0,1417,10,3,-3,2,0,0,0,1,23.4,64.2,-40.8,4,5,-1,1
14811,14895,286,281,3,4,4,3,3,3,0,1,23,17,3,3,0,3,0,1,0,1,0,0,-84,5,-1,1,0,0,6,0,-3,26.4,47.2,-20.8,5,2,3,1
15160,14768,287,274,3,3,3,3,3,3,0,1,19,13,2,4,0,1,0,1,0,1,0,0,392,13,0,0,0,0,6,-2,-1,50.6,25.6,25,4,4,0,1
15183,16199,261,285,6,7,7,6,4,6,1,0,11,16,3,2,0,0,0,1,1,0,0,0,-1016,-24,-1,1,-2,0,-5,1,0,43.4,57,-13.6,4,5,-1,0
16455,15604,278,280,8,4,4,8,9,7,0,0,17,13,1,3,0,0,1,0,0,0,0,0,851,-2,4,-4,2,0,4,-2,0,37.2,68,-30.8,4,4,0,1
15189,14967,248,246,6,6,7,6,6,4,0,0,14,20,4,3,0,0,0,1,0,0,0,0,222,2,0,1,2,0,-6,1,0,44.6,24,20.6,4,4,0,1
17858,14266,249,229,12,5,5,12,18,6,0,0,16,20,3,3,1,0,1,0,0,0,0,0,3592,20,7,-7,12,0,-4,0,1,27.6,48,-20.4,5,4,1,1
16075,15635,293,271,6,5,5,6,8,5,0,0,16,17,6,3,0,2,0,1,0,0,0,0,440,22,1,-1,3,0,-1,3,-2,27.6,79.6,-52,5,5,0,1
14691,14040,299,253,2,3,3,2,1,1,0,0,16,18,2,1,1,0,0,1,0,0,0,0,651,46,-1,1,0,0,-2,1,1,17.4,55.8,-38.4,3,3,0,0
15242,13126,304,256,3,1,1,3,5,2,0,0,22,35,1,5,1,0,0,1,0,0,0,0,2116,48,2,-2,3,0,-13,-4,1,11,9.6,1.4,3,3,0,0
14501,15996,249,285,4,5,5,4,5,4,0,0,12,19,7,3,0,4,1,0,0,0,0,0,-1495,-36,-1,1,1,0,-7,4,-4,33,11.8,21.2,4,3,1,0
14650,15144,254,247,5,5,5,5,3,6,0,0,15,15,5,5,1,0,0,1,0,0,0,0,-494,7,0,0,-3,0,0,0,1,12.6,23.2,-10.6,3,3,0,1
14933,13187,301,280,3,0,0,3,3,0,0,0,18,38,6,4,0,0,1,0,0,0,0,0,1746,21,3,-3,3,0,-20,2,0,11.2,45,-33.8,3,3,0,1
16329,14024,279,289,6,2,2,6,6,2,0,0,18,21,4,0,2,0,1,0,0,0,0,0,2305,-10,4,-4,4,0,-3,4,2,9.4,6.2,3.2,3,1,2,1
13969,16207,258,295,3,7,7,3,1,4,0,1,13,106,5,3,0,0,0,1,0,1,0,0,-2238,-37,-4,4,-3,0,-93,2,0,5.4,24.8,-19.4,3,4,-1,0
15206,13528,306,298,4,0,0,4,6,0,1,0,21,34,4,8,0,0,1,0,1,0,0,0,1678,8,4,-4,6,0,-13,-4,0,22.2,10.8,11.4,4,3,1,1
15044,14790,257,252,5,5,5,5,4,4,0,1,107,13,3,0,2,0,1,0,0,1,0,0,254,5,0,0,0,0,94,3,2,37.6,12.2,25.4,3,3,0,0
16254,14242,259,223,9,4,4,9,6,8,1,0,17,130,3,4,1,0,1,0,1,0,0,0,2012,36,5,-5,-2,0,-113,-1,1,17.6,15.4,2.2,5,3,2,1
16668,15106,261,275,9,4,4,9,7,4,0,0,17,14,3,3,0,1,1,0,0,0,0,0,1562,-14,5,-5,3,0,3,0,-1,7.4,61.8,-54.4,3,4,-1,1
14698,15517,274,263,4,5,5,4,2,9,0,0,37,15,4,2,0,0,1,0,0,0,0,0,-819,11,-1,1,-7,0,22,2,0,73,44.6,28.4,4,3,1,0
13379,17397,241,271,2,8,8,2,2,9,0,0,33,28,4,2,0,1,0,1,0,0,0,0,-4018,-30,-6,6,-7,0,5,2,-1,13.8,9.8,4,5,2,3,0
14008,15242,259,282,3,5,6,3,3,3,0,1,19,19,3,2,0,0,0,1,0,1,0,0,-1234,-23,-2,3,0,0,0,1,0,36.2,19.8,16.4,3,5,-2,0
14340,15051,249,278,4,3,3,4,3,6,0,0,15,19,6,2,0,1,1,0,0,0,0,0,-711,-29,1,-1,-3,0,-4,4,-1,10.6,32.6,-22,3,3,0,0
14738,15662,248,236,5,8,8,5,4,9,0,1,18,15,5,3,2,1,0,1,0,1,0,0,-924,12,-3,3,-5,0,3,2,1,15.8,29.2,-13.4,3,4,-1,1
14147,16098,280,279,3,8,8,3,1,4,1,0,13,21,2,5,1,1,0,1,1,0,0,0,-1951,1,-5,5,-3,0,-8,-3,0,35.8,18,17.8,4,5,-1,0
15553,15020,261,232,7,5,5,7,9,7,0,0,19,14,1,2,0,0,1,0,0,0,0,0,533,29,2,-2,2,0,5,-1,0,20.8,19.8,1,4,5,-1,0
16330,13551,293,269,6,2,2,6,8,0,0,1,20,15,3,4,0,0,1,0,0,1,0,0,2779,24,4,-4,8,0,5,-1,0,16.6,18.6,-2,4,5,-1,1
17493,16793,264,262,9,9,9,9,10,13,0,1,13,31,3,5,1,0,0,1,0,1,0,0,700,2,0,0,-3,0,-18,-2,1,111.4,38,73.4,4,5,-1,1
16559,13859,280,252,7,3,3,7,7,6,0,0,15,50,4,6,3,0,0,1,0,0,0,0,2700,28,4,-4,1,0,-35,-2,3,19.8,28.8,-9,3,2,1,1
17685,15365,290,228,10,6,6,10,12,6,0,0,13,16,0,2,2,0,1,0,0,0,0,0,2320,62,4,-4,6,0,-3,-2,2,36.6,54.4,-17.8,5,4,1,1
15126,14091,280,254,4,2,2,4,3,2,0,0,19,35,6,2,0,2,0,1,0,0,0,0,1035,26,2,-2,1,0,-16,4,-2,5.8,8,-2.2,2,3,-1,1
14699,13582,260,284,5,0,0,5,4,0,0,0,15,13,1,2,0,2,1,0,0,0,0,0,1117,-24,5,-5,4,0,2,-1,-2,27,19,8,4,4,0,0
16837,13571,297,278,8,1,1,8,10,0,1,0,26,20,5,3,1,0,1,0,1,0,0,0,3266,19,7,-7,10,0,6,2,1,83.8,50.2,33.6,4,4,0,1
15076,15416,274,279,5,5,5,5,8,2,1,0,11,16,2,3,0,0,1,0,1,0,0,0,-340,-5,0,0,6,0,-5,-1,0,18.8,71.4,-52.6,4,3,1,0
17451,15907,277,263,8,5,5,8,9,6,0,0,123,36,3,5,0,0,0,1,0,0,0,0,1544,14,3,-3,3,0,87,-2,0,16.2,19.6,-3.4,3,3,0,1
14544,15516,289,276,2,6,6,2,2,7,0,0,21,15,3,3,0,0,0,1,0,0,0,0,-972,13,-4,4,-5,0,6,0,0,20.8,17,3.8,3,4,-1,0
15662,15231,253,289,7,4,4,8,6,4,0,0,18,36,4,2,0,1,1,0,0,0,0,0,431,-36,3,-4,2,0,-18,2,-1,68.2,24.4,43.8,4,4,0,0
14734,17225,237,260,5,9,9,5,5,9,0,1,16,15,2,6,0,2,0,1,0,1,0,0,-2491,-23,-4,4,-4,0,1,-4,-2,26,13.4,12.6,5,4,1,1
18563,14445,282,263,13,4,4,13,13,2,0,0,17,20,3,3,1,0,1,0,0,0,0,0,4118,19,9,-9,11,0,-3,0,1,47,14.4,32.6,3,5,-2,1
15506,14069,264,277,5,3,3,5,4,1,0,0,17,16,1,2,2,0,0,1,0,0,0,0,1437,-13,2,-2,3,0,1,-1,2,20.6,15.2,5.4,2,5,-3,0
13799,17704,257,283,2,11,11,3,2,11,0,1,13,22,3,1,1,2,0,1,0,1,0,0,-3905,-26,-9,8,-9,0,-9,2,-1,32.6,10,22.6,5,4,1,0
14746,14311,272,275,5,3,3,5,5,2,0,1,17,18,4,6,0,0,1,0,0,1,0,0,435,-3,2,-2,3,0,-1,-2,0,22.8,21.6,1.2,5,5,0,0
13889,15152,260,261,2,5,5,2,3,6,0,0,15,16,3,1,3,0,0,1,0,0,0,0,-1263,-1,-3,3,-3,0,-1,2,3,11.8,13.2,-1.4,4,2,2,0
16564,17801,288,268,6,12,12,6,8,18,1,0,18,15,4,4,0,0,0,1,1,0,0,0,-1237,20,-6,6,-10,0,3,0,0,16.8,16.2,0.6,5,3,2,0
14398,16651,263,252,3,10,10,3,5,10,0,1,17,16,0,3,0,0,0,1,0,1,0,0,-2253,11,-7,7,-5,0,1,-3,0,9.4,35.6,-26.2,3,5,-2,0
17650,15803,261,247,10,6,6,10,11,7,0,0,18,20,4,4,0,1,0,1,0,0,0,0,1847,14,4,-4,4,0,-2,0,-1,16.6,22,-5.4,4,3,1,0
14852,15718,273,256,3,7,7,3,5,8,0,0,30,15,3,7,0,1,0,1,0,0,0,0,-866,17,-4,4,-3,0,15,-4,-1,86.2,13,73.2,4,2,2,1
16528,14345,259,273,10,2,2,10,9,3,0,0,18,20,1,2,0,1,1,0,0,0,0,0,2183,-14,8,-8,6,0,-2,-1,-1,19.4,20.6,-1.2,4,5,-1,1
14766,15940,239,269,5,7,7,5,8,6,0,0,18,19,3,4,0,1,0,1,0,0,0,0,-1174,-30,-2,2,2,0,-1,-1,-1,22.4,30.6,-8.2,4,3,1,1
15473,16326,221,243,7,9,9,7,7,7,0,0,44,18,1,2,0,1,0,1,0,0,0,0,-853,-22,-2,2,0,0,26,-1,-1,29.4,24.2,5.2,3,5,-2,1
14842,16097,269,254,3,8,8,4,4,7,0,0,19,12,2,4,1,1,0,1,0,0,0,0,-1255,15,-5,4,-3,0,7,-2,0,17.4,39.2,-21.8,4,2,2,0
15665,13283,279,269,5,1,1,5,3,1,0,0,16,39,5,2,2,0,1,0,0,0,0,0,2382,10,4,-4,2,0,-23,3,2,54,102.8,-48.8,4,5,-1,1
13771,14691,282,272,1,3,3,1,2,4,0,0,16,20,3,0,0,0,1,0,0,0,0,0,-920,10,-2,2,-2,0,-4,3,0,8.2,39.2,-31,1,4,-3,0
14820,15050,268,263,4,5,5,4,5,5,0,1,37,18,2,6,0,0,0,1,0,1,0,0,-230,5,-1,1,0,0,19,-4,0,52,10,42,4,3,1,1
16225,14729,236,278,9,4,5,9,9,5,0,0,21,18,2,5,0,0,1,0,0,0,0,0,1496,-42,5,-4,4,0,3,-3,0,14.4,19,-4.6,5,3,2,1
15527,16602,254,245,6,9,9,6,6,12,0,0,17,16,3,2,0,0,1,0,0,0,0,0,-1075,9,-3,3,-6,0,1,1,0,23.2,19.2,4,3,3,0,1
13545,15912,283,313,1,4,4,1,0,5,0,0,17,16,3,6,0,1,0,1,0,0,0,0,-2367,-30,-3,3,-5,0,1,-3,-1,13,10.6,2.4,4,3,1,0
14837,15019,252,293,5,3,3,5,9,3,0,0,19,15,4,5,0,2,1,0,0,0,0,0,-182,-41,2,-2,6,0,4,-1,-2,19.8,17,2.8,4,5,-1,0
14641,17088,266,240,4,12,12,4,1,14,0,0,16,20,4,4,0,0,0,1,0,0,0,0,-2447,26,-8,8,-13,0,-4,0,0,15.4,19.4,-4,4,4,0,0
14438,15725,247,251,4,7,7,4,4,8,0,0,16,18,3,4,0,0,1,0,0,0,0,0,-1287,-4,-3,3,-4,0,-2,-1,0,4,24.8,-20.8,1,3,-2,1
13871,14759,258,252,3,5,5,3,2,3,0,0,15,26,1,2,0,0,1,0,0,0,0,0,-888,6,-2,2,-1,0,-11,-1,0,9.8,21.8,-12,2,3,-1,1
15066,15949,254,285,5,6,7,5,7,5,0,1,19,16,2,4,0,0,1,0,0,1,0,0,-883,-31,-1,2,2,0,3,-2,0,20.8,25,-4.2,5,4,1,0
15391,15259,265,248,5,6,6,5,7,6,0,0,12,16,1,5,3,1,0,1,0,0,0,0,132,17,-1,1,1,0,-4,-4,2,30,50.4,-20.4,4,3,1,1
15343,16552,258,250,5,9,9,5,6,12,0,0,26,17,1,2,0,1,1,0,0,0,0,0,-1209,8,-4,4,-6,0,9,-1,-1,35.4,44.6,-9.2,5,3,2,0
15293,15534,268,284,5,6,6,5,2,5,0,0,18,20,2,2,1,0,0,1,0,0,0,0,-241,-16,-1,1,-3,0,-2,0,1,51.4,22.4,29,2,3,-1,1
14716,14701,268,261,4,4,4,5,6,2,0,0,12,34,1,3,1,2,1,0,0,0,0,0,15,7,0,-1,4,0,-22,-2,-1,21.2,16.2,5,4,5,-1,0
15347,15626,294,259,4,6,6,4,3,7,0,0,16,24,3,2,1,0,1,0,0,0,0,0,-279,35,-2,2,-4,0,-8,1,1,9.6,81.2,-71.6,3,4,-1,1
15036,15201,296,271,4,4,4,4,4,4,0,0,16,35,5,3,0,0,0,1,0,0,0,0,-165,25,0,0,0,0,-19,2,0,16,11.4,4.6,4,4,0,1
14505,14801,239,232,4,7,7,4,4,5,0,0,13,18,5,2,1,0,0,1,0,0,0,0,-296,7,-3,3,-1,0,-5,3,1,24.4,13.4,11,4,2,2,0
14045,15411,225,286,4,6,6,4,5,5,0,0,17,12,2,7,0,1,1,0,0,0,0,0,-1366,-61,-2,2,0,0,5,-5,-1,18.6,33,-14.4,4,5,-1,0
14691,13929,270,264,3,2,2,3,3,3,0,0,18,72,5,3,2,1,0,1,0,0,0,0,762,6,1,-1,0,0,-54,2,1,11,22.8,-11.8,2,2,0,0
15448,15217,258,248,6,5,5,6,5,11,0,1,10,15,3,4,0,0,0,1,0,1,0,0,231,10,1,-1,-6,0,-5,-1,0,76.8,11.6,65.2,5,2,3,1
16214,15311,251,253,8,7,7,8,7,3,0,1,19,17,6,1,1,0,0,1,0,1,0,0,903,-2,1,-1,4,0,2,5,1,27.6,64.2,-36.6,4,4,0,1
15638,14234,220,246,9,4,4,9,6,1,0,0,18,15,0,3,3,0,0,1,0,0,0,0,1404,-26,5,-5,5,0,3,-3,3,15.8,6.8,9,3,2,1,1
14021,18082,249,267,3,12,12,3,4,12,0,0,17,16,1,1,0,1,1,0,0,0,0,0,-4061,-18,-9,9,-8,0,1,0,-1,47.4,24.4,23,4,4,0,0
16926,15494,278,269,9,6,6,9,8,9,0,0,11,13,1,1,0,0,0,1,0,0,0,0,1432,9,3,-3,-1,0,-2,0,0,45.8,13.2,32.6,4,4,0,1
16434,15696,262,249,10,7,7,10,5,5,0,0,14,15,3,1,1,0,0,1,0,0,0,0,738,13,3,-3,0,0,-1,2,1,25,32,-7,3,3,0,0
13228,14453,257,284,2,3,3,2,1,2,0,1,11,19,2,2,0,0,0,1,0,1,0,0,-1225,-27,-1,1,-1,0,-8,0,0,20.4,107.8,-87.4,2,4,-2,1
14491,13547,274,253,3,3,3,3,1,4,0,0,23,14,5,3,0,0,0,1,0,0,0,0,944,21,0,0,-3,0,9,2,0,25.4,37,-11.6,2,5,-3,1
14627,16524,241,253,4,8,8,4,3,11,0,0,17,15,1,3,0,4,0,1,0,0,0,0,-1897,-12,-4,4,-8,0,2,-2,-4,18.8,12,6.8,4,2,2,0
14405,17749,220,278,4,10,10,4,9,10,0,0,21,84,2,2,1,4,0,1,0,0,0,0,-3344,-58,-6,6,-1,0,-63,0,-3,35.6,48,-12.4,4,5,-1,0
16141,15576,266,255,6,6,7,6,6,7,0,0,25,15,4,3,2,3,0,1,0,0,0,0,565,11,0,1,-1,0,10,1,-1,44.4,34.6,9.8,4,4,0,1
16306,13590,240,222,10,4,4,10,13,3,0,0,15,25,2,0,0,0,1,0,0,0,0,0,2716,18,6,-6,10,0,-10,2,0,20,24,-4,3,3,0,1
13405,15652,273,271,1,7,7,1,1,6,0,0,15,17,3,2,0,1,0,1,0,0,0,0,-2247,2,-6,6,-5,0,-2,1,-1,13.4,130.4,-117,2,3,-1,0
12745,15597,252,266,0,5,5,0,0,8,0,0,16,35,3,7,0,2,0,1,0,0,0,0,-2852,-14,-5,5,-8,0,-19,-4,-2,55.4,7,48.4,3,3,0,0
14490,14122,289,264,3,3,3,3,3,4,1,0,14,39,6,1,0,0,1,0,1,0,0,0,368,25,0,0,-1,0,-25,5,0,28.4,44.2,-15.8,4,5,-1,0
12792,14540,248,257,1,4,4,1,2,7,0,1,22,16,2,6,0,1,1,0,0,1,0,0,-1748,-9,-3,3,-5,0,6,-4,-1,92,18,74,4,4,0,0
15189,15914,270,285,5,7,7,5,3,5,0,0,17,16,1,1,0,2,0,1,0,0,0,0,-725,-15,-2,2,-2,0,1,0,-2,16.6,14,2.6,2,3,-1,0
15811,14259,272,280,6,1,1,6,8,2,0,0,104,8,0,1,0,1,1,0,0,0,0,0,1552,-8,5,-5,6,0,96,-1,-1,112,40.8,71.2,4,5,-1,1
15697,13960,291,275,5,2,2,6,8,1,0,1,19,11,2,3,0,0,1,0,0,1,0,0,1737,16,3,-4,7,0,8,-1,0,83.4,139.4,-56,3,5,-2,1
15322,13941,256,291,6,1,1,6,4,1,0,0,15,16,4,4,0,1,0,1,0,0,0,0,1381,-35,5,-5,3,0,-1,0,-1,29.4,12.2,17.2,4,2,2,1
15079,15158,294,274,3,5,5,3,3,5,0,1,16,15,4,4,1,1,0,1,0,1,0,0,-79,20,-2,2,-2,0,1,0,0,28,13.6,14.4,4,3,1,1
17642,14702,236,242,11,5,5,11,12,6,0,0,16,14,4,6,0,0,0,1,0,0,0,0,2940,-6,6,-6,6,0,2,-2,0,5.6,56,-50.4,1,4,-3,1
15812,14405,268,266,6,3,3,6,5,6,0,1,18,8,0,4,2,0,1,0,0,1,0,0,1407,2,3,-3,-1,0,10,-4,2,47.8,83.8,-36,4,2,2,1
15178,16400,255,273,6,7,7,6,8,8,0,0,17,20,3,4,0,2,1,0,0,0,0,0,-1222,-18,-1,1,0,0,-3,-1,-2,18.4,81.2,-62.8,4,3,1,0
15711,16424,278,269,6,9,9,6,5,6,0,0,14,18,4,0,0,0,0,1,0,0,0,0,-713,9,-3,3,-1,0,-4,4,0,11.2,29.4,-18.2,4,5,-1,0
13331,14532,263,310,1,1,1,1,1,1,0,1,22,20,4,2,0,1,0,1,0,1,0,0,-1201,-47,0,0,0,0,2,2,-1,38,49.2,-11.2,4,4,0,0
15346,16249,264,272,5,7,7,5,4,7,1,0,21,13,3,5,2,0,0,1,1,0,0,0,-903,-8,-2,2,-3,0,8,-2,2,23.4,12.6,10.8,4,3,1,0
14427,16952,215,259,5,10,11,5,5,10,0,1,16,17,2,3,1,0,0,1,0,1,0,0,-2525,-44,-5,6,-5,0,-1,-1,1,16,70.2,-54.2,2,5,-3,0
13222,14867,236,273,2,4,4,2,3,3,0,0,17,18,1,2,0,0,0,1,0,0,0,0,-1645,-37,-2,2,0,0,-1,-1,0,37.2,24.6,12.6,4,4,0,1
13915,16987,244,293,3,9,9,3,3,8,0,1,12,18,3,5,0,2,0,1,0,1,0,0,-3072,-49,-6,6,-5,0,-6,-2,-2,17.2,33.2,-16,4,3,1,0
15991,15106,282,247,7,6,6,7,4,5,1,0,27,16,3,1,1,0,1,0,1,0,0,0,885,35,1,-1,-1,0,11,2,1,16.6,13.8,2.8,2,3,-1,1
17146,13733,270,238,8,3,3,8,8,5,0,0,15,17,2,5,0,0,1,0,0,0,0,0,3413,32,5,-5,3,0,-2,-3,0,33.6,87,-53.4,4,4,0,1
16388,15758,258,257,8,7,7,8,8,5,0,0,16,17,2,5,3,1,0,1,0,0,0,0,630,1,1,-1,3,0,-1,-3,2,36.8,34,2.8,4,5,-1,0
14251,13575,281,273,2,1,2,2,4,2,0,0,40,11,0,4,3,0,1,0,0,0,0,0,676,8,1,0,2,0,29,-4,3,65.4,24.2,41.2,4,5,-1,0
15254,16983,262,247,4,11,11,4,6,12,0,1,38,20,2,4,1,0,0,1,0,1,0,0,-1729,15,-7,7,-6,0,18,-2,1,24.2,62.2,-38,5,4,1,0
17134,15578,245,266,10,6,6,10,11,3,0,0,12,106,2,2,2,2,1,0,0,0,0,0,1556,-21,4,-4,8,0,-94,0,0,42.6,17.6,25,4,4,0,0
15088,14148,297,280,5,2,2,5,4,1,0,0,14,16,5,3,0,0,1,0,0,0,0,0,940,17,3,-3,3,0,-2,2,0,56.4,21.6,34.8,4,3,1,1
17110,17618,219,263,12,10,10,12,13,7,0,0,29,23,2,5,0,0,1,0,0,0,0,0,-508,-44,2,-2,6,0,6,-3,0,11.2,88.6,-77.4,3,3,0,0
17319,13477,290,230,10,2,3,10,10,3,1,0,22,12,1,6,0,0,1,0,1,0,0,0,3842,60,8,-7,7,0,10,-5,0,25.4,57.6,-32.2,4,3,1,1
15627,14461,298,318,5,1,1,5,7,1,0,0,17,16,3,6,0,1,1,0,0,0,0,0,1166,-20,4,-4,6,0,1,-3,-1,43.2,32.4,10.8,3,5,-2,1
17282,14329,303,218,9,5,5,9,12,6,0,0,20,16,2,3,2,0,0,1,0,0,0,0,2953,85,4,-4,6,0,4,-1,2,26.4,60.4,-34,4,3,1,1
13884,14325,280,291,2,1,1,2,1,2,0,1,12,12,2,1,0,1,1,0,0,1,0,0,-441,-11,1,-1,-1,0,0,1,-1,18.6,20.2,-1.6,4,3,1,1
16301,17690,243,283,8,9,9,8,8,11,0,1,13,19,2,2,0,1,0,1,0,1,0,0,-1389,-40,-1,1,-3,0,-6,0,-1,28.6,48.2,-19.6,3,4,-1,0
15707,14806,297,286,6,4,4,6,3,2,0,0,18,13,4,3,0,0,1,0,0,0,0,0,901,11,2,-2,1,0,5,1,0,55.8,80.6,-24.8,5,3,2,1
13212,17555,227,254,2,11,11,2,2,13,0,1,36,13,2,3,1,1,0,1,0,1,0,0,-4343,-27,-9,9,-11,0,23,-1,0,9,21.4,-12.4,3,4,-1,0
15043,14430,284,280,4,2,2,4,4,3,0,0,15,36,4,3,0,1,0,1,0,0,0,0,613,4,2,-2,1,0,-21,1,-1,19.6,17.8,1.8,4,4,0,1
18035,15090,264,262,11,7,7,11,12,2,0,1,16,18,3,1,0,0,1,0,0,1,0,0,2945,2,4,-4,10,0,-2,2,0,66.6,64.8,1.8,4,4,0,1
14807,15024,296,275,3,3,3,3,3,5,0,0,19,15,1,4,0,0,1,0,0,0,0,0,-217,21,0,0,-2,0,4,-3,0,79.8,48,31.8,3,4,-1,0
16281,14776,280,260,6,4,4,6,5,7,0,0,20,14,2,6,2,0,1,0,0,0,0,0,1505,20,2,-2,-2,0,6,-4,2,12,12.2,-0.2,4,3,1,0
15221,15186,276,254,4,6,6,4,5,4,0,0,16,18,3,3,0,0,0,1,0,0,0,0,35,22,-2,2,1,0,-2,0,0,30.4,8.4,22,4,3,1,1
16977,14568,251,294,10,3,3,10,17,3,0,1,16,111,2,1,1,0,1,0,0,1,0,0,2409,-43,7,-7,14,0,-95,1,1,22.2,57.6,-35.4,3,3,0,1
16388,17310,265,214,8,13,13,8,5,12,1,0,14,36,2,3,2,1,0,1,1,0,0,0,-922,51,-5,5,-7,0,-22,-1,1,20.4,50.8,-30.4,4,3,1,1
14879,13315,259,275,4,1,1,4,9,1,0,1,76,13,1,5,0,0,0,1,0,1,0,0,1564,-16,3,-3,8,0,63,-4,0,52.6,8.2,44.4,4,3,1,1
16490,14238,255,271,6,4,4,6,9,3,0,0,15,19,4,2,3,0,0,1,0,0,0,0,2252,-16,2,-2,6,0,-4,2,3,46.8,15,31.8,4,3,1,1
14890,16615,267,281,5,8,8,5,4,6,1,0,18,24,2,1,0,1,1,0,1,0,0,0,-1725,-14,-3,3,-2,0,-6,1,-1,31,93,-62,5,4,1,0
14862,15392,262,319,4,3,3,4,6,5,0,0,15,17,3,2,0,0,1,0,0,0,0,0,-530,-57,1,-1,1,0,-2,1,0,11.8,50.2,-38.4,5,5,0,0
15674,13669,269,235,7,4,5,7,7,6,0,0,15,13,2,0,0,0,1,0,0,0,0,0,2005,34,3,-2,1,0,2,2,0,18.2,11.8,6.4,3,5,-2,1
16234,13455,231,216,8,3,3,8,9,6,0,0,16,20,3,2,2,0,0,1,0,0,0,0,2779,15,5,-5,3,0,-4,1,2,101.2,43.8,57.4,5,5,0,1
16925,14797,264,263,9,5,5,9,6,2,0,0,19,15,2,3,0,0,0,1,0,0,0,0,2128,1,4,-4,4,0,4,-1,0,23.8,34.6,-10.8,5,3,2,1
14782,15826,263,261,4,7,7,4,4,8,0,0,112,18,3,4,1,1,1,0,0,0,0,0,-1044,2,-3,3,-4,0,94,-1,0,22.8,35.8,-13,4,5,-1,1
15639,16311,243,255,7,9,9,7,7,13,1,0,17,16,2,5,0,2,0,1,1,0,0,0,-672,-12,-2,2,-6,0,1,-3,-2,27.4,81.2,-53.8,3,5,-2,1
16478,14903,283,231,7,7,7,7,5,4,0,0,18,104,2,1,0,0,1,0,0,0,0,0,1575,52,0,0,1,0,-86,1,0,27.4,7,20.4,5,2,3,0
15086,14941,267,229,5,6,7,5,2,7,0,1,13,16,4,0,1,0,0,1,0,1,0,0,145,38,-1,2,-5,0,-3,4,1,86.4,29,57.4,4,4,0,0
17392,15171,277,244,9,5,6,9,6,5,0,1,14,19,5,4,1,0,1,0,0,1,0,0,2221,33,4,-3,1,0,-5,1,1,35.4,114.6,-79.2,5,5,0,1
17155,14006,279,271,9,2,2,10,12,2,0,0,40,15,4,3,0,1,0,1,0,0,0,0,3149,8,7,-8,10,0,25,1,-1,30.4,14.4,16,5,3,2,1
15336,14320,251,286,6,2,2,6,9,2,1,0,20,14,5,5,0,1,1,0,1,0,0,0,1016,-35,4,-4,7,0,6,0,-1,22.6,27.6,-5,5,5,0,1
17139,16236,298,254,7,10,11,7,6,15,0,0,203,37,1,2,2,0,0,1,0,0,0,0,903,44,-3,4,-9,0,166,-1,2,88.4,88.8,-0.4,3,5,-2,1
13842,14403,249,274,3,1,1,3,5,0,0,0,20,15,4,7,1,4,1,0,0,0,0,1,-561,-25,2,-2,5,0,5,-3,-3,27.8,27.6,0.2,2,4,-2,1
13982,13736,268,272,2,2,2,2,3,3,0,1,42,16,5,4,1,0,1,0,0,1,0,0,246,-4,0,0,0,0,26,1,1,9.4,40.8,-31.4,3,5,-2,1
14037,14692,282,290,2,4,4,2,3,0,0,1,19,36,4,7,0,0,1,0,0,1,0,0,-655,-8,-2,2,3,0,-17,-3,0,31.8,15,16.8,2,3,-1,0
15695,16204,257,259,7,8,8,7,5,11,0,0,16,12,1,3,0,0,0,1,0,0,0,0,-509,-2,-1,1,-6,0,4,-2,0,21.2,20.8,0.4,3,5,-2,1
18154,14822,284,265,9,4,4,9,13,5,0,0,14,14,5,3,1,1,1,0,0,0,0,0,3332,19,5,-5,8,0,0,2,0,29.4,8.4,21,4,3,1,1
15895,13780,289,263,5,2,2,5,6,2,0,0,14,44,1,2,1,0,1,0,0,0,0,0,2115,26,3,-3,4,0,-30,-1,1,10,30.6,-20.6,4,4,0,1
16059,14335,275,218,6,4,4,6,5,5,0,0,20,20,4,3,1,0,1,0,0,0,0,0,1724,57,2,-2,0,0,0,1,1,19.4,32.6,-13.2,4,3,1,0
15052,14798,256,255,4,6,6,4,2,2,0,1,13,19,2,1,1,0,1,0,0,1,0,0,254,1,-2,2,0,0,-6,1,1,10,35.4,-25.4,2,4,-2,0
15101,16826,250,325,6,5,5,6,4,5,0,1,19,19,5,5,0,2,0,1,0,1,0,0,-1725,-75,1,-1,-1,0,0,0,-2,32.6,33.2,-0.6,4,4,0,0
15976,16309,281,243,6,8,8,6,8,18,0,1,15,12,1,2,2,0,0,1,0,1,0,0,-333,38,-2,2,-10,0,3,-1,2,5.4,65.6,-60.2,2,3,-1,1
16054,16401,224,263,9,7,7,9,10,8,0,0,20,15,1,4,1,1,0,1,0,0,0,0,-347,-39,2,-2,2,0,5,-3,0,14,12,2,5,4,1,0
15918,14434,267,289,7,3,3,7,9,1,0,0,15,12,2,3,0,1,1,0,0,0,0,0,1484,-22,4,-4,8,0,3,-1,-1,42,30.2,11.8,4,5,-1,1
15961,17760,229,228,8,12,12,8,17,25,0,1,17,26,4,2,0,0,1,0,0,1,0,0,-1799,1,-4,4,-8,0,-9,2,0,17.6,11,6.6,4,3,1,0
18088,14925,262,230,12,5,5,12,22,10,1,0,14,45,3,4,2,0,1,0,1,0,0,0,3163,32,7,-7,12,0,-31,-1,2,7.6,38.2,-30.6,2,3,-1,1
15498,15988,277,277,5,7,7,5,2,9,0,0,15,118,4,3,0,0,0,1,0,0,0,0,-490,0,-2,2,-7,0,-103,1,0,37,51.4,-14.4,5,2,3,0
14714,13142,282,295,5,0,0,5,1,0,0,1,21,17,1,1,0,0,1,0,0,1,0,0,1572,-13,5,-5,1,0,4,0,0,11.2,29.4,-18.2,4,4,0,0
13458,18598,245,275,2,11,11,2,3,11,1,0,36,127,4,1,1,4,0,1,1,0,0,1,-5140,-30,-9,9,-8,0,-91,3,-3,8.2,8.8,-0.6,3,3,0,0
19497,13873,293,252,13,3,3,13,13,3,0,0,17,227,1,3,4,0,0,1,0,0,0,0,5624,41,10,-10,10,0,-210,-2,4,73.4,51,22.4,3,3,0,1
14326,15972,221,250,5,9,9,5,7,4,0,0,12,17,4,4,0,2,0,1,0,0,0,0,-1646,-29,-4,4,3,0,-5,0,-2,38.4,71.2,-32.8,4,4,0,0
14853,14308,235,232,5,4,4,5,8,8,0,0,20,36,3,4,1,0,1,0,0,0,0,0,545,3,1,-1,0,0,-16,-1,1,33.8,18.2,15.6,3,2,1,0
13898,13789,270,255,2,3,3,2,2,1,0,0,18,17,3,3,0,0,0,1,0,0,0,0,109,15,-1,1,1,0,1,0,0,43.6,13.6,30,4,3,1,1
16048,15748,237,255,8,7,7,8,10,3,0,1,19,13,1,3,0,2,1,0,0,1,0,0,300,-18,1,-1,7,0,6,-2,-2,50.8,31.2,19.6,4,5,-1,0
13905,16660,268,279,2,7,7,2,1,10,0,1,17,16,2,3,0,0,0,1,0,1,0,0,-2755,-11,-5,5,-9,0,1,-1,0,14.4,103.2,-88.8,4,5,-1,0
15009,13772,284,282,4,1,1,4,4,2,0,1,35,20,1,4,1,0,1,0,0,1,0,0,1237,2,3,-3,2,0,15,-3,1,33,20.4,12.6,3,4,-1,1
14869,15967,266,306,6,5,5,6,1,3,0,0,15,13,3,4,0,2,0,1,0,0,0,0,-1098,-40,1,-1,-2,0,2,-1,-2,9.8,53,-43.2,4,3,1,0
13794,16476,250,284,3,7,7,3,2,9,0,1,15,20,2,5,0,1,0,1,0,1,0,0,-2682,-34,-4,4,-7,0,-5,-3,-1,14.4,13.8,0.6,3,2,1,1
15713,15136,241,246,8,5,5,8,6,7,0,0,14,14,1,7,2,1,1,0,0,0,0,0,577,-5,3,-3,-1,0,0,-6,1,12.8,92,-79.2,1,3,-2,0
15750,18072,280,261,5,10,10,5,5,11,0,0,15,113,4,4,1,1,0,1,0,0,0,0,-2322,19,-5,5,-6,0,-98,0,0,45.2,17.2,28,2,4,-2,0
15606,15678,284,275,5,6,7,5,5,5,0,0,23,18,7,2,1,0,1,0,0,0,0,0,-72,9,-1,2,0,0,5,5,1,91.2,11.8,79.4,3,4,-1,1
14180,16473,291,269,1,7,7,1,2,9,0,0,16,15,4,1,0,1,0,1,0,0,0,0,-2293,22,-6,6,-7,0,1,3,-1,29.6,32.4,-2.8,4,4,0,0
13256,17247,248,273,2,11,11,2,1,6,0,0,14,26,1,8,0,0,0,1,0,0,0,0,-3991,-25,-9,9,-5,0,-12,-7,0,14,28.8,-14.8,3,4,-1,1
13343,15287,273,319,1,3,3,1,1,4,0,1,45,17,4,4,0,1,0,1,0,1,0,0,-1944,-46,-2,2,-3,0,28,0,-1,30.2,34.4,-4.2,4,4,0,0
15053,14971,254,263,5,6,6,5,6,3,0,1,14,14,3,3,2,0,1,0,0,1,0,0,82,-9,-1,1,3,0,0,0,2,30.2,15.4,14.8,4,2,2,1
14485,14876,241,250,6,5,5,6,5,4,0,0,26,15,2,2,1,1,1,0,0,0,0,0,-391,-9,1,-1,1,0,11,0,0,23.6,18,5.6,4,3,1,0
16243,14837,240,246,8,4,4,8,7,6,0,0,38,21,6,4,2,1,1,0,0,0,0,0,1406,-6,4,-4,1,0,17,2,1,38.6,29.6,9,3,4,-1,0
16017,14049,232,259,8,3,3,8,18,2,0,1,15,18,3,4,0,0,1,0,0,1,0,0,1968,-27,5,-5,16,0,-3,-1,0,66.4,93.8,-27.4,3,4,-1,0
14463,15447,239,280,5,5,5,5,5,5,0,0,17,17,3,1,0,0,1,0,0,0,0,0,-984,-41,0,0,0,0,0,2,0,50,35.8,14.2,3,4,-1,0
15665,14646,284,265,6,4,4,6,5,4,0,0,117,15,4,1,0,0,1,0,0,0,0,0,1019,19,2,-2,1,0,102,3,0,65.4,12.8,52.6,5,4,1,0
15848,14337,273,257,7,3,3,7,8,6,0,0,16,21,6,0,1,0,1,0,0,0,0,0,1511,16,4,-4,2,0,-5,6,1,12.2,26.2,-14,5,3,2,1
14595,13700,270,262,3,2,2,3,4,3,0,1,11,59,5,2,1,1,0,1,0,1,0,0,895,8,1,-1,1,0,-48,3,0,10.4,35.8,-25.4,3,5,-2,1
15691,17104,218,269,7,10,10,7,15,12,0,1,14,15,3,0,0,1,0,1,0,1,0,0,-1413,-51,-3,3,3,0,-1,3,-1,72.8,34.6,38.2,4,4,0,0
16664,18053,244,252,9,11,11,9,11,13,0,0,14,16,3,2,0,2,1,0,0,0,0,0,-1389,-8,-2,2,-2,0,-2,1,-2,81.4,75.6,5.8,3,2,1,0
15834,15728,263,254,8,6,6,8,9,11,0,0,14,13,2,1,0,0,0,1,0,0,0,0,106,9,2,-2,-2,0,1,1,0,52.2,29.6,22.6,4,5,-1,0
15605,15110,261,284,5,4,4,5,10,5,0,0,28,21,6,2,1,3,0,1,0,0,0,0,495,-23,1,-1,5,0,7,4,-2,45.2,8.6,36.6,3,4,-1,0
13766,17193,243,265,3,11,11,3,3,17,0,0,12,15,1,3,1,2,0,1,0,0,0,0,-3427,-22,-8,8,-14,0,-3,-2,-1,6.8,84.2,-77.4,2,5,-3,0
15215,15142,258,241,5,6,6,5,8,6,0,0,18,18,2,0,0,0,0,1,0,0,0,0,73,17,-1,1,2,0,0,2,0,9.2,16.6,-7.4,4,3,1,1
15371,18109,249,266,5,11,11,5,5,7,0,0,13,16,3,2,1,5,1,0,0,0,0,0,-2738,-17,-6,6,-2,0,-3,1,-4,16.2,14.6,1.6,4,3,1,0
14721,14232,228,259,6,4,4,6,5,1,0,0,14,20,5,3,0,1,0,1,0,0,0,0,489,-31,2,-2,4,0,-6,2,-1,13.2,23.4,-10.2,4,4,0,0
14951,15231,271,294,5,5,5,5,6,5,0,0,16,19,2,3,0,0,1,0,0,0,0,0,-280,-23,0,0,1,0,-3,-1,0,49.2,12.6,36.6,4,4,0,1
15246,14846,243,273,7,3,3,7,4,3,0,1,20,13,2,5,1,1,1,0,0,1,0,0,400,-30,4,-4,1,0,7,-3,0,27.2,69.2,-42,3,4,-1,1
15887,15495,262,261,6,7,7,6,6,6,0,1,16,16,1,1,1,1,0,1,0,1,0,0,392,1,-1,1,0,0,0,0,0,13,17.8,-4.8,5,3,2,0
13365,16348,263,263,1,10,10,1,1,8,0,0,35,18,5,5,0,0,0,1,0,0,0,0,-2983,0,-9,9,-7,0,17,0,0,56,16.4,39.6,4,4,0,0
16614,14111,295,278,5,2,2,5,8,2,1,0,30,16,4,3,2,3,1,0,1,0,0,0,2503,17,3,-3,6,0,14,1,-1,49.2,10.6,38.6,5,3,2,0
13368,16621,247,260,1,7,7,1,2,11,0,0,15,19,3,1,1,1,0,1,0,0,0,0,-3253,-13,-6,6,-9,0,-4,2,0,13,23.8,-10.8,3,4,-1,0
14614,15467,261,283,4,5,5,4,5,3,0,0,47,44,3,5,0,2,0,1,0,0,0,0,-853,-22,-1,1,2,0,3,-2,-2,62.2,38.8,23.4,4,5,-1,0
2609,2661,3,5,0,0,0,0,0,0,0,0,1,7,0,1,0,0,0,0,0,0,0,0,-52,-2,0,0,0,0,-6,-1,0,16.2,11.6,4.6,3,3,0,1
14844,15399,271,248,5,7,7,5,2,3,0,0,14,14,2,5,1,0,0,1,0,0,0,0,-555,23,-2,2,-1,0,0,-3,1,6.8,35.4,-28.6,1,5,-4,0
15830,15541,243,287,7,6,6,7,6,4,0,1,12,22,5,2,0,0,1,0,0,1,0,0,289,-44,1,-1,2,0,-10,3,0,77.2,6.6,70.6,4,1,3,0
13551,16842,239,268,3,9,9,3,5,7,0,0,22,46,2,3,0,2,0,1,0,0,0,0,-3291,-29,-6,6,-2,0,-24,-1,-2,126.4,88,38.4,5,3,2,0
14425,14497,278,283,3,2,2,3,6,4,1,0,17,32,2,4,0,1,0,1,1,0,0,0,-72,-5,1,-1,2,0,-15,-2,-1,13.8,54.2,-40.4,3,5,-2,0
15820,16449,220,256,8,8,8,8,11,8,0,0,29,19,5,1,0,0,0,1,0,0,0,0,-629,-36,0,0,3,0,10,4,0,27.8,20.2,7.6,4,4,0,0
13063,16353,232,246,1,9,9,1,1,16,0,1,15,22,1,2,0,1,0,1,0,1,0,0,-3290,-14,-8,8,-15,0,-7,-1,-1,50.8,21.8,29,4,4,0,0
15574,13772,225,240,7,3,3,8,6,1,0,1,16,33,2,6,2,2,1,0,0,1,0,0,1802,-15,4,-5,5,0,-17,-4,0,38.4,48.2,-9.8,5,3,2,1
14983,15630,260,262,4,7,7,4,5,4,0,1,13,19,6,3,0,0,0,1,0,1,0,0,-647,-2,-3,3,1,0,-6,3,0,20.4,11,9.4,4,3,1,0
17730,13967,269,241,12,3,3,12,11,4,0,0,25,19,6,1,0,0,1,0,0,0,0,0,3763,28,9,-9,7,0,6,5,0,28.2,125.4,-97.2,3,5,-2,1
16280,14876,268,278,10,4,4,10,5,3,0,1,13,16,0,2,0,2,0,1,0,1,0,0,1404,-10,6,-6,2,0,-3,-2,-2,50.4,10.2,40.2,4,2,2,1
18506,16204,237,214,12,9,9,13,10,11,0,0,13,24,4,2,3,0,0,1,0,0,0,0,2302,23,3,-4,-1,0,-11,2,3,20.2,108.4,-88.2,3,3,0,1
13602,17345,274,298,2,8,8,2,0,9,0,0,27,18,3,0,0,0,0,1,0,0,0,0,-3743,-24,-6,6,-9,0,9,3,0,22,27,-5,3,4,-1,0
14576,15843,232,261,6,6,6,6,3,8,1,0,21,20,5,5,0,1,0,1,1,0,0,0,-1267,-29,0,0,-5,0,1,0,-1,131.2,21.6,109.6,5,4,1,1
16823,15862,242,223,12,7,7,12,8,6,0,0,22,21,6,7,0,0,1,0,0,0,0,0,961,19,5,-5,2,0,1,-1,0,34.2,46.4,-12.2,5,2,3,1
14753,16619,265,296,3,5,5,3,5,7,0,0,13,18,2,2,2,2,1,0,0,0,0,0,-1866,-31,-2,2,-2,0,-5,0,0,37.8,17.6,20.2,4,3,1,0
13998,17203,281,267,1,10,10,1,1,13,0,0,11,17,4,1,1,1,0,1,0,0,0,0,-3205,14,-9,9,-12,0,-6,3,0,161,115,46,4,4,0,0
15494,15563,279,283,4,5,5,4,4,5,0,1,18,54,2,2,1,0,1,0,0,1,0,0,-69,-4,-1,1,-1,0,-36,0,1,71.6,16.6,55,3,4,-1,1
15555,14426,261,234,6,5,5,6,6,4,1,0,14,12,3,5,1,1,1,0,1,0,0,0,1129,27,1,-1,2,0,2,-2,0,17,6,11,4,1,3,1
15947,15232,283,236,8,5,5,8,3,6,0,0,16,10,2,1,1,1,1,0,0,0,0,0,715,47,3,-3,-3,0,6,1,0,8.6,25.6,-17,4,3,1,1
14971,15036,256,273,5,4,4,5,5,3,1,0,26,13,3,4,1,2,1,0,1,0,0,0,-65,-17,1,-1,2,0,13,-1,-1,20.6,12.4,8.2,3,3,0,1
17784,12832,292,252,9,1,1,9,9,0,0,0,116,20,4,1,1,0,1,0,0,0,0,0,4952,40,8,-8,9,0,96,3,1,13.8,34,-20.2,3,4,-1,1
14178,15256,259,269,2,5,5,2,3,7,0,0,14,14,2,2,0,1,0,1,0,0,0,0,-1078,-10,-3,3,-4,0,0,0,-1,16.2,73.6,-57.4,4,4,0,0
14808,14864,274,283,4,4,4,4,2,2,0,0,13,17,4,5,0,1,1,0,0,0,0,0,-56,-9,0,0,0,0,-4,-1,-1,21,23.6,-2.6,3,4,-1,1
13774,14618,262,259,2,4,4,2,3,4,0,0,14,14,1,3,0,0,1,0,0,0,0,0,-844,3,-2,2,-1,0,0,-2,0,34.8,18.2,16.6,4,3,1,0
14696,13770,287,288,2,1,1,2,3,2,0,0,15,16,2,3,0,0,1,0,0,0,0,0,926,-1,1,-1,1,0,-1,-1,0,12.6,12.8,-0.2,3,4,-1,0
16661,16820,258,232,9,11,11,9,10,12,0,0,12,13,1,2,0,0,0,1,0,0,0,0,-159,26,-2,2,-2,0,-1,-1,0,53.4,51.4,2,3,4,-1,1
15188,14613,262,240,6,5,5,6,4,8,0,0,21,16,2,6,1,0,0,1,0,0,0,0,575,22,1,-1,-4,0,5,-4,1,20,45.2,-25.2,3,4,-1,1
15876,15508,279,270,6,4,4,7,4,6,0,0,16,39,2,2,0,0,0,1,0,0,0,0,368,9,2,-3,-2,0,-23,0,0,36.2,33.8,2.4,5,5,0,1
14863,15353,270,282,5,5,5,5,3,6,1,0,16,14,2,0,0,0,1,0,1,0,0,0,-490,-12,0,0,-3,0,2,2,0,7.6,8,-0.4,3,2,1,0
15598,15010,278,283,4,5,5,4,4,1,0,0,15,13,4,0,2,0,0,1,0,0,0,0,588,-5,-1,1,3,0,2,4,2,35.2,13.8,21.4,3,3,0,0
15914,15741,274,264,5,8,8,5,7,6,0,1,18,16,5,2,2,0,0,1,0,1,0,0,173,10,-3,3,1,0,2,3,2,19.2,31,-11.8,4,4,0,1
14964,14460,278,246,5,4,4,5,1,4,0,0,37,15,4,2,1,1,1,0,0,0,0,0,504,32,1,-1,-3,0,22,2,0,23.6,23,0.6,4,4,0,1
17598,15344,252,225,11,6,6,11,11,6,0,0,22,14,3,5,1,1,1,0,0,0,0,0,2254,27,5,-5,5,0,8,-2,0,35.4,59.6,-24.2,5,3,2,1
15240,15615,244,268,6,6,6,6,10,8,0,0,13,22,0,1,0,1,0,1,0,0,0,0,-375,-24,0,0,2,0,-9,-1,-1,51.2,63.4,-12.2,5,5,0,0
17070,16283,256,270,9,7,7,9,13,6,1,0,16,17,4,3,0,0,1,0,1,0,0,0,787,-14,2,-2,7,0,-1,1,0,114.6,20.6,94,4,3,1,1
17483,14862,287,245,9,4,4,9,6,3,0,0,25,35,3,3,1,0,1,0,0,0,0,0,2621,42,5,-5,3,0,-10,0,1,18.6,13.6,5,4,3,1,1
13637,14768,253,269,2,5,5,2,3,4,1,0,17,14,0,4,1,1,1,0,1,0,0,0,-1131,-16,-3,3,-1,0,3,-4,0,70,28,42,4,4,0,1
15817,17403,243,279,7,10,10,7,8,10,0,0,15,16,2,0,0,0,0,1,0,0,0,0,-1586,-36,-3,3,-2,0,-1,2,0,53.6,109.2,-55.6,3,5,-2,0
17681,14077,277,259,11,2,2,11,15,3,0,0,36,106,4,4,3,0,1,0,0,0,0,0,3604,18,9,-9,12,0,-70,0,3,35.4,48.8,-13.4,3,2,1,1
14250,15518,272,288,3,5,5,3,2,6,1,0,15,41,3,3,1,2,0,1,1,0,0,0,-1268,-16,-2,2,-4,0,-26,0,-1,9.8,11.6,-1.8,3,3,0,1
15990,15449,267,300,6,4,4,6,9,4,0,0,17,16,3,2,0,0,1,0,0,0,0,0,541,-33,2,-2,5,0,1,1,0,28.6,16.4,12.2,3,2,1,0
14756,13953,300,289,2,1,1,2,3,2,0,1,19,20,3,6,0,0,1,0,0,1,0,0,803,11,1,-1,1,0,-1,-3,0,48.8,17.8,31,5,4,1,1
15499,16490,243,259,6,9,9,6,9,12,0,1,101,18,4,6,0,1,0,1,0,1,0,0,-991,-16,-3,3,-3,0,83,-2,-1,27.6,9,18.6,2,3,-1,0
15931,14261,283,253,4,3,3,4,7,4,0,0,17,14,1,2,2,1,0,1,0,0,0,0,1670,30,1,-1,3,0,3,-1,1,7,19.4,-12.4,2,2,0,1
15414,15402,268,278,6,4,4,6,7,4,1,0,23,15,3,7,1,0,1,0,1,0,0,0,12,-10,2,-2,3,0,8,-4,1,62.4,5.6,56.8,5,2,3,1
15582,15735,233,261,7,7,7,7,8,8,0,0,14,20,3,1,0,1,0,1,0,0,0,0,-153,-28,0,0,0,0,-6,2,-1,35.4,19.4,16,5,3,2,1
15709,15163,245,277,7,3,3,7,8,4,0,0,12,20,2,2,0,1,0,1,0,0,0,0,546,-32,4,-4,4,0,-8,0,-1,50,25.2,24.8,3,3,0,0
16513,13880,294,264,7,2,2,7,9,3,0,0,16,16,3,1,0,0,1,0,0,0,0,0,2633,30,5,-5,6,0,0,2,0,14.2,15.8,-1.6,5,3,2,1
16450,16186,258,248,8,8,8,8,16,8,0,0,13,14,3,4,0,0,1,0,0,0,0,0,264,10,0,0,8,0,-1,-1,0,6,16.8,-10.8,2,4,-2,0
15696,18965,234,262,7,13,13,7,13,16,0,0,17,25,0,5,0,1,0,1,0,0,0,0,-3269,-28,-6,6,-3,0,-8,-5,-1,16.6,13.6,3,3,4,-1,0
13303,17020,210,281,3,10,10,3,2,8,0,0,15,17,1,0,0,1,0,1,0,0,0,0,-3717,-71,-7,7,-6,0,-2,1,-1,12.6,75.8,-63.2,2,5,-3,0
15488,15137,272,250,6,6,6,6,6,3,0,0,163,11,2,3,2,0,1,0,0,0,0,0,351,22,0,0,3,0,152,-1,2,105.8,28,77.8,5,3,2,1
16709,13072,308,269,7,1,1,7,7,0,0,1,18,13,4,3,0,0,1,0,0,1,0,0,3637,39,6,-6,7,0,5,1,0,11.6,49.8,-38.2,3,4,-1,1
16777,14956,303,264,8,4,5,8,4,6,0,1,17,13,1,3,0,0,1,0,0,1,0,0,1821,39,4,-3,-2,0,4,-2,0,39,41.4,-2.4,3,5,-2,0
14695,14882,285,277,4,4,4,4,3,8,0,0,36,15,4,0,0,0,0,1,0,0,0,0,-187,8,0,0,-5,0,21,4,0,8,51.6,-43.6,2,4,-2,1
13078,15373,249,290,1,5,5,1,1,3,1,0,16,121,5,6,0,1,0,1,1,0,0,0,-2295,-41,-4,4,-2,0,-105,-1,-1,47,40.2,6.8,3,4,-1,0
13601,15167,263,286,2,4,4,2,3,9,1,0,16,37,3,3,0,0,1,0,1,0,0,0,-1566,-23,-2,2,-6,0,-21,0,0,7,45.2,-38.2,2,4,-2,0
15445,15563,254,253,6,6,6,6,9,4,0,1,19,37,4,3,1,0,1,0,0,1,0,0,-118,1,0,0,5,0,-18,1,1,19.2,47.2,-28,4,3,1,0
13891,14519,262,254,2,4,4,2,3,5,0,0,18,18,5,7,1,1,0,1,0,0,0,0,-628,8,-2,2,-2,0,0,-2,0,26,20.2,5.8,3,5,-2,1
15824,14868,247,266,6,4,4,6,9,5,0,1,20,37,2,3,0,0,1,0,0,1,0,0,956,-19,2,-2,4,0,-17,-1,0,28,10.6,17.4,4,3,1,1
14672,14833,261,261,5,4,4,5,3,2,0,0,17,37,3,3,0,3,1,0,0,0,0,0,-161,0,1,-1,1,0,-20,0,-3,23.8,11.2,12.6,4,3,1,0
13491,14785,281,242,0,5,5,0,0,5,0,0,14,33,2,2,0,0,0,1,0,0,0,0,-1294,39,-5,5,-5,0,-19,0,0,19.4,31.8,-12.4,4,1,3,1
15673,16198,247,257,7,7,7,7,7,11,0,0,19,13,0,3,1,0,1,0,0,0,0,0,-525,-10,0,0,-4,0,6,-3,1,29.2,21.4,7.8,5,3,2,0
14344,14815,255,301,4,4,4,4,3,3,0,1,16,19,3,1,0,1,0,1,0,1,0,0,-471,-46,0,0,0,0,-3,2,-1,10.4,13.2,-2.8,4,4,0,0
15685,14869,253,264,6,3,3,6,9,4,0,0,13,39,3,3,1,3,0,1,0,0,0,0,816,-11,3,-3,5,0,-26,0,-2,9.8,9.6,0.2,3,3,0,0
17097,15659,242,282,10,6,6,11,12,2,0,1,21,178,1,2,0,3,1,0,0,1,0,0,1438,-40,4,-5,10,0,-157,-1,-3,14.8,29.2,-14.4,2,2,0,0
13734,15367,272,290,2,4,4,2,2,6,0,1,13,13,3,4,0,1,0,1,0,1,0,0,-1633,-18,-2,2,-4,0,0,-1,-1,21.4,123.6,-102.2,4,5,-1,0
14256,13802,305,272,2,2,2,2,2,4,0,0,17,31,0,1,0,0,0,1,0,0,0,0,454,33,0,0,-2,0,-14,-1,0,63.8,6.4,57.4,2,3,-1,1
16069,15027,295,260,5,6,6,5,6,7,0,0,15,15,3,0,0,1,0,1,0,0,0,0,1042,35,-1,1,-1,0,0,3,-1,10.8,42.6,-31.8,3,4,-1,1
14667,17400,237,269,5,9,9,6,8,9,0,0,13,11,2,4,0,1,0,1,0,0,0,0,-2733,-32,-4,3,-1,0,2,-2,-1,50,34.2,15.8,3,4,-1,0
14492,16948,265,303,3,7,8,3,4,9,0,1,35,18,4,7,1,0,1,0,0,1,0,0,-2456,-38,-4,5,-5,0,17,-3,1,69,62.6,6.4,4,4,0,0
15659,15085,265,248,6,7,7,6,7,5,1,0,15,17,4,1,0,0,0,1,1,0,0,0,574,17,-1,1,2,0,-2,3,0,33.6,5.4,28.2,3,1,2,1
14901,15319,267,237,4,7,7,4,3,8,0,0,13,21,3,3,1,2,1,0,0,0,0,0,-418,30,-3,3,-5,0,-8,0,-1,12,48.2,-36.2,3,5,-2,1
17664,15181,273,257,9,5,6,9,9,4,0,0,14,101,3,4,3,0,0,1,0,0,0,0,2483,16,4,-3,5,0,-87,-1,3,76,52.4,23.6,4,2,2,1
16428,15186,231,249,9,6,6,9,11,4,0,0,21,20,2,6,1,1,0,1,0,0,0,0,1242,-18,3,-3,7,0,1,-4,0,19,13.2,5.8,5,5,0,1
15155,14653,296,285,4,3,3,4,1,7,0,0,36,35,3,5,0,1,0,1,0,0,0,0,502,11,1,-1,-6,0,1,-2,-1,24.8,40.4,-15.6,4,4,0,1
15787,16175,250,271,8,7,7,8,8,9,0,0,25,16,5,4,0,1,0,1,0,0,0,0,-388,-21,1,-1,-1,0,9,1,-1,34.2,17,17.2,3,3,0,1
14732,14998,271,250,4,6,6,5,2,6,0,0,16,15,1,2,0,1,0,1,0,0,0,0,-266,21,-2,1,-4,0,1,-1,-1,10.8,5.6,5.2,3,1,2,0
16816,13211,290,261,7,1,1,7,9,0,0,0,16,13,2,1,0,0,1,0,0,0,0,0,3605,29,6,-6,9,0,3,1,0,143.4,43.6,99.8,4,3,1,1
15824,13748,243,257,7,2,2,7,7,2,0,0,19,24,1,6,1,0,0,1,0,0,0,0,2076,-14,5,-5,5,0,-5,-5,1,48,37.8,10.2,4,4,0,0
16664,14925,259,293,9,3,3,9,14,3,0,0,15,14,2,3,0,1,1,0,0,0,0,0,1739,-34,6,-6,11,0,1,-1,-1,58.2,45,13.2,4,3,1,1
16278,15169,275,277,7,5,5,7,6,2,0,1,12,16,4,0,2,1,0,1,0,1,0,0,1109,-2,2,-2,4,0,-4,4,1,22.6,23.2,-0.6,5,2,3,1
17647,15148,284,266,9,5,5,9,10,3,0,1,15,15,1,2,0,0,1,0,0,1,0,0,2499,18,4,-4,7,0,0,-1,0,16.2,14.8,1.4,4,2,2,1
15007,16581,283,301,4,8,8,4,4,9,0,1,15,15,2,5,0,0,0,1,0,1,0,0,-1574,-18,-4,4,-5,0,0,-3,0,8,23.4,-15.4,1,4,-3,0
17748,13670,256,269,12,2,2,12,13,0,0,0,19,16,2,3,0,0,0,1,0,0,0,0,4078,-13,10,-10,13,0,3,-1,0,24.6,24.8,-0.2,4,4,0,1
15471,15429,243,271,5,5,6,5,6,5,0,1,27,22,4,6,0,2,0,1,0,1,0,0,42,-28,0,1,1,0,5,-2,-2,18.8,10.4,8.4,5,4,1,0
14044,14725,245,249,4,4,4,4,4,8,0,0,19,18,1,2,0,0,1,0,0,0,0,0,-681,-4,0,0,-4,0,1,-1,0,20.8,36.8,-16,4,5,-1,1
17610,14941,258,245,11,5,5,11,11,3,1,0,21,15,2,3,1,0,0,1,1,0,0,0,2669,13,6,-6,8,0,6,-1,1,31,12.4,18.6,5,3,2,1
12747,17593,190,279,3,11,11,3,4,6,0,0,15,16,1,1,0,1,1,0,0,0,0,0,-4846,-89,-8,8,-2,0,-1,0,-1,45.8,96,-50.2,4,2,2,0
14540,15183,285,267,3,5,5,3,3,4,0,0,44,17,4,4,0,0,0,1,0,0,0,0,-643,18,-2,2,-1,0,27,0,0,15.4,46,-30.6,4,4,0,0
14591,14793,276,279,4,3,3,4,4,6,0,0,14,19,3,2,0,0,1,0,0,0,0,0,-202,-3,1,-1,-2,0,-5,1,0,37.6,22.2,15.4,4,3,1,1
15708,15416,278,272,6,5,5,6,4,5,0,0,15,17,4,1,0,0,0,1,0,0,0,0,292,6,1,-1,-1,0,-2,3,0,10,12.6,-2.6,5,5,0,0
17064,14326,283,255,8,4,4,8,8,3,0,0,16,32,3,3,0,0,0,1,0,0,0,0,2738,28,4,-4,5,0,-16,0,0,31.4,106,-74.6,5,3,2,1
13973,16670,231,259,4,10,10,4,4,11,0,0,36,19,2,3,0,0,0,1,0,0,0,0,-2697,-28,-6,6,-7,0,17,-1,0,35.8,69.6,-33.8,4,3,1,0
15742,13020,297,277,5,0,0,5,4,0,0,0,19,18,3,4,2,0,1,0,0,0,0,0,2722,20,5,-5,4,0,1,-1,2,13.8,10.4,3.4,4,4,0,1
17595,15133,267,257,10,6,6,10,10,6,0,0,17,33,0,1,1,0,0,1,0,0,0,0,2462,10,4,-4,4,0,-16,-1,1,30.8,41,-10.2,5,5,0,1
14598,15421,223,219,6,9,9,6,9,9,1,0,16,21,4,3,0,0,1,0,1,0,0,0,-823,4,-3,3,0,0,-5,1,0,30.4,8.6,21.8,3,4,-1,1
17092,15672,263,254,12,5,5,12,7,8,0,0,37,29,6,4,1,0,1,0,0,0,0,0,1420,9,7,-7,-1,0,8,2,1,9.8,62.4,-52.6,2,3,-1,1
15140,16121,225,249,7,9,9,7,8,6,0,0,15,44,5,3,0,0,1,0,0,0,0,0,-981,-24,-2,2,2,0,-29,2,0,22.6,25.4,-2.8,5,4,1,0
14859,15169,282,276,3,4,4,3,6,5,0,0,39,13,0,2,2,1,0,1,0,0,0,0,-310,6,-1,1,1,0,26,-2,1,72,9.4,62.6,5,2,3,1
15184,15790,290,254,4,7,7,6,5,10,0,0,70,17,4,4,0,0,0,1,0,0,0,0,-606,36,-3,1,-5,0,53,0,0,8.8,52.2,-43.4,4,3,1,1
18023,15127,230,217,13,7,7,14,17,7,0,1,17,98,2,4,0,0,1,0,0,1,0,0,2896,13,6,-7,10,0,-81,-2,0,36.8,109.8,-73,4,3,1,1
15480,15166,261,256,5,6,6,5,6,3,0,0,26,15,4,3,1,0,0,1,0,0,0,0,314,5,-1,1,3,0,11,1,1,52.8,55.4,-2.6,4,4,0,0
16356,13613,272,210,7,5,5,7,7,5,0,0,17,16,3,1,1,0,0,1,0,0,0,0,2743,62,2,-2,2,0,1,2,1,10.2,15.2,-5,3,2,1,1
13471,16029,274,288,1,6,6,1,0,8,0,1,18,42,4,4,0,1,1,0,0,1,0,0,-2558,-14,-5,5,-8,0,-24,0,-1,45.4,12.2,33.2,5,3,2,0
16236,14244,302,250,6,3,3,6,4,6,0,1,12,36,3,2,0,0,1,0,0,1,0,0,1992,52,3,-3,-2,0,-24,1,0,10.4,48,-37.6,3,4,-1,0
14135,16798,235,265,3,11,11,3,5,5,0,0,15,34,1,2,0,1,0,1,0,0,0,0,-2663,-30,-8,8,0,0,-19,-1,-1,39.8,17.2,22.6,4,5,-1,0
16335,17253,253,258,8,10,10,8,8,11,0,0,12,41,1,2,0,0,0,1,0,0,0,0,-918,-5,-2,2,-3,0,-29,-1,0,20.6,10.4,10.2,4,4,0,1
16400,16999,254,268,8,7,7,8,11,7,0,1,136,19,3,4,1,1,1,0,0,1,0,0,-599,-14,1,-1,4,0,117,-1,0,14.6,25.6,-11,4,3,1,1
16036,13557,267,282,7,1,1,9,10,3,0,1,41,13,3,7,0,0,1,0,0,1,0,0,2479,-15,6,-8,7,0,28,-4,0,29.8,43.4,-13.6,4,2,2,1
15020,14636,290,290,3,3,3,3,2,1,0,1,20,20,2,4,1,1,0,1,0,1,0,0,384,0,0,0,1,0,0,-2,0,13.6,10.4,3.2,4,4,0,1
15240,14530,266,236,5,7,7,6,6,3,0,0,17,16,2,1,0,0,0,1,0,0,0,0,710,30,-2,1,3,0,1,1,0,7,44.2,-37.2,3,4,-1,0
16484,15458,277,276,7,5,5,7,14,7,0,1,39,15,4,5,1,0,1,0,0,1,0,0,1026,1,2,-2,7,0,24,-1,1,18.4,22.6,-4.2,3,4,-1,0
14324,18789,242,237,4,14,14,5,4,20,1,0,13,14,1,1,3,4,1,0,1,0,0,0,-4465,5,-10,9,-16,0,-1,0,-1,15.8,12.2,3.6,3,3,0,0
15214,14795,278,250,5,5,5,5,5,7,0,1,21,12,2,5,0,0,1,0,0,1,0,0,419,28,0,0,-2,0,9,-3,0,11.4,11.4,0,2,3,-1,1
14326,17020,238,262,3,11,11,3,5,10,0,1,124,17,3,1,0,2,0,1,0,1,0,0,-2694,-24,-8,8,-5,0,107,2,-2,29.2,118,-88.8,4,5,-1,0
15242,14684,237,234,7,6,6,7,6,4,0,1,112,55,2,3,0,1,0,1,0,1,0,0,558,3,1,-1,2,0,57,-1,-1,25.4,163,-137.6,3,4,-1,0
14539,14415,260,263,5,3,4,5,5,3,0,0,17,143,3,3,0,1,1,0,0,0,0,0,124,-3,2,-1,2,0,-126,0,-1,31.2,10.2,21,5,3,2,0
16930,16498,261,259,9,7,7,9,11,13,0,0,18,15,1,2,0,1,1,0,0,0,0,0,432,2,2,-2,-2,0,3,-1,-1,16.6,25.4,-8.8,5,5,0,1
15895,14873,252,244,8,5,5,8,11,6,0,0,14,13,1,2,1,0,1,0,0,0,0,0,1022,8,3,-3,5,0,1,-1,1,26.2,35,-8.8,3,4,-1,1
13490,15192,278,307,0,3,3,0,0,1,1,0,48,17,3,6,1,0,0,1,1,0,0,0,-1702,-29,-3,3,-1,0,31,-3,1,5,91,-86,1,5,-4,0
15939,15068,271,301,7,3,3,7,6,2,0,0,24,14,3,6,3,1,1,0,0,0,0,0,871,-30,4,-4,4,0,10,-3,2,35.4,11,24.4,3,4,-1,1
18877,15494,211,222,15,6,6,15,22,7,0,0,15,10,1,3,4,1,1,0,0,0,0,0,3383,-11,9,-9,15,0,5,-2,3,51.6,32,19.6,4,4,0,1
15353,15439,232,269,7,5,5,7,6,6,0,0,21,19,5,1,0,2,0,1,0,0,0,0,-86,-37,2,-2,0,0,2,4,-2,26.2,45.8,-19.6,3,3,0,1
16522,15598,231,237,10,7,7,10,10,7,0,0,18,120,5,3,0,0,0,1,0,0,0,0,924,-6,3,-3,3,0,-102,2,0,15.6,29.4,-13.8,4,3,1,0
14450,16429,260,260,3,10,10,3,3,8,0,1,16,16,2,6,1,0,0,1,0,1,0,0,-1979,0,-7,7,-5,0,0,-4,1,26,19.6,6.4,3,4,-1,0
14821,13862,264,270,5,2,2,5,3,3,0,1,16,106,2,2,1,0,1,0,0,1,0,0,959,-6,3,-3,0,0,-90,0,1,51.8,62.6,-10.8,4,5,-1,1
18606,15556,280,246,11,5,5,11,14,9,0,1,113,50,1,6,3,0,1,0,0,1,0,0,3050,34,6,-6,5,0,63,-5,3,16.6,8.4,8.2,4,1,3,0
